Line Id,Date,Name,AFC Revenue (A),Travel Revenue (B),Famoco Revenue (C),QR Online Revenue (D),QR Paper Revenue (E),Static QR Revenue (E1),Whats App QR Revenue (E2),Total Revenue (F) = A + C + D + E + E1 + E2,Parked Vehicle - Cash Revenue (F),Parked Vehicle - Card Revenue (G),Parked Vehicle - Total Revenue (H) = F + G,Pass Sale - Cash Revenue (I),Pass Sale - Card Revenue (J),Pass Sale - Total Revenue (K) = I + J,CL Entry Count (L),QR Entry Count (M),Total Entry Count (N) = L + M,CL Exit Count (O),QR Exit Count (P),Total Exit Count (Q) = O + P,Ridership Count,CSC Qty (R),CST Qty (S),P-CSC (1-day) Qty (T),P-CSC (30-day) Qty (U),Paper Ticket Qty (V),QR Online Qty (W),QR Paper Qty (X),Total Qty (Y) = R + S + T + U + V + W + X
1,22/07/2022,01ED-Wimco Nagar Depot Metro,61002,62720,0,1504,19080,0,0,81586,150,495,645,0,500,500,1747,511,2258,1358,263,1621,1366,21,13,0,0,9,40,472,555
1,22/07/2022,01EF-Wimco Nagar Metro,111334,128017,0,3048,32660,0,0,147042,6175,5320,11495,0,1250,1250,3152,888,4040,2938,753,3691,2992,40,103,3,0,5,89,797,1037
1,22/07/2022,01F1-Thiruvotriyur Metro,89301,93957,0,1288,20820,0,0,111409,760,1345,2105,0,0,0,2654,590,3244,2521,421,2942,2480,46,0,0,0,3,41,552,642
1,22/07/2022,01F3-Thiruvotriyur Theradi Metro,93300,116431,0,1880,31170,0,0,126350,1075,2980,4055,0,0,0,2766,885,3651,2917,866,3783,2928,36,91,4,0,7,52,838,1028
1,22/07/2022,01F5-Kaladipet Metro,88875,90045,0,1000,21120,0,0,110995,1260,2205,3465,0,0,0,2712,642,3354,2665,505,3170,2597,11,0,1,0,1,33,612,658
1,22/07/2022,01F7-Tollgate Metro,58424,52649,100,976,14020,0,0,73520,35,155,190,0,0,0,1526,444,1970,1453,349,1802,1414,33,0,1,0,5,34,406,479
1,22/07/2022,01F9-New Washermenpet Metro,79037,89548,200,1112,23620,0,0,103969,1285,1665,2950,0,250,250,2675,801,3476,2563,669,3232,2627,19,119,2,0,3,41,760,944
1,22/07/2022,01FB-Tondiarpet Metro,75825,93633,1300,1088,26140,0,0,104353,2520,3270,5790,0,250,250,2733,901,3634,2762,730,3492,2694,39,1,0,0,8,39,856,943
1,22/07/2022,01FD-Thiagaraya College Metro,90295,105361,100,1520,26720,0,0,118635,4635,3405,8040,0,1000,1000,3267,968,4235,3235,807,4042,3251,48,46,2,0,10,51,914,1071
1,22/07/2022,0101-Washermanpet,78620,103873,200,1256,33550,0,0,113626,9165,3605,12770,0,11500,11500,3224,1141,4365,2814,993,3807,2904,14,138,0,0,5,50,1094,1301
1,22/07/2022,0103-Mannadi,64054,103869,200,840,29990,0,0,95084,8980,5300,14280,0,0,0,2820,1008,3828,3112,962,4074,3075,11,81,1,0,1,33,976,1103
1,22/07/2022,0105-High Court,124196,224307,1200,1768,61040,0,0,188204,650,2920,3570,0,0,0,6427,1921,8348,6571,1781,8352,6738,28,258,3,0,5,74,2091,2459
1,22/07/2022,0109-Government Estate,86133,142139,350,1640,38140,0,0,126263,1635,4195,5830,0,4250,4250,3919,1357,5276,4055,1522,5577,4441,28,524,0,0,10,73,1269,1904
1,22/07/2022,0111-LIC,73119,153129,200,1312,30500,0,0,105131,1575,495,2070,0,0,0,4273,1072,5345,5027,940,5967,4946,26,1,0,0,2,53,1001,1083
1,22/07/2022,0113-Thousand Lights,114259,210899,900,3048,40240,0,0,158447,550,315,865,0,0,0,6145,1466,7611,6932,1187,8119,6881,30,0,3,0,3,136,1317,1489
1,22/07/2022,0115-AG-DMS,97718,136291,200,1528,24530,0,0,123976,0,0,0,0,0,0,4283,835,5118,4145,630,4775,4360,23,229,0,0,2,61,762,1077
1,22/07/2022,0117-Teynampet,70385,129955,100,1872,29500,0,0,101857,0,0,0,0,0,0,3781,1060,4841,4249,888,5137,4189,25,0,2,0,1,77,977,1082
1,22/07/2022,0119-Nandanam,65699,107582,500,1864,26300,0,0,94363,160,335,495,0,250,250,3279,971,4250,3568,691,4259,3527,25,0,8,1,2,80,886,1002
1,22/07/2022,0121-Saidapet,41030,73286,100,896,23890,0,0,65916,4275,1515,5790,0,2000,2000,1812,813,2625,2024,612,2636,1980,13,0,2,0,0,41,779,835
1,22/07/2022,0123-Little Mount,73243,82904,900,1128,22150,0,0,97421,3420,6940,10360,0,0,0,2884,809,3693,2389,505,2894,2450,25,158,2,0,1,51,752,989
1,22/07/2022,0125-Guindy,121170,243771,0,4280,84270,0,0,209720,5715,8610,14325,0,0,0,6724,2837,9561,6187,2015,8202,6275,29,361,3,0,14,174,2680,3261
1,22/07/2022,0129-Nanganallur Road,40703,42826,360,512,8990,0,0,50565,2010,6255,8265,0,0,0,1215,298,1513,1348,229,1577,1294,11,0,3,0,1,19,272,306
1,22/07/2022,0131-Meenambakkam,116313,124110,800,1328,36180,0,0,154621,2065,9140,11205,0,0,0,3564,1033,4597,2901,838,3739,2992,29,184,0,0,2,43,1005,1263
1,22/07/2022,0133-Chennai International Airport,148104,305658,0,7720,136110,0,0,291934,7090,12255,19345,0,5250,5250,5109,3690,8799,5385,3083,8468,5459,69,662,6,0,8,203,3509,4457
2,22/07/2022,0201-Puratchi Thalaivar Dr. M.G. Ramachandran Central,256716,434481,1805,6144,128700,0,0,393365,12555,2370,14925,0,2600,2600,11986,4545,16531,10396,7132,17528,12511,94,3066,12,0,14,237,4306,7729
2,22/07/2022,0203-Egmore,52790,121546,200,1592,51970,0,0,106552,3855,1620,5475,0,7000,7000,2198,1830,4028,2888,2513,5401,2827,21,371,10,0,4,70,1762,2238
2,22/07/2022,0205-Nehru Park,34075,40878,500,424,14560,0,0,49559,2185,3645,5830,0,2000,2000,1212,521,1733,1117,378,1495,1126,13,77,1,0,1,20,502,614
2,22/07/2022,0207-Kilpauk,30320,51816,200,408,14410,0,0,45338,695,205,900,0,0,0,1413,492,1905,1511,420,1931,1526,8,78,0,0,5,22,471,584
2,22/07/2022,0209-Pachaiyappas College,31631,47360,0,416,13760,0,0,45807,0,0,0,0,1000,1000,1512,502,2014,1415,417,1832,1423,5,54,1,0,1,19,479,559
2,22/07/2022,0211-Shenoy Nagar,40120,40947,200,624,10640,0,0,51584,1920,1200,3120,0,0,0,1202,378,1580,1251,320,1571,1250,8,58,0,0,2,24,351,443
2,22/07/2022,0213-Anna Nagar East,64567,100922,0,1896,28190,0,0,94653,625,3010,3635,0,0,0,2777,1036,3813,2769,798,3567,2855,14,179,2,0,2,76,942,1215
2,22/07/2022,0215-Anna Nagar Tower,82254,87873,500,1352,23600,0,0,107706,6015,8210,14225,0,250,250,2434,862,3296,2450,671,3121,2489,17,176,0,0,5,55,793,1046
2,22/07/2022,0217-Thirumangalam,202343,280154,1950,5968,77940,0,0,288201,66120,17655,83775,0,1500,1500,7609,2670,10279,7389,2091,9480,7598,55,511,4,0,5,210,2446,3231
2,22/07/2022,0219-Koyambedu,142166,196979,850,3232,66450,0,0,212698,7915,9230,17145,0,6000,6000,5138,2273,7411,4563,1852,6415,4773,44,574,6,0,9,131,2155,2919
2,22/07/2022,0221-Puratchi Thalaivi Dr. J. Jayalalithaa CMBT,49833,161854,0,1656,71360,0,0,122849,0,0,0,0,0,0,2069,2368,4437,4293,4318,8611,3560,44,273,5,0,3,72,2295,2692
2,22/07/2022,0223-Arumbakkam,48891,49564,0,2000,18290,0,0,69181,4585,2465,7050,0,7750,7750,1335,673,2008,1342,534,1876,1262,32,1,1,0,4,38,632,708
2,22/07/2022,0225-Vadapalani,106663,181565,2000,3664,68930,0,0,181257,16110,4040,20150,0,6500,6500,4120,2346,6466,4196,2057,6253,4302,34,475,3,0,12,136,2193,2853
2,22/07/2022,0227-Ashok Nagar,78359,123752,210,3040,40540,0,0,122149,5500,5170,10670,0,3000,3000,3164,1401,4565,3027,1091,4118,3176,28,309,0,0,1,106,1294,1738
2,22/07/2022,0229-Ekkattuthangal,73748,130885,320,2856,37200,0,0,114124,3215,5920,9135,0,1000,1000,3707,1297,5004,3483,882,4365,3734,15,356,0,0,8,93,1200,1672
2,22/07/2022,0231-Arignar Anna Alandur,136401,190788,550,3352,56450,0,0,196753,6260,10210,16470,0,6500,6500,5237,1836,7073,4670,1504,6174,5117,42,696,10,0,7,121,1719,2595
2,22/07/2022,0233-St. Thomas Mount,78431,95572,1050,2024,28060,0,0,109565,1190,3235,4425,0,5000,5000,2685,952,3637,2466,755,3221,2589,25,228,3,0,2,82,868,1208
1,23/07/2022,01ED-Wimco Nagar Depot Metro,54822,57768,0,1344,23850,0,0,80016,110,70,180,0,1000,1000,1357,610,1967,1099,303,1402,1059,30,3,0,0,10,37,577,657
1,23/07/2022,01EF-Wimco Nagar Metro,87012,116111,210,2680,38260,0,0,128162,7305,5395,12700,0,500,500,2412,977,3389,2387,927,3314,2415,32,102,3,0,20,72,911,1140
1,23/07/2022,01F1-Thiruvotriyur Metro,81548,89336,0,2096,27970,0,0,111614,1060,1490,2550,0,0,0,2106,786,2892,2032,687,2719,2029,47,38,10,0,9,61,726,891
1,23/07/2022,01F3-Thiruvotriyur Theradi Metro,89125,103801,0,1904,32950,0,0,123979,640,2350,2990,0,0,0,2314,949,3263,2361,1028,3389,2407,54,132,1,0,11,62,894,1154
1,23/07/2022,01F5-Kaladipet Metro,70810,82651,500,1808,24640,0,0,97758,815,1880,2695,0,0,0,2127,772,2899,2158,700,2858,2100,44,0,2,0,13,61,713,833
1,23/07/2022,01F7-Tollgate Metro,39272,50135,0,832,18990,0,0,59094,50,90,140,0,0,0,1195,566,1761,1181,446,1627,1133,22,11,0,0,6,30,540,609
1,23/07/2022,01F9-New Washermenpet Metro,68783,80944,500,1720,23740,0,0,94743,1130,1430,2560,0,0,0,2240,752,2992,2094,794,2888,2194,16,154,0,0,12,50,727,959
1,23/07/2022,01FB-Tondiarpet Metro,62214,82473,550,824,29030,0,0,92618,1525,2210,3735,0,1000,1000,2091,908,2999,2169,842,3011,2078,21,0,1,0,8,27,878,935
1,23/07/2022,01FD-Thiagaraya College Metro,77499,96124,250,2032,31990,0,0,111771,1890,2100,3990,0,0,0,2564,1063,3627,2607,972,3579,2575,86,51,1,0,9,72,998,1217
1,23/07/2022,0101-Washermanpet,67722,100077,350,1744,44970,0,0,114786,11380,5840,17220,0,8000,8000,2304,1469,3773,2181,1215,3396,2208,18,124,3,0,8,78,1398,1629
1,23/07/2022,0103-Mannadi,63302,95302,0,1584,36270,0,0,101156,14725,6360,21085,0,1500,1500,2299,1232,3531,2410,1215,3625,2462,13,140,2,0,4,68,1178,1405
1,23/07/2022,0105-High Court,76693,158202,500,2328,66300,0,0,145821,830,1810,2640,0,0,0,3586,2095,5681,3632,1919,5551,3731,28,283,0,0,4,91,2091,2497
1,23/07/2022,0109-Government Estate,73825,146145,350,1784,62150,0,0,138109,3945,2675,6620,0,3750,3750,3225,2157,5382,3355,2119,5474,3612,23,452,1,0,23,74,2083,2656
1,23/07/2022,0111-LIC,40125,76902,100,1080,28720,0,0,70025,16490,545,17035,0,2000,2000,1716,959,2675,2012,840,2852,1903,15,0,0,0,6,45,917,983
1,23/07/2022,0113-Thousand Lights,66467,142615,1750,2208,43870,0,0,114295,350,240,590,0,0,0,3576,1498,5074,4146,1201,5347,3958,23,0,5,0,9,92,1400,1529
1,23/07/2022,0115-AG-DMS,51330,83596,600,1120,22760,0,0,75810,0,0,0,0,500,500,2238,754,2992,2224,640,2864,2311,8,175,2,0,0,43,705,933
1,23/07/2022,0117-Teynampet,39661,78910,100,1400,28410,0,0,69571,0,0,0,0,0,0,1803,1013,2816,2193,924,3117,2067,19,0,0,0,2,58,958,1037
1,23/07/2022,0119-Nandanam,45051,72086,50,1248,27800,0,0,74149,0,0,0,0,0,0,1818,963,2781,1966,727,2693,1861,41,0,2,0,4,52,911,1010
1,23/07/2022,0121-Saidapet,30822,54934,0,1184,25460,0,0,57466,2790,1505,4295,0,250,250,1066,838,1904,1215,663,1878,1126,13,0,2,0,5,43,804,867
1,23/07/2022,0123-Little Mount,44436,57073,200,1144,20860,0,0,66640,4040,2655,6695,0,0,0,1625,730,2355,1377,576,1953,1452,17,192,5,0,7,48,685,954
1,23/07/2022,0125-Guindy,97167,217715,152,4920,104020,0,0,206259,5830,4315,10145,0,500,500,4230,3351,7581,4233,2701,6934,4287,42,555,12,0,24,173,3250,4056
1,23/07/2022,0129-Nanganallur Road,26412,33340,0,768,11330,0,0,38510,11320,4180,15500,0,0,0,709,351,1060,850,316,1166,791,23,0,4,0,5,24,332,388
1,23/07/2022,0131-Meenambakkam,100361,104620,400,1904,40720,0,0,143385,2715,7160,9875,0,0,0,2373,1126,3499,1985,1075,3060,2102,34,240,4,0,4,52,1102,1436
1,23/07/2022,0133-Chennai International Airport,119851,310430,0,7784,170490,0,0,298125,12155,8755,20910,0,1500,1500,4046,4626,8672,4341,3843,8184,4401,72,719,17,0,29,244,4443,5524
2,23/07/2022,0201-Puratchi Thalaivar Dr. M.G. Ramachandran Central,228687,397941,1550,6840,142590,0,0,379667,12675,2105,14780,0,6550,6550,9715,4888,14603,7202,7246,14448,9869,89,3613,16,0,23,267,4632,8640
2,23/07/2022,0203-Egmore,67628,120206,200,2248,58740,0,0,128816,3400,1360,4760,0,9250,9250,2019,1996,4015,2361,2609,4970,2478,17,544,28,0,10,85,1908,2592
2,23/07/2022,0205-Nehru Park,27896,44454,200,1080,18350,0,0,47526,2085,550,2635,0,2000,2000,1085,667,1752,1048,468,1516,1082,10,116,1,0,10,39,623,799
2,23/07/2022,0207-Kilpauk,26272,42050,597,856,13320,0,0,41045,495,90,585,0,0,0,1088,493,1581,1118,490,1608,1148,16,81,0,0,4,40,456,597
2,23/07/2022,0209-Pachaiyappas College,26329,40943,0,608,15090,0,0,42027,0,0,0,0,2000,2000,1123,541,1664,1087,452,1539,1082,7,75,4,0,4,25,514,629
2,23/07/2022,0211-Shenoy Nagar,30164,34719,0,608,11510,0,0,42282,2120,870,2990,0,4000,4000,900,407,1307,922,405,1327,922,12,72,0,0,5,27,381,497
2,23/07/2022,0213-Anna Nagar East,51492,84581,0,1816,27990,0,0,81298,565,2185,2750,0,3000,3000,2054,974,3028,2132,892,3024,2197,17,186,0,0,1,64,914,1182
2,23/07/2022,0215-Anna Nagar Tower,53062,75534,50,1656,25770,0,0,80538,4475,4375,8850,0,1000,1000,1745,931,2676,1874,851,2725,1893,22,198,1,0,2,64,861,1148
2,23/07/2022,0217-Thirumangalam,154693,244968,210,5704,102350,0,0,262957,97685,13525,111210,0,0,0,5161,3358,8519,5159,2984,8143,5282,50,558,10,0,12,213,3162,4005
2,23/07/2022,0219-Koyambedu,109168,170834,1200,2272,75920,0,0,188560,4965,4880,9845,0,9500,9500,3682,2528,6210,3208,1952,5160,3438,42,773,18,0,15,92,2462,3402
2,23/07/2022,0221-Puratchi Thalaivi Dr. J. Jayalalithaa CMBT,52976,147207,0,1896,75060,0,0,129932,0,0,0,0,0,0,1835,2414,4249,3237,4048,7285,2784,57,446,6,0,6,68,2375,2958
2,23/07/2022,0223-Arumbakkam,37183,49242,0,880,24180,0,0,62243,3320,995,4315,0,5250,5250,1025,850,1875,1137,658,1795,1009,32,1,5,0,10,33,814,895
2,23/07/2022,0225-Vadapalani,114989,248389,200,7464,115716,0,0,238369,20510,4570,25080,0,1500,1500,4608,3942,8550,4483,3584,8067,4948,53,984,1,0,39,287,3666,5030
2,23/07/2022,0227-Ashok Nagar,69381,108104,0,2528,46210,0,0,118119,6845,4545,11390,0,3000,3000,2459,1565,4024,2366,1311,3677,2445,26,328,3,0,5,94,1475,1931
2,23/07/2022,0229-Ekkattuthangal,57072,83049,1020,2208,30740,0,0,91040,2415,1860,4275,0,0,0,1946,1093,3039,1885,841,2726,2072,25,384,3,0,11,94,994,1511
2,23/07/2022,0231-Arignar Anna Alandur,116337,175961,1100,4032,74020,0,0,195489,8770,8730,17500,0,2250,2250,3557,2365,5922,3503,2231,5734,3751,68,675,6,0,11,141,2243,3144
2,23/07/2022,0233-St. Thomas Mount,63444,90762,0,2688,39350,0,0,105482,3650,1890,5540,0,3250,3250,1858,1283,3141,1816,1125,2941,1904,36,290,8,0,3,90,1197,1624
1,24/07/2022,01ED-Wimco Nagar Depot Metro,30580,48385,0,1128,25730,0,0,57438,180,40,220,0,500,500,734,643,1377,773,424,1197,712,19,2,0,0,7,32,615,675
1,24/07/2022,01EF-Wimco Nagar Metro,45739,79661,0,2488,36740,0,0,84967,7840,3205,11045,0,0,0,1269,938,2207,1297,948,2245,1305,27,133,8,0,20,43,893,1124
1,24/07/2022,01F1-Thiruvotriyur Metro,54625,66104,50,1760,31140,0,0,87575,1320,935,2255,0,0,0,1147,845,1992,1185,707,1892,1134,33,0,0,0,10,53,789,885
1,24/07/2022,01F3-Thiruvotriyur Theradi Metro,64145,96430,100,1784,42820,0,0,108849,935,1330,2265,0,0,0,1589,1147,2736,1766,1098,2864,1740,35,150,3,0,24,43,1100,1355
1,24/07/2022,01F5-Kaladipet Metro,43036,61755,0,952,27870,0,0,71858,595,920,1515,0,0,0,1141,810,1951,1324,771,2095,1201,21,2,2,0,23,32,770,850
1,24/07/2022,01F7-Tollgate Metro,22694,36087,0,712,18010,0,0,41416,50,70,120,0,0,0,632,535,1167,715,459,1174,651,19,0,0,0,8,24,511,562
1,24/07/2022,01F9-New Washermenpet Metro,43027,57511,0,1024,24230,0,0,68281,930,975,1905,0,1000,1000,1242,759,2001,1243,660,1903,1253,13,106,1,0,6,36,729,891
1,24/07/2022,01FB-Tondiarpet Metro,48927,59096,0,1120,26680,0,0,76727,2540,1510,4050,0,500,500,1120,805,1925,1250,812,2062,1195,34,15,3,0,14,35,770,871
1,24/07/2022,01FD-Thiagaraya College Metro,53802,74902,500,2448,36480,0,0,93230,2570,2670,5240,0,250,250,1408,1133,2541,1434,926,2360,1441,52,59,0,0,10,80,1054,1255
1,24/07/2022,0101-Washermanpet,48342,78180,280,1008,40800,0,0,90430,7815,1870,9685,0,4250,4250,1401,1301,2702,1352,1218,2570,1399,13,164,5,0,16,44,1262,1504
1,24/07/2022,0103-Mannadi,37304,63302,0,768,36000,0,0,74072,22720,4700,27420,0,0,0,995,1142,2137,1089,1064,2153,1070,12,138,0,0,5,25,1115,1295
1,24/07/2022,0105-High Court,30124,67150,0,1672,35740,0,0,67536,675,585,1260,0,0,0,1201,1203,2404,1157,990,2147,1256,7,176,0,0,5,61,1203,1452
1,24/07/2022,0109-Government Estate,39858,86800,1040,1824,41430,0,0,84152,7105,975,8080,0,250,250,1635,1457,3092,1552,1466,3018,1797,22,418,5,0,7,65,1382,1899
1,24/07/2022,0111-LIC,13999,40637,50,584,19600,0,0,34233,1420,790,2210,0,0,0,691,663,1354,923,595,1518,820,16,1,0,0,5,23,638,683
1,24/07/2022,0113-Thousand Lights,28014,59645,100,2016,28000,0,0,58130,385,30,415,0,0,0,1052,974,2026,1396,809,2205,1245,16,0,0,0,6,73,896,991
1,24/07/2022,0115-AG-DMS,23886,38884,0,744,16290,0,0,40920,0,0,0,0,0,0,778,519,1297,745,458,1203,833,13,166,0,0,1,33,491,704
1,24/07/2022,0117-Teynampet,17094,47604,0,976,26120,0,0,44190,0,0,0,0,0,0,749,869,1618,944,764,1708,842,12,0,0,0,10,39,834,895
1,24/07/2022,0119-Nandanam,18028,40338,700,904,22940,0,0,42572,0,0,0,0,0,0,722,794,1516,797,606,1403,701,15,0,8,0,5,34,762,824
1,24/07/2022,0121-Saidapet,17174,39818,0,952,23470,0,0,41596,4330,1480,5810,0,4250,4250,511,757,1268,716,657,1373,613,4,0,1,0,4,35,732,776
1,24/07/2022,0123-Little Mount,27197,51410,300,1144,23050,0,0,51691,5985,2435,8420,0,0,0,1058,771,1829,1000,609,1609,1076,7,187,6,0,12,35,731,978
1,24/07/2022,0125-Guindy,64047,150631,100,4544,83900,0,0,152591,8445,1525,9970,0,0,0,2229,2641,4870,2284,2475,4759,2330,28,524,6,0,19,142,2540,3259
1,24/07/2022,0129-Nanganallur Road,18538,23208,0,504,12890,0,0,31932,13315,3520,16835,0,0,0,319,391,710,426,351,777,363,12,0,0,0,6,17,371,406
1,24/07/2022,0131-Meenambakkam,54111,85091,120,1848,43578,0,0,99657,3890,3375,7265,0,0,0,1355,1185,2540,1166,1015,2181,1292,25,300,4,0,10,59,1161,1559
1,24/07/2022,0133-Chennai International Airport,98273,277173,100,6680,174680,0,0,279733,12490,5235,17725,0,2250,2250,2941,4637,7578,3242,4040,7282,3158,71,659,13,0,35,184,4519,5481
2,24/07/2022,0201-Puratchi Thalaivar Dr. M.G. Ramachandran Central,176645,339859,230,8176,149370,0,0,334421,19530,2125,21655,0,250,250,6578,5070,11648,4107,6535,10642,6729,82,3409,19,0,28,326,4814,8678
2,24/07/2022,0203-Egmore,47913,100403,100,1584,56780,0,0,106377,9235,1760,10995,0,10500,10500,1460,1951,3411,1497,2310,3807,1608,13,526,11,0,6,61,1894,2511
2,24/07/2022,0205-Nehru Park,17057,26052,0,760,13940,0,0,31757,2485,500,2985,0,2250,2250,466,483,949,492,437,929,493,9,73,2,0,0,30,453,567
2,24/07/2022,0207-Kilpauk,11862,27599,350,432,11870,0,0,24514,225,25,250,0,0,0,558,405,963,556,426,982,599,6,112,0,0,2,20,385,525
2,24/07/2022,0209-Pachaiyappas College,20319,37158,0,904,18830,0,0,40053,0,0,0,0,4000,4000,783,696,1479,734,577,1311,768,7,122,0,0,3,48,649,829
2,24/07/2022,0211-Shenoy Nagar,14081,22318,0,408,11770,0,0,26259,0,0,0,0,2000,2000,410,394,804,442,313,755,434,15,48,0,0,5,17,381,466
2,24/07/2022,0213-Anna Nagar East,29995,59943,300,1328,25150,0,0,56773,670,660,1330,0,0,0,1285,874,2159,1297,779,2076,1328,15,184,1,0,11,56,813,1080
2,24/07/2022,0215-Anna Nagar Tower,35008,59938,0,1472,25900,0,0,62380,6300,3915,10215,0,0,0,1179,895,2074,1218,818,2036,1286,11,256,4,0,3,50,842,1166
2,24/07/2022,0217-Thirumangalam,99997,183202,100,4672,94820,0,0,199589,91970,6940,98910,0,0,0,3059,3051,6110,3262,2816,6078,3245,42,555,11,0,9,181,2873,3671
2,24/07/2022,0219-Koyambedu,72591,128456,264,2104,72500,0,0,147459,5110,4045,9155,0,4000,4000,2143,2306,4449,1963,1879,3842,2025,26,556,16,0,19,94,2260,2971
2,24/07/2022,0221-Puratchi Thalaivi Dr. J. Jayalalithaa CMBT,42724,132988,50,1896,83350,0,0,128020,0,0,0,0,0,0,1563,2687,4250,2126,3286,5412,1840,38,472,2,0,15,83,2636,3246
2,24/07/2022,0223-Arumbakkam,28372,40405,0,448,24710,0,0,53530,3720,600,4320,0,4000,4000,636,851,1487,737,663,1400,635,35,0,1,0,20,20,833,909
2,24/07/2022,0225-Vadapalani,73093,169355,190,6320,86800,0,0,166403,21420,4110,25530,0,1500,1500,2831,2971,5802,2945,2820,5765,3077,30,673,2,0,26,199,2784,3714
2,24/07/2022,0227-Ashok Nagar,51882,74738,0,2048,39800,0,0,93730,6685,5830,12515,0,6000,6000,1291,1360,2651,1289,1268,2557,1355,29,274,3,0,1,80,1286,1673
2,24/07/2022,0229-Ekkattuthangal,39964,52990,0,928,22870,0,0,63762,1925,1125,3050,0,0,0,1100,754,1854,1121,795,1916,1191,27,325,3,0,11,41,723,1130
2,24/07/2022,0231-Arignar Anna Alandur,86663,134558,500,3008,61980,0,0,152151,9915,4315,14230,0,0,0,2501,1902,4403,2102,1873,3975,2577,46,881,6,0,17,89,1840,2879
2,24/07/2022,0233-St. Thomas Mount,43363,66153,0,1936,30870,0,0,76169,1830,1465,3295,0,250,250,1148,986,2134,1095,1010,2105,1236,24,365,4,0,4,70,924,1391
1,25/07/2022,01ED-Wimco Nagar Depot Metro,67232,64817,100,1424,21500,0,0,90256,145,245,390,0,500,500,1598,529,2127,1414,355,1769,1376,21,1,0,0,6,30,539,597
1,25/07/2022,01EF-Wimco Nagar Metro,121747,128293,40,2416,35270,0,0,159473,15125,5980,21105,0,5250,5250,3102,911,4013,2909,1011,3920,2896,43,90,2,0,5,56,853,1049
1,25/07/2022,01F1-Thiruvotriyur Metro,124522,101680,0,1080,24700,0,0,150302,1470,1500,2970,0,0,0,2641,679,3320,2637,622,3259,2577,22,0,1,0,9,34,645,711
1,25/07/2022,01F3-Thiruvotriyur Theradi Metro,110217,107715,100,1080,25520,0,0,136917,1300,2895,4195,0,0,0,2582,719,3301,2812,796,3608,2821,32,94,1,0,10,36,678,851
1,25/07/2022,01F5-Kaladipet Metro,121199,96480,0,1272,22470,0,0,144941,800,2460,3260,0,0,0,2870,714,3584,2821,609,3430,2765,30,0,1,0,8,41,673,753
1,25/07/2022,01F7-Tollgate Metro,65627,52439,0,752,13560,0,0,79939,25,125,150,0,0,0,1525,431,1956,1455,371,1826,1433,35,1,0,0,5,23,415,479
1,25/07/2022,01F9-New Washermenpet Metro,104043,89287,100,1032,23490,0,0,128665,1180,1780,2960,0,0,0,2620,781,3401,2628,740,3368,2622,14,55,1,0,2,31,755,858
1,25/07/2022,01FB-Tondiarpet Metro,99111,91321,450,1176,22400,0,0,123137,1950,3710,5660,0,0,0,2663,744,3407,2765,759,3524,2724,27,12,0,0,5,41,708,793
1,25/07/2022,01FD-Thiagaraya College Metro,124784,109299,520,2496,27970,0,0,155770,4385,2035,6420,0,1000,1000,3279,985,4264,3333,849,4182,3335,51,41,2,0,5,59,924,1082
1,25/07/2022,0101-Washermanpet,113912,105888,755,1784,34290,0,0,150741,9680,4110,13790,0,13250,13250,3183,1197,4380,2907,1112,4019,2936,25,97,2,0,1,61,1132,1318
1,25/07/2022,0103-Mannadi,90502,104344,0,936,31400,0,0,122838,12355,7725,20080,0,1500,1500,2808,1059,3867,3098,1200,4298,3079,18,84,2,0,0,28,1030,1162
1,25/07/2022,0105-High Court,160257,225695,0,1776,65030,0,0,227063,1335,1460,2795,0,0,0,6325,2070,8395,6533,1830,8363,6587,38,154,0,0,1,73,2158,2424
1,25/07/2022,0109-Government Estate,91139,144249,200,1688,46040,0,0,139067,2590,3055,5645,0,4000,4000,3793,1638,5431,4125,1533,5658,4313,24,327,2,0,10,64,1559,1986
1,25/07/2022,0111-LIC,91375,154768,1232,1344,27620,0,0,121571,2985,875,3860,0,250,250,4513,966,5479,5191,951,6142,5125,34,0,1,0,0,56,898,989
1,25/07/2022,0113-Thousand Lights,144210,223132,3180,3160,41980,0,0,192530,495,255,750,0,250,250,6312,1548,7860,7435,1366,8801,7299,34,0,0,0,8,129,1400,1571
1,25/07/2022,0115-AG-DMS,107490,138396,0,1688,28040,0,0,137218,0,0,0,0,1250,1250,4137,935,5072,4294,833,5127,4350,23,99,2,0,1,59,867,1051
1,25/07/2022,0117-Teynampet,87122,132220,0,1368,28600,0,0,117090,0,0,0,0,0,0,3791,1046,4837,4434,1075,5509,4315,25,2,0,0,1,55,974,1057
1,25/07/2022,0119-Nandanam,92161,110291,656,1032,24690,0,0,118539,0,0,0,0,2000,2000,3155,896,4051,3790,853,4643,3705,38,0,3,0,4,45,833,923
1,25/07/2022,0121-Saidapet,53945,77316,0,912,22580,0,0,77437,3355,1355,4710,0,5000,5000,1844,774,2618,2302,747,3049,2193,16,0,0,0,2,36,744,798
1,25/07/2022,0123-Little Mount,89828,82993,1079,856,21900,0,0,113663,4155,6960,11115,0,3000,3000,2939,788,3727,2468,625,3093,2504,27,126,4,0,1,39,740,937
1,25/07/2022,0125-Guindy,162707,235375,1200,4840,69970,0,0,238717,10250,8530,18780,0,500,500,6835,2467,9302,6448,2199,8647,6543,40,304,2,0,7,185,2272,2810
1,25/07/2022,0129-Nanganallur Road,55444,45544,0,384,9490,0,0,65318,9980,8125,18105,0,0,0,1264,315,1579,1397,254,1651,1373,21,0,2,0,0,13,300,336
1,25/07/2022,0131-Meenambakkam,126275,130511,200,2232,38130,0,0,166837,2890,9575,12465,0,0,0,3651,1064,4715,3004,899,3903,3128,20,190,3,0,5,64,1011,1293
1,25/07/2022,0133-Chennai International Airport,201941,298145,0,6248,124480,0,0,332669,10445,14750,25195,0,13000,13000,5267,3377,8644,5373,3125,8498,5548,61,691,5,0,23,193,3228,4201
2,25/07/2022,0201-Puratchi Thalaivar Dr. M.G. Ramachandran Central,277438,440704,840,9792,158030,0,0,446100,33210,4285,37495,0,13550,13550,12888,5599,18487,9296,6458,15754,11642,128,2863,19,0,12,399,5211,8632
2,25/07/2022,0203-Egmore,91344,119605,650,2960,50510,0,0,145464,12015,2865,14880,0,22500,22500,2605,1843,4448,2439,2244,4683,2731,20,619,8,0,7,111,1730,2495
2,25/07/2022,0205-Nehru Park,32068,39432,0,680,12430,0,0,45178,1340,2715,4055,0,2000,2000,1138,458,1596,1101,381,1482,1137,12,75,0,0,0,22,434,543
2,25/07/2022,0207-Kilpauk,38938,51924,300,960,14550,0,0,54748,860,215,1075,0,0,0,1406,520,1926,1455,492,1947,1503,14,75,0,0,1,36,487,613
2,25/07/2022,0209-Pachaiyappas College,35407,48244,500,656,13380,0,0,49943,0,0,0,0,2750,2750,1490,509,1999,1470,494,1964,1499,13,83,3,0,0,25,478,602
2,25/07/2022,0211-Shenoy Nagar,31544,42855,0,504,11710,0,0,43758,0,0,0,0,0,0,1111,425,1536,1293,453,1746,1280,17,45,0,0,2,20,405,489
2,25/07/2022,0213-Anna Nagar East,93836,98846,0,1632,26230,0,0,121698,540,3335,3875,0,3000,3000,2675,945,3620,2854,932,3786,2868,23,147,1,0,1,56,879,1107
2,25/07/2022,0215-Anna Nagar Tower,78056,87532,222,1224,22370,0,0,101872,6145,7230,13375,0,500,500,2340,778,3118,2549,816,3365,2560,15,153,1,0,0,44,722,935
2,25/07/2022,0217-Thirumangalam,287043,280868,1800,3808,75020,0,0,367671,62900,19070,81970,0,1500,1500,7427,2471,9898,7845,2520,10365,7774,60,381,8,1,6,137,2320,2913
2,25/07/2022,0219-Koyambedu,175376,204046,1205,2376,80770,0,0,259727,7610,8275,15885,1000,17000,18000,5039,2650,7689,4434,1830,6264,4569,47,431,4,0,9,99,2581,3171
2,25/07/2022,0221-Puratchi Thalaivi Dr. J. Jayalalithaa CMBT,86132,172193,0,3152,78530,0,0,167814,0,0,0,0,0,0,3178,2589,5767,2964,2995,5959,3482,48,1005,5,0,2,120,2502,3682
2,25/07/2022,0223-Arumbakkam,51806,51189,0,608,19150,0,0,71564,5815,1415,7230,0,7500,7500,1294,695,1989,1393,586,1979,1308,32,0,2,0,3,24,663,724
2,25/07/2022,0225-Vadapalani,114312,179406,350,2728,66840,0,0,184230,8690,2390,11080,0,6000,6000,3938,2241,6179,4254,2342,6596,4299,38,406,3,0,13,107,2132,2699
2,25/07/2022,0227-Ashok Nagar,114443,127380,0,4184,43770,0,0,162397,6755,5645,12400,0,12000,12000,3152,1455,4607,3263,1308,4571,3231,28,164,1,0,4,81,1376,1654
2,25/07/2022,0229-Ekkattuthangal,99272,126322,850,1544,29340,0,0,131006,3435,1440,4875,0,1500,1500,3427,1026,4453,3863,1091,4954,3889,31,205,1,0,5,66,946,1254
2,25/07/2022,0231-Arignar Anna Alandur,169032,181425,0,3528,58570,0,0,231130,13050,14955,28005,0,4500,4500,4898,1942,6840,4610,1676,6286,4772,55,391,4,0,4,118,1831,2403
2,25/07/2022,0233-St. Thomas Mount,83274,95523,550,2104,26760,0,0,112688,2880,2890,5770,0,2750,2750,2646,912,3558,2569,865,3434,2649,28,173,1,0,2,85,820,1109
1,26/07/2022,01ED-Wimco Nagar Depot Metro,76838,59929,700,1088,15850,0,0,94476,90,380,470,0,1750,1750,1732,419,2151,1354,329,1683,1399,22,50,2,0,5,30,399,508
1,26/07/2022,01EF-Wimco Nagar Metro,106065,129141,500,2344,33190,0,0,142099,6075,5980,12055,0,250,250,3099,888,3987,3045,774,3819,3037,26,56,4,0,7,73,817,983
1,26/07/2022,01F1-Thiruvotriyur Metro,103981,91490,0,896,18120,0,0,122997,1010,1545,2555,0,0,0,2636,522,3158,2524,451,2975,2488,40,0,1,0,5,26,495,567
1,26/07/2022,01F3-Thiruvotriyur Theradi Metro,92348,103274,0,904,24200,0,0,117452,865,2770,3635,0,0,0,2462,706,3168,2737,761,3498,2738,25,46,2,0,1,31,669,774
1,26/07/2022,01F5-Kaladipet Metro,98586,90059,0,1048,17800,0,0,117434,705,2590,3295,0,0,0,2844,572,3416,2738,516,3254,2717,23,0,1,0,1,39,533,597
1,26/07/2022,01F7-Tollgate Metro,52346,51966,200,536,12280,0,0,65362,30,85,115,0,0,0,1538,391,1929,1461,306,1767,1454,18,0,0,0,1,17,374,410
1,26/07/2022,01F9-New Washermenpet Metro,89142,85398,100,1544,20380,0,0,111166,850,1815,2665,0,500,500,2604,689,3293,2540,617,3157,2572,20,38,2,0,2,40,649,751
1,26/07/2022,01FB-Tondiarpet Metro,84424,86600,0,1056,20720,0,0,106200,1895,3315,5210,0,750,750,2628,703,3331,2622,667,3289,2618,27,7,0,0,0,36,666,736
1,26/07/2022,01FD-Thiagaraya College Metro,99458,100807,550,1344,22850,0,0,124202,2550,2375,4925,0,500,500,3194,800,3994,3243,691,3934,3229,74,16,2,0,2,46,758,898
1,26/07/2022,0101-Washermanpet,84259,104966,600,1304,32810,0,0,118973,5630,3075,8705,0,3500,3500,3192,1135,4327,2925,964,3889,2994,17,99,3,0,1,38,1081,1239
1,26/07/2022,0103-Mannadi,72267,103086,1000,688,29300,0,0,103255,10300,6720,17020,0,0,0,2817,969,3786,3047,996,4043,3107,13,130,1,0,0,30,950,1124
1,26/07/2022,0105-High Court,140529,231733,0,1672,64260,0,0,206461,1045,1660,2705,0,0,0,6691,2033,8724,6786,1772,8558,6870,39,186,0,0,3,61,2106,2395
1,26/07/2022,0109-Government Estate,84238,129248,0,1536,34810,0,0,120584,2085,3165,5250,0,2500,2500,3742,1235,4977,4020,1280,5300,4196,28,276,3,0,5,61,1160,1533
1,26/07/2022,0111-LIC,76297,155279,120,1696,26100,0,0,104213,940,800,1740,0,0,0,4615,940,5555,5219,864,6083,5210,23,1,0,0,2,67,863,956
1,26/07/2022,0113-Thousand Lights,122480,219861,420,2792,36740,0,0,162432,340,565,905,0,0,0,6540,1345,7885,7418,1181,8599,7376,33,6,1,0,4,123,1201,1368
1,26/07/2022,0115-AG-DMS,102704,130442,0,1168,21150,0,0,125022,0,0,0,0,3250,3250,4245,738,4983,4234,583,4817,4335,20,117,0,0,0,47,683,867
1,26/07/2022,0117-Teynampet,74889,127444,0,1456,25180,0,0,101525,0,0,0,0,500,500,3880,908,4788,4375,845,5220,4305,21,0,3,0,2,63,842,931
1,26/07/2022,0119-Nandanam,81617,110319,0,1416,23190,0,0,106223,365,0,365,0,4000,4000,3359,866,4225,3802,699,4501,3749,35,0,1,0,2,62,798,898
1,26/07/2022,0121-Saidapet,49630,73706,100,1304,20030,0,0,71064,2330,1655,3985,0,2500,2500,1853,683,2536,2205,641,2846,2167,12,0,2,0,0,32,651,697
1,26/07/2022,0123-Little Mount,77364,80018,300,720,18460,0,0,96844,3350,6600,9950,0,250,250,2964,665,3629,2444,538,2982,2510,19,127,5,0,5,31,629,816
1,26/07/2022,0125-Guindy,120102,216146,700,4008,59550,0,0,184360,5565,7400,12965,0,0,0,6518,2070,8588,6078,1814,7892,6248,50,250,2,0,2,155,1912,2371
1,26/07/2022,0129-Nanganallur Road,46744,45790,200,368,8760,0,0,56072,8490,8055,16545,0,0,0,1343,277,1620,1454,237,1691,1414,19,0,0,0,0,16,261,296
1,26/07/2022,0131-Meenambakkam,128077,120423,10,2064,30540,0,0,160691,4375,14400,18775,0,0,0,3551,896,4447,2988,774,3762,3081,17,144,4,0,1,59,841,1066
1,26/07/2022,0133-Chennai International Airport,158697,281413,100,5720,117780,0,0,282297,6425,13295,19720,0,11750,11750,5000,3205,8205,5100,2911,8011,5305,54,527,7,0,18,167,3058,3831
2,26/07/2022,0201-Puratchi Thalaivar Dr. M.G. Ramachandran Central,211307,389024,100,5936,141970,0,0,359313,18395,2445,20840,0,4700,4700,10998,4904,15902,9212,5515,14727,10487,107,1842,15,0,11,252,4677,6904
2,26/07/2022,0203-Egmore,70169,109970,100,1520,48590,0,0,120379,8150,1900,10050,0,6750,6750,2345,1717,4062,2350,1877,4227,2501,26,441,4,0,8,58,1660,2197
2,26/07/2022,0205-Nehru Park,35871,39100,0,1184,9670,0,0,46725,1925,3200,5125,0,0,0,1290,355,1645,1184,339,1523,1235,8,99,0,0,2,29,326,464
2,26/07/2022,0207-Kilpauk,33234,48416,200,632,13620,0,0,47686,775,315,1090,0,0,0,1347,476,1823,1381,433,1814,1411,11,53,0,0,0,28,448,540
2,26/07/2022,0209-Pachaiyappas College,39466,44602,0,584,10360,0,0,50410,0,0,0,0,2500,2500,1528,396,1924,1432,367,1799,1447,10,54,0,0,1,17,373,455
2,26/07/2022,0211-Shenoy Nagar,34323,41158,0,416,10350,0,0,45089,0,0,0,0,2000,2000,1181,363,1544,1264,372,1636,1270,12,42,0,0,0,16,346,416
2,26/07/2022,0213-Anna Nagar East,83381,96768,0,1424,22620,0,0,107425,945,3315,4260,0,9000,9000,2844,828,3672,2934,786,3720,2951,18,119,0,0,2,46,769,954
2,26/07/2022,0215-Anna Nagar Tower,93048,82999,0,1168,20150,0,0,114366,4805,3545,8350,0,15750,15750,2321,727,3048,2391,700,3091,2449,24,171,0,0,1,44,669,909
2,26/07/2022,0217-Thirumangalam,231635,273352,700,5240,70340,0,0,307915,47110,24710,71820,0,1500,1500,7562,2396,9958,7669,2185,9854,7709,55,314,3,0,6,176,2208,2762
2,26/07/2022,0219-Koyambedu,157101,188077,1029,2440,64350,0,0,224920,6580,12490,19070,0,10500,10500,4894,2150,7044,4426,1709,6135,4589,46,452,5,0,7,80,2081,2671
2,26/07/2022,0221-Puratchi Thalaivi Dr. J. Jayalalithaa CMBT,61935,135030,0,1640,62280,0,0,125855,0,0,0,0,0,0,2236,2048,4284,2858,2739,5597,2843,50,388,14,0,3,64,2002,2521
2,26/07/2022,0223-Arumbakkam,49703,51837,0,992,19310,0,0,70005,1985,1415,3400,0,250,250,1345,696,2041,1415,513,1928,1326,29,2,0,0,5,28,660,724
2,26/07/2022,0225-Vadapalani,106861,183397,100,2784,69740,0,0,179485,8140,2240,10380,0,5000,5000,4061,2323,6384,4326,2185,6511,4393,37,368,5,0,5,109,2203,2727
2,26/07/2022,0227-Ashok Nagar,100293,117196,500,2296,35990,0,0,139079,5595,5670,11265,0,6000,6000,3061,1243,4304,3075,1128,4203,3143,34,200,1,0,0,84,1150,1469
2,26/07/2022,0229-Ekkattuthangal,84468,126268,300,1912,27560,0,0,114240,1595,245,1840,0,250,250,3726,990,4716,3854,886,4740,3980,37,286,0,0,3,73,902,1301
2,26/07/2022,0231-Arignar Anna Alandur,148617,175677,200,2584,46870,0,0,198271,7765,12300,20065,0,2500,2500,5082,1557,6639,4709,1425,6134,4997,38,456,3,0,2,98,1451,2048
2,26/07/2022,0233-St. Thomas Mount,74156,91126,205,2808,25670,0,0,102839,2725,3170,5895,0,3500,3500,2535,871,3406,2503,722,3225,2540,20,135,2,0,1,58,814,1030
1,27/07/2022,01ED-Wimco Nagar Depot Metro,68573,64574,570,800,20270,0,0,90213,245,370,615,0,1250,1250,1789,519,2308,1427,337,1764,1410,28,0,1,0,5,21,501,556
1,27/07/2022,01EF-Wimco Nagar Metro,99104,127704,440,2336,31900,0,0,133780,7830,6240,14070,0,1000,1000,3152,855,4007,2998,832,3830,3024,30,47,1,0,4,70,783,935
1,27/07/2022,01F1-Thiruvotriyur Metro,104511,95952,0,880,21420,0,0,126811,675,1130,1805,0,0,0,2622,608,3230,2540,544,3084,2495,36,0,0,0,4,29,584,653
1,27/07/2022,01F3-Thiruvotriyur Theradi Metro,88976,108548,500,1280,25480,0,0,116236,890,2900,3790,0,0,0,2660,724,3384,2791,800,3591,2851,49,86,2,0,9,40,683,869
1,27/07/2022,01F5-Kaladipet Metro,102106,94698,1011,1320,20700,0,0,125137,1255,2790,4045,0,0,0,2919,654,3573,2795,622,3417,2762,27,1,1,0,9,47,613,698
1,27/07/2022,01F7-Tollgate Metro,53361,54977,601,896,14750,0,0,69608,50,185,235,0,0,0,1542,477,2019,1488,348,1836,1487,27,0,0,0,3,31,443,504
1,27/07/2022,01F9-New Washermenpet Metro,77492,90132,277,1072,22880,0,0,101721,2540,1785,4325,0,500,500,2741,779,3520,2696,703,3399,2698,18,42,2,0,6,40,742,850
1,27/07/2022,01FB-Tondiarpet Metro,91626,92814,652,1296,23300,0,0,116874,1935,3815,5750,0,1250,1250,2720,781,3501,2746,748,3494,2719,29,2,0,1,7,50,728,817
1,27/07/2022,01FD-Thiagaraya College Metro,93784,106891,901,1352,25840,0,0,121877,6680,2720,9400,0,750,750,3345,901,4246,3326,830,4156,3324,80,24,1,0,3,49,853,1010
1,27/07/2022,0101-Washermanpet,94248,110122,1800,1344,36540,0,0,133932,5625,4245,9870,0,12250,12250,3272,1246,4518,3035,1083,4118,3068,25,73,2,0,5,55,1190,1350
1,27/07/2022,0103-Mannadi,77004,109450,100,768,34370,0,0,112242,10975,8700,19675,0,500,500,2898,1198,4096,3147,1148,4295,3169,23,84,0,0,1,32,1169,1309
1,27/07/2022,0105-High Court,127788,237708,910,2072,72630,0,0,203400,895,1580,2475,0,0,0,6748,2370,9118,6702,1925,8627,6785,45,178,0,0,6,88,2437,2754
1,27/07/2022,0109-Government Estate,74115,135288,974,1520,38170,0,0,114779,3550,3115,6665,0,4000,4000,3768,1372,5140,4020,1474,5494,4267,24,359,4,0,3,67,1294,1751
1,27/07/2022,0111-LIC,74162,162772,400,1640,30490,0,0,106692,2530,540,3070,0,0,0,4727,1072,5799,5331,979,6310,5313,25,0,0,0,5,67,996,1093
1,27/07/2022,0113-Thousand Lights,124061,220944,2700,2872,38050,0,0,167683,420,365,785,0,0,0,6631,1393,8024,7392,1264,8656,7355,40,0,1,0,4,121,1264,1430
1,27/07/2022,0115-AG-DMS,87971,138090,1000,1568,26490,0,0,117029,0,0,0,0,500,500,4382,909,5291,4299,835,5134,4426,24,128,0,0,1,64,840,1057
1,27/07/2022,0117-Teynampet,74499,135688,1200,1072,29700,0,0,106471,0,0,0,0,2500,2500,3988,1067,5055,4470,1127,5597,4425,24,1,0,0,2,47,1008,1082
1,27/07/2022,0119-Nandanam,87717,114320,22,1728,26010,0,0,115477,0,0,0,0,750,750,3464,982,4446,3820,801,4621,3790,35,0,0,0,4,72,896,1007
1,27/07/2022,0121-Saidapet,43349,81186,0,984,25490,0,0,69823,2970,2890,5860,0,5000,5000,1963,869,2832,2309,762,3071,2260,20,0,8,0,3,40,835,906
1,27/07/2022,0123-Little Mount,85159,84182,103,1544,21320,0,0,108126,3075,7555,10630,0,1000,1000,3045,810,3855,2473,565,3038,2557,14,143,7,0,0,65,738,967
1,27/07/2022,0125-Guindy,115778,233887,1200,4104,68420,0,0,189502,4025,7500,11525,0,500,500,6779,2355,9134,6436,1996,8432,6587,33,256,4,0,8,147,2200,2648
1,27/07/2022,0129-Nanganallur Road,48221,44743,500,1032,9760,0,0,59513,8345,7205,15550,0,0,0,1277,302,1579,1377,312,1689,1341,13,0,0,0,3,11,288,315
1,27/07/2022,0131-Meenambakkam,116372,125780,1000,2152,34040,0,0,153564,3495,12730,16225,0,0,0,3592,979,4571,3045,804,3849,3129,21,149,5,0,1,53,938,1167
1,27/07/2022,0133-Chennai International Airport,156079,294463,3400,6824,129980,0,0,296283,7775,13690,21465,0,10750,10750,5054,3537,8591,5273,3189,8462,5350,78,525,12,0,14,170,3386,4185
2,27/07/2022,0201-Puratchi Thalaivar Dr. M.G. Ramachandran Central,206058,406242,2462,6712,155750,0,0,370982,11245,3100,14345,0,5400,5400,11052,5517,16569,9726,6415,16141,10763,109,1552,10,0,18,284,5236,7209
2,27/07/2022,0203-Egmore,68786,121280,700,1776,46730,0,0,117992,6175,2150,8325,0,6250,6250,2621,1657,4278,2598,2411,5009,2990,17,692,11,0,8,73,1600,2401
2,27/07/2022,0205-Nehru Park,28883,41290,538,440,12680,0,0,42541,1145,2915,4060,0,750,750,1330,459,1789,1178,367,1545,1223,11,96,0,0,0,16,441,564
2,27/07/2022,0207-Kilpauk,34932,52240,400,752,15010,0,0,51094,660,360,1020,0,0,0,1453,539,1992,1451,524,1975,1492,14,89,0,0,0,28,512,643
2,27/07/2022,0209-Pachaiyappas College,42967,48092,1370,400,13430,0,0,58167,0,0,0,0,2000,2000,1607,510,2117,1446,444,1890,1480,18,57,0,0,0,17,482,574
2,27/07/2022,0211-Shenoy Nagar,30618,41464,522,296,10600,0,0,42036,0,0,0,0,2000,2000,1198,369,1567,1271,365,1636,1267,14,38,0,0,2,11,356,421
2,27/07/2022,0213-Anna Nagar East,62973,104488,1400,1320,28520,0,0,94213,900,3875,4775,0,0,0,2873,1006,3879,2957,912,3869,3007,14,128,1,0,4,45,952,1144
2,27/07/2022,0215-Anna Nagar Tower,72263,93466,700,1632,24790,0,0,99385,4070,7940,12010,0,2250,2250,2520,885,3405,2605,825,3430,2676,15,165,0,0,2,57,816,1055
2,27/07/2022,0217-Thirumangalam,224971,283468,1100,4912,75440,0,0,306423,55210,19865,75075,0,0,0,7589,2541,10130,7842,2255,10097,7873,51,337,5,0,7,151,2374,2925
2,27/07/2022,0219-Koyambedu,168896,199119,1491,2464,55090,0,0,227941,4515,9220,13735,0,4500,4500,5485,1867,7352,4520,1907,6427,5176,36,868,6,0,7,98,1783,2798
2,27/07/2022,0221-Puratchi Thalaivi Dr. J. Jayalalithaa CMBT,53086,143050,260,1640,68560,0,0,123546,0,0,0,0,0,0,2098,2215,4313,3129,3237,6366,2935,35,299,6,0,2,60,2171,2573
2,27/07/2022,0223-Arumbakkam,51377,54202,0,800,19710,0,0,71887,2110,2965,5075,0,10750,10750,1395,735,2130,1506,614,2120,1407,23,2,0,0,3,34,690,752
2,27/07/2022,0225-Vadapalani,96779,185853,750,3160,71470,0,0,172159,9450,1820,11270,0,5000,5000,4056,2397,6453,4238,2141,6379,4406,33,467,3,0,12,124,2273,2912
2,27/07/2022,0227-Ashok Nagar,67656,130719,1500,2416,49660,0,0,121232,4615,7385,12000,0,0,0,3077,1646,4723,3112,1306,4418,3117,27,149,3,0,2,85,1558,1824
2,27/07/2022,0229-Ekkattuthangal,75479,124122,200,1712,26230,0,0,103621,1975,4570,6545,0,0,0,3632,939,4571,3818,955,4773,3914,29,225,2,0,8,65,864,1193
2,27/07/2022,0231-Arignar Anna Alandur,143969,178558,1508,2872,52510,0,0,200859,5375,11020,16395,0,2750,2750,5053,1749,6802,4725,1474,6199,4900,53,355,1,0,1,101,1647,2158
2,27/07/2022,0233-St. Thomas Mount,82045,93505,4220,2656,25250,0,0,114171,1595,2855,4450,0,18250,18250,2625,857,3482,2560,740,3300,2649,23,142,2,0,5,80,772,1024
1,28/07/2022,01ED-Wimco Nagar Depot Metro,58821,55845,0,1608,19330,0,0,79759,75,365,440,0,250,250,1422,519,1941,1174,366,1540,1179,10,0,1,0,7,45,478,541
1,28/07/2022,01EF-Wimco Nagar Metro,83719,114882,526,1808,31700,0,0,117753,8280,4425,12705,0,1250,1250,2634,836,3470,2558,813,3371,2582,17,76,4,0,12,52,780,941
1,28/07/2022,01F1-Thiruvotriyur Metro,74847,80850,0,968,21540,0,0,97355,430,1020,1450,0,0,0,2046,589,2635,1995,499,2494,1974,24,2,1,0,4,31,556,618
1,28/07/2022,01F3-Thiruvotriyur Theradi Metro,81288,100591,0,1960,27888,0,0,111136,1060,2535,3595,0,0,0,2280,813,3093,2412,809,3221,2456,41,83,3,0,8,60,749,944
1,28/07/2022,01F5-Kaladipet Metro,66540,79961,520,992,23900,0,0,91952,1090,1920,3010,0,0,0,2210,713,2923,2170,712,2882,2078,25,0,0,0,8,34,683,750
1,28/07/2022,01F7-Tollgate Metro,45716,47220,78,880,13530,0,0,60204,40,180,220,0,0,0,1300,433,1733,1229,361,1590,1222,22,0,0,0,4,25,403,454
1,28/07/2022,01F9-New Washermenpet Metro,69418,78361,800,1440,21100,0,0,92758,995,1920,2915,0,250,250,2269,696,2965,2157,630,2787,2212,8,86,0,0,4,50,681,829
1,28/07/2022,01FB-Tondiarpet Metro,68675,80467,0,920,24190,0,0,93785,2060,3490,5550,0,250,250,2296,793,3089,2270,600,2870,2194,27,1,0,0,11,33,753,825
1,28/07/2022,01FD-Thiagaraya College Metro,88191,95290,0,1096,30150,0,0,119437,1550,2615,4165,0,250,250,2593,997,3590,2601,766,3367,2596,30,49,0,0,6,45,956,1086
1,28/07/2022,0101-Washermanpet,83622,106079,150,2168,40760,0,0,126700,10185,3635,13820,0,10250,10250,2811,1387,4198,2554,1171,3725,2641,20,143,2,0,8,79,1302,1554
1,28/07/2022,0103-Mannadi,70486,93942,50,696,34790,0,0,106022,14685,6330,21015,0,0,0,2381,1193,3574,2485,1140,3625,2491,19,98,2,0,4,30,1161,1314
1,28/07/2022,0105-High Court,136239,216775,500,2168,66130,0,0,205037,860,1485,2345,0,0,0,5954,2112,8066,5987,1834,7821,6085,34,241,0,0,5,81,2264,2625
1,28/07/2022,0109-Government Estate,83057,130633,335,2088,43160,0,0,128640,4225,2470,6695,0,250,250,3638,1580,5218,3574,1535,5109,3858,24,412,0,0,2,93,1478,2009
1,28/07/2022,0111-LIC,67408,126864,2400,1920,29780,0,0,101508,1740,445,2185,0,0,0,3534,1062,4596,3965,834,4799,3908,27,0,0,0,5,78,975,1085
1,28/07/2022,0113-Thousand Lights,125766,207342,1500,2576,43140,0,0,172982,410,220,630,0,0,0,6149,1537,7686,6701,1258,7959,6625,36,0,2,0,5,116,1407,1566
1,28/07/2022,0115-AG-DMS,76753,102994,100,1448,22770,0,0,101071,0,0,0,0,1000,1000,2947,762,3709,2987,687,3674,3113,27,159,1,0,1,53,711,952
1,28/07/2022,0117-Teynampet,67145,105104,1300,1456,25900,0,0,95801,0,0,0,0,0,0,2897,888,3785,3398,833,4231,3332,16,0,0,0,3,63,875,957
1,28/07/2022,0119-Nandanam,69979,101432,100,1704,26400,0,0,98183,0,0,0,0,750,750,2896,960,3856,3277,725,4002,3208,37,0,2,0,2,63,889,993
1,28/07/2022,0121-Saidapet,37467,60655,160,1096,21520,0,0,60243,5265,1765,7030,0,0,0,1420,731,2151,1631,630,2261,1604,8,2,2,0,3,45,691,751
1,28/07/2022,0123-Little Mount,70450,77082,220,976,21090,0,0,92736,2910,5625,8535,0,0,0,2518,745,3263,2199,585,2784,2268,17,179,0,0,0,43,692,931
1,28/07/2022,0125-Guindy,113306,199132,400,3744,58720,0,0,176170,4690,8440,13130,0,3000,3000,5666,2017,7683,5303,1933,7236,5539,31,400,3,0,12,146,1863,2455
1,28/07/2022,0129-Nanganallur Road,36694,43396,0,344,11560,0,0,48598,7400,7270,14670,0,0,0,1145,352,1497,1264,306,1570,1188,15,1,0,0,4,10,343,373
1,28/07/2022,0131-Meenambakkam,93403,110628,650,1808,33170,0,0,129031,4050,14195,18245,0,0,0,2992,936,3928,2525,828,3353,2621,21,171,3,0,3,56,895,1149
1,28/07/2022,0133-Chennai International Airport,137318,295528,1000,6024,142118,0,0,286460,10490,13150,23640,0,5250,5250,4537,3861,8398,4982,3736,8718,5002,64,539,12,0,19,162,3720,4516
2,28/07/2022,0201-Puratchi Thalaivar Dr. M.G. Ramachandran Central,215264,409280,4404,6488,152490,0,0,378646,10965,2025,12990,0,7050,7050,10535,5464,15999,9183,7421,16604,10775,87,2439,13,0,38,268,5215,8060
2,28/07/2022,0203-Egmore,58582,108586,1300,2152,53260,0,0,115294,4305,1930,6235,0,10500,10500,1881,1928,3809,2250,2362,4612,2242,15,397,8,0,1,86,1825,2332
2,28/07/2022,0205-Nehru Park,28585,40112,0,544,15490,0,0,44619,1565,3025,4590,0,0,0,1077,545,1622,991,435,1426,1030,10,89,1,0,0,20,521,641
2,28/07/2022,0207-Kilpauk,28722,46899,100,784,14690,0,0,44296,1145,130,1275,0,0,0,1177,540,1717,1268,492,1760,1290,19,93,0,0,4,35,502,653
2,28/07/2022,0209-Pachaiyappas College,45074,41793,0,912,11020,0,0,57006,0,0,0,0,10000,10000,1278,421,1699,1231,381,1612,1267,22,67,0,0,1,26,390,506
2,28/07/2022,0211-Shenoy Nagar,38965,38219,0,496,10950,0,0,50411,0,0,0,0,0,0,1024,382,1406,1064,395,1459,1095,19,77,3,0,3,19,363,484
2,28/07/2022,0213-Anna Nagar East,69936,92797,422,1456,27770,0,0,99584,795,2955,3750,0,3000,3000,2486,949,3435,2495,877,3372,2549,22,164,1,0,5,54,888,1134
2,28/07/2022,0215-Anna Nagar Tower,66093,80600,200,1352,23260,0,0,90905,7610,8920,16530,0,0,0,2148,798,2946,2123,734,2857,2225,26,223,7,0,1,42,747,1046
2,28/07/2022,0217-Thirumangalam,196461,269412,600,5464,85140,0,0,287665,74040,14055,88095,0,1500,1500,6611,2840,9451,6801,2429,9230,6900,68,458,3,0,12,193,2635,3369
2,28/07/2022,0219-Koyambedu,149386,173667,200,2632,65724,0,0,217942,4220,7235,11455,0,12250,12250,4187,2166,6353,3710,1718,5428,3913,45,558,3,0,10,96,2074,2786
2,28/07/2022,0221-Puratchi Thalaivi Dr. J. Jayalalithaa CMBT,41968,124450,0,1496,62240,0,0,105704,0,0,0,0,0,0,1761,2023,3784,2668,2812,5480,2411,24,262,2,0,0,54,1987,2329
2,28/07/2022,0223-Arumbakkam,53311,50365,0,864,20820,0,0,74995,4450,1840,6290,0,8500,8500,1225,736,1961,1285,556,1841,1187,27,5,0,0,7,26,705,770
2,28/07/2022,0225-Vadapalani,96384,185679,1080,3328,78770,0,0,179562,13760,4150,17910,0,2500,2500,3931,2615,6546,3814,2479,6293,4068,35,661,2,0,8,130,2492,3328
2,28/07/2022,0227-Ashok Nagar,75134,113204,748,1784,46360,0,0,124026,4940,5790,10730,0,1500,1500,2582,1527,4109,2707,1184,3891,2606,23,85,1,0,1,61,1470,1641
2,28/07/2022,0229-Ekkattuthangal,77876,113294,680,1496,26400,0,0,106452,1880,2090,3970,0,0,0,3297,923,4220,3361,804,4165,3482,16,234,2,0,7,59,859,1177
2,28/07/2022,0231-Arignar Anna Alandur,146688,166209,100,3032,41840,0,0,191660,4815,9225,14040,0,2750,2750,4703,1369,6072,4008,1437,5445,4648,34,891,4,0,10,106,1260,2305
2,28/07/2022,0233-St. Thomas Mount,63693,84936,750,1784,28920,0,0,95147,760,3635,4395,0,7750,7750,2179,953,3132,2094,806,2900,2152,21,153,0,0,1,65,882,1122
1,29/07/2022,01ED-Wimco Nagar Depot Metro,68153,61512,0,1320,18560,0,0,88033,150,470,620,0,500,500,1712,508,2220,1379,287,1666,1374,16,3,2,0,3,39,470,533
1,29/07/2022,01EF-Wimco Nagar Metro,102710,133309,0,2400,33810,0,0,138920,8570,5495,14065,0,0,0,3194,887,4081,3100,868,3968,3132,32,75,2,0,11,66,820,1006
1,29/07/2022,01F1-Thiruvotriyur Metro,93234,90673,0,1304,19350,0,0,113888,1535,790,2325,0,0,0,2564,570,3134,2442,541,2983,2419,31,22,1,0,1,36,529,620
1,29/07/2022,01F3-Thiruvotriyur Theradi Metro,94924,110665,1500,1360,27260,0,0,125044,1490,3395,4885,0,0,0,2724,785,3509,2839,828,3667,2886,34,87,1,0,5,42,739,908
1,29/07/2022,01F5-Kaladipet Metro,92009,86433,500,1040,18100,0,0,111649,1060,2575,3635,0,0,0,2771,570,3341,2640,549,3189,2591,19,0,0,0,2,33,536,590
1,29/07/2022,01F7-Tollgate Metro,48292,50517,100,888,11720,0,0,61000,70,95,165,0,0,0,1495,389,1884,1428,320,1748,1425,26,0,0,0,1,32,361,420
1,29/07/2022,01F9-New Washermenpet Metro,90199,86035,142,1248,21380,0,0,112969,2080,1665,3745,0,750,750,2691,766,3457,2672,697,3369,2609,22,27,3,0,1,48,720,821
1,29/07/2022,01FB-Tondiarpet Metro,84105,89860,224,1096,18280,0,0,103705,2520,3785,6305,0,1250,1250,2811,632,3443,2785,633,3418,2815,29,109,1,0,8,36,597,780
1,29/07/2022,01FD-Thiagaraya College Metro,92540,103881,850,1504,22710,0,0,117604,2590,1775,4365,0,250,250,3297,833,4130,3334,783,4117,3336,31,44,2,0,5,51,783,916
1,29/07/2022,0101-Washermanpet,97052,108623,0,1256,35300,0,0,133608,12770,4155,16925,0,10250,10250,3223,1165,4388,2920,1091,4011,2984,8,89,1,0,9,48,1111,1266
1,29/07/2022,0103-Mannadi,86322,101856,0,920,28430,0,0,115672,10515,6030,16545,0,1500,1500,2940,985,3925,3083,1067,4150,3083,11,72,1,0,2,36,957,1079
1,29/07/2022,0105-High Court,133318,221106,0,1696,59510,0,0,194524,1205,1645,2850,0,0,0,6311,2057,8368,6469,1693,8162,6591,40,221,0,0,3,74,1984,2322
1,29/07/2022,0109-Government Estate,89362,132877,200,1408,37740,0,0,128710,7195,5235,12430,0,750,750,3696,1333,5029,3951,1420,5371,4185,21,325,1,0,7,62,1257,1673
1,29/07/2022,0111-LIC,77146,159034,510,2224,29470,0,0,109350,1455,410,1865,0,2000,2000,4461,1051,5512,5210,933,6143,5198,29,2,4,0,1,78,963,1077
1,29/07/2022,0113-Thousand Lights,114787,220962,3160,3368,40730,0,0,162045,305,425,730,0,1000,1000,6371,1467,7838,7308,1303,8611,7257,18,0,0,0,4,136,1313,1471
1,29/07/2022,0115-AG-DMS,93486,140338,200,1960,28010,0,0,123656,0,0,0,0,250,250,4225,955,5180,4227,781,5008,4408,22,195,2,0,1,77,878,1175
1,29/07/2022,0117-Teynampet,75974,130493,0,1736,29220,0,0,106930,0,0,0,0,0,0,3880,1078,4958,4250,950,5200,4215,19,0,0,0,2,76,994,1091
1,29/07/2022,0119-Nandanam,85003,113996,740,1712,26910,0,0,114365,0,0,0,0,500,500,3406,1008,4414,3758,822,4580,3730,19,0,11,0,3,71,926,1030
1,29/07/2022,0121-Saidapet,50137,74998,500,808,22870,0,0,74315,2680,1945,4625,0,4250,4250,1938,787,2725,2155,718,2873,2094,20,0,0,0,2,35,756,813
1,29/07/2022,0123-Little Mount,73209,87370,0,1504,24570,0,0,99283,5570,6445,12015,0,0,0,2927,894,3821,2478,554,3032,2557,15,148,0,0,5,59,835,1062
1,29/07/2022,0125-Guindy,132382,238035,600,4496,72440,0,0,209918,5310,8220,13530,0,1500,1500,6852,2510,9362,6243,2119,8362,6522,24,415,5,0,7,178,2344,2973
1,29/07/2022,0129-Nanganallur Road,34704,44775,200,288,12930,0,0,48122,10325,5240,15565,0,0,0,1178,401,1579,1254,344,1598,1215,5,0,0,0,2,11,387,405
1,29/07/2022,0131-Meenambakkam,115571,129259,600,2496,38980,0,0,157647,3580,13020,16600,0,0,0,3607,1133,4740,2937,944,3881,3078,21,185,5,1,0,71,1082,1365
1,29/07/2022,0133-Chennai International Airport,153955,301214,350,7136,132000,0,0,293441,9940,12850,22790,0,7750,7750,5323,3637,8960,5266,3347,8613,5475,70,611,27,0,13,220,3444,4385
2,29/07/2022,0201-Puratchi Thalaivar Dr. M.G. Ramachandran Central,235060,438850,2960,7064,163510,0,0,408594,15230,1370,16600,0,3050,3050,11296,5654,16950,10191,6920,17111,11536,101,2070,20,0,17,301,5398,7907
2,29/07/2022,0203-Egmore,72070,120613,400,1960,50100,0,0,124530,5995,2030,8025,0,8750,8750,2431,1771,4202,2577,2334,4911,2848,22,520,10,0,11,78,1706,2347
2,29/07/2022,0205-Nehru Park,56077,42946,0,400,14730,0,0,71207,1470,2990,4460,0,26000,26000,1204,527,1731,1159,408,1567,1195,13,85,0,0,0,19,506,623
2,29/07/2022,0207-Kilpauk,35554,54276,400,728,17110,0,0,53792,740,260,1000,0,0,0,1400,610,2010,1451,473,1924,1490,13,77,0,0,3,34,578,705
2,29/07/2022,0209-Pachaiyappas College,35149,45294,275,432,11970,0,0,47826,0,0,0,0,2000,2000,1588,454,2042,1370,390,1760,1415,8,77,0,0,1,20,429,535
2,29/07/2022,0211-Shenoy Nagar,40439,42446,0,592,10800,0,0,51831,0,0,0,0,1000,1000,1218,376,1594,1242,378,1620,1276,16,68,0,0,0,22,356,462
2,29/07/2022,0213-Anna Nagar East,89382,103218,1150,1712,27380,0,0,119624,870,3550,4420,0,3000,3000,2838,987,3825,2922,903,3825,2996,31,130,2,1,4,58,917,1143
2,29/07/2022,0215-Anna Nagar Tower,75331,91119,0,1400,23930,0,0,100661,3020,3975,6995,0,250,250,2493,844,3337,2532,789,3321,2630,20,185,0,0,2,50,790,1047
2,29/07/2022,0217-Thirumangalam,232159,280820,900,7272,80820,0,0,321151,71665,18155,89820,0,0,0,7543,2760,10303,7410,2369,9779,7545,48,434,14,0,5,224,2513,3238
2,29/07/2022,0219-Koyambedu,162993,196465,660,3168,69620,0,0,236441,8315,12710,21025,15000,6500,21500,5025,2318,7343,4530,1820,6350,4677,57,401,11,0,9,117,2227,2822
2,29/07/2022,0221-Puratchi Thalaivi Dr. J. Jayalalithaa CMBT,55702,155501,0,1632,69960,0,0,127294,0,0,0,0,0,0,2131,2247,4378,3685,3894,7579,3337,42,302,2,0,4,67,2197,2614
2,29/07/2022,0223-Arumbakkam,42592,51424,0,792,18830,0,0,62214,2005,1570,3575,0,2250,2250,1399,705,2104,1442,611,2053,1339,19,4,5,0,6,32,669,735
2,29/07/2022,0225-Vadapalani,100979,183053,1100,3584,65680,0,0,171343,12250,3180,15430,0,1000,1000,4266,2262,6528,4225,2359,6584,4493,25,615,1,0,15,137,2116,2909
2,29/07/2022,0227-Ashok Nagar,74218,125322,0,2680,45880,0,0,122778,6455,5755,12210,0,3000,3000,3064,1565,4629,3099,1192,4291,3099,24,150,6,0,0,104,1459,1743
2,29/07/2022,0229-Ekkattuthangal,87735,124486,150,2496,31370,0,0,121751,5125,3455,8580,0,0,0,3537,1135,4672,3513,914,4427,3689,22,323,0,0,5,100,1027,1477
2,29/07/2022,0231-Arignar Anna Alandur,139564,190707,900,3712,61340,0,0,205516,6910,10785,17695,0,2500,2500,5099,2021,7120,4708,1715,6423,5022,43,490,6,0,2,122,1878,2541
2,29/07/2022,0233-St. Thomas Mount,74523,101097,350,2816,33020,0,0,110709,900,3410,4310,0,5000,5000,2760,1103,3863,2549,825,3374,2627,29,141,2,0,5,74,1026,1277
1,30/07/2022,01ED-Wimco Nagar Depot Metro,65064,59759,500,1504,22760,0,0,89828,75,350,425,0,4000,4000,1501,587,2088,1208,346,1554,1177,20,4,2,0,12,45,554,637
1,30/07/2022,01EF-Wimco Nagar Metro,125065,129201,600,2376,20660,0,0,148701,7555,4060,11615,0,2000,2000,3192,583,3775,2666,1090,3756,3232,21,682,3,0,11,69,506,1292
1,30/07/2022,01F1-Thiruvotriyur Metro,89880,89254,100,2184,27220,0,0,119384,320,970,1290,0,0,0,2219,764,2983,2130,643,2773,2070,31,0,0,0,9,57,698,795
1,30/07/2022,01F3-Thiruvotriyur Theradi Metro,77611,106612,0,2512,32210,0,0,112333,655,2395,3050,0,0,0,2372,930,3302,2531,1004,3535,2536,25,102,2,0,5,71,848,1053
1,30/07/2022,01F5-Kaladipet Metro,86790,86614,0,2016,27210,0,0,116016,845,1970,2815,0,0,0,2229,849,3078,2240,807,3047,2189,27,0,0,0,10,74,782,893
1,30/07/2022,01F7-Tollgate Metro,53480,47028,0,816,14130,0,0,68426,45,210,255,0,0,0,1279,441,1720,1249,444,1693,1211,24,0,0,0,9,29,414,476
1,30/07/2022,01F9-New Washermenpet Metro,78260,81650,100,4000,25190,0,0,107550,1085,1650,2735,0,500,500,2209,870,3079,2181,773,2954,2218,22,69,2,0,7,77,782,959
1,30/07/2022,01FB-Tondiarpet Metro,68947,82273,4450,1296,26910,0,0,101603,1260,2460,3720,0,250,250,2099,872,2971,2215,841,3056,2161,27,6,0,0,6,39,831,909
1,30/07/2022,01FD-Thiagaraya College Metro,96982,101518,0,2016,33690,0,0,132688,2210,4035,6245,0,500,500,2884,1153,4037,2757,1036,3793,2716,86,27,1,0,5,72,1082,1273
1,30/07/2022,0101-Washermanpet,95377,109071,0,1552,45310,0,0,142239,15080,5510,20590,0,20000,20000,2645,1501,4146,2500,1275,3775,2545,18,157,2,0,11,65,1432,1685
1,30/07/2022,0103-Mannadi,86496,99914,0,1104,25500,0,0,113100,11180,7075,18255,0,1500,1500,2744,878,3622,2646,1186,3832,2989,26,491,0,0,5,45,834,1401
1,30/07/2022,0105-High Court,106623,192813,0,3536,78530,0,0,188689,2195,3680,5875,0,0,0,4418,2630,7048,4491,2041,6532,4582,35,370,4,0,6,120,2503,3038
1,30/07/2022,0109-Government Estate,83137,141588,575,2120,53440,0,0,139272,3720,3115,6835,0,0,0,3389,1879,5268,3638,1782,5420,3808,19,447,3,0,7,92,1780,2348
1,30/07/2022,0111-LIC,53082,114082,130,2928,34900,0,0,91040,1850,320,2170,0,0,0,2635,1208,3843,3269,863,4132,3174,15,0,0,0,5,79,1109,1208
1,30/07/2022,0113-Thousand Lights,111592,184304,628,3296,52280,0,0,167796,330,490,820,0,2250,2250,4668,1810,6478,5476,1433,6909,5302,26,0,2,0,8,134,1677,1847
1,30/07/2022,0115-AG-DMS,62558,86708,0,1592,24970,0,0,89120,30,0,30,0,250,250,2229,845,3074,2299,690,2989,2378,14,155,1,0,2,60,785,1017
1,30/07/2022,0117-Teynampet,64465,98083,200,1584,29150,0,0,95399,0,0,0,0,0,0,2469,1052,3521,2967,930,3897,2832,20,0,0,0,3,63,983,1069
1,30/07/2022,0119-Nandanam,61466,79499,2200,2456,29160,0,0,95282,0,0,0,0,250,250,2000,1031,3031,2212,713,2925,2105,36,0,0,0,6,63,969,1074
1,30/07/2022,0121-Saidapet,54994,59382,0,1080,25000,0,0,81074,2600,2140,4740,0,8250,8250,1227,847,2074,1440,765,2205,1336,23,0,3,0,2,43,803,874
1,30/07/2022,0123-Little Mount,52644,65538,0,1448,24170,0,0,78262,4420,4850,9270,0,0,0,1808,842,2650,1501,554,2055,1619,14,223,1,0,2,53,793,1086
1,30/07/2022,0125-Guindy,116433,224596,300,5384,97810,0,0,219927,3785,3925,7710,0,500,500,4937,3210,8147,4675,2747,7422,4788,29,572,10,0,20,204,3029,3864
1,30/07/2022,0129-Nanganallur Road,42726,41266,0,408,15440,0,0,58574,9155,5315,14470,0,0,0,932,457,1389,1035,404,1439,954,18,1,2,0,3,14,445,483
1,30/07/2022,0131-Meenambakkam,119106,116152,0,2056,44430,0,0,165592,6035,9990,16025,0,0,0,2723,1223,3946,2248,1058,3306,2391,26,276,3,0,3,65,1187,1560
1,30/07/2022,0133-Chennai International Airport,159725,311102,800,7184,162540,0,0,330249,18185,9735,27920,0,6750,6750,4382,4414,8796,4579,4014,8593,4658,132,833,20,0,22,215,4235,5457
2,30/07/2022,0201-Puratchi Thalaivar Dr. M.G. Ramachandran Central,236104,430293,1090,8944,169540,0,0,415678,14530,1990,16520,0,4000,4000,10097,5798,15895,7848,7599,15447,10252,99,3336,13,0,20,348,5477,9293
2,30/07/2022,0203-Egmore,78929,123561,0,1976,58610,0,0,139515,4910,3760,8670,0,9750,9750,2091,2023,4114,2472,2465,4937,2526,17,552,13,0,14,83,1950,2629
2,30/07/2022,0205-Nehru Park,33982,47444,0,1256,21330,0,0,56568,2440,1845,4285,0,0,0,1063,733,1796,1036,541,1577,1079,16,124,0,0,4,45,683,872
2,30/07/2022,0207-Kilpauk,30238,48866,0,544,19160,0,0,49942,410,145,555,0,0,0,1130,641,1771,1213,571,1784,1183,12,92,0,0,1,24,619,748
2,30/07/2022,0209-Pachaiyappas College,30779,39230,0,640,11650,0,0,43069,0,0,0,0,6000,6000,1245,452,1697,1104,377,1481,1156,8,97,1,0,1,27,419,553
2,30/07/2022,0211-Shenoy Nagar,30921,39323,500,856,13600,0,0,45877,0,0,0,0,0,0,1013,483,1496,1046,486,1532,1054,15,80,6,0,1,31,452,585
2,30/07/2022,0213-Anna Nagar East,71195,100933,600,2240,34770,0,0,108805,1580,1875,3455,0,0,0,2446,1214,3660,2535,1081,3616,2573,24,207,0,0,6,86,1134,1457
2,30/07/2022,0215-Anna Nagar Tower,68746,87937,628,1672,29940,0,0,100986,2655,2915,5570,0,250,250,2135,1048,3183,2151,996,3147,2232,21,277,2,0,3,63,978,1344
2,30/07/2022,0217-Thirumangalam,196612,269191,600,6208,96680,0,0,300100,93120,16080,109200,0,1500,1500,6163,3211,9374,5964,3169,9133,6327,60,911,4,0,16,233,2985,4209
2,30/07/2022,0219-Koyambedu,139895,181594,0,3200,78390,0,0,221485,7365,8265,15630,0,10500,10500,3905,2604,6509,3634,2060,5694,3785,52,603,14,0,18,128,2498,3313
2,30/07/2022,0221-Puratchi Thalaivi Dr. J. Jayalalithaa CMBT,47645,155061,100,2736,81530,0,0,132011,0,0,0,0,0,0,1847,2652,4499,3189,3949,7138,2845,42,361,8,0,7,111,2577,3106
2,30/07/2022,0223-Arumbakkam,50418,50234,0,624,24620,0,0,75662,4725,1560,6285,0,9000,9000,1176,876,2052,1212,681,1893,1055,26,2,1,0,4,24,845,902
2,30/07/2022,0225-Vadapalani,117435,222511,2100,5976,100550,0,0,226061,25190,5180,30370,0,3500,3500,4316,3445,7761,4349,3223,7572,4662,39,985,8,0,16,245,3216,4509
2,30/07/2022,0227-Ashok Nagar,77349,120653,0,2344,53690,0,0,133383,7500,5715,13215,0,12000,12000,2525,1792,4317,2630,1487,4117,2576,32,239,1,0,1,87,1717,2077
2,30/07/2022,0229-Ekkattuthangal,69274,82725,100,1920,26360,0,0,97654,1865,2125,3990,0,250,250,2119,933,3052,2149,861,3010,2244,13,297,1,0,6,72,860,1249
2,30/07/2022,0231-Arignar Anna Alandur,124066,194165,450,5328,80390,0,0,210234,7760,7840,15600,0,1250,1250,4185,2555,6740,3853,2309,6162,4206,61,794,10,0,12,175,2401,3453
2,30/07/2022,0233-St. Thomas Mount,59577,101464,50,2896,43920,0,0,106443,2985,1555,4540,0,3500,3500,2168,1429,3597,2064,1218,3282,2125,25,263,3,0,3,108,1323,1725
1,02/08/2022,01ED-Wimco Nagar Depot Metro,97070,62775,100,1400,19480,0,0,118050,140,335,475,0,12000,12000,1721,505,2226,1410,311,1721,1382,20,0,8,0,7,30,483,548
1,02/08/2022,01EF-Wimco Nagar Metro,164161,129708,620,2424,19710,0,0,186915,10695,6220,16915,0,2250,2250,3522,554,4076,3044,819,3863,3368,32,389,5,0,5,60,486,977
1,02/08/2022,01F1-Thiruvotriyur Metro,139523,98889,280,1664,17280,0,0,158747,1030,575,1605,0,0,0,2801,506,3307,2570,524,3094,2705,32,145,1,0,4,46,458,686
1,02/08/2022,01F3-Thiruvotriyur Theradi Metro,121364,109561,0,1216,24890,0,0,147470,955,3040,3995,0,0,0,2672,717,3389,2795,867,3662,2898,37,132,4,0,6,41,676,896
1,02/08/2022,01F5-Kaladipet Metro,125159,90186,100,896,18042,0,0,144197,760,2755,3515,0,0,0,2823,577,3400,2734,506,3240,2711,31,0,0,0,1,31,551,614
1,02/08/2022,01F7-Tollgate Metro,69976,55755,1000,840,14028,0,0,85844,85,150,235,0,0,0,1569,454,2023,1554,371,1925,1530,26,0,0,0,5,28,428,487
1,02/08/2022,01F9-New Washermenpet Metro,125313,88641,1150,856,21470,0,0,148789,915,2000,2915,0,0,0,2675,719,3394,2679,714,3393,2675,23,41,1,0,2,35,690,792
1,02/08/2022,01FB-Tondiarpet Metro,94814,88729,1200,1304,20790,0,0,118108,1890,3205,5095,0,500,500,2630,704,3334,2728,648,3376,2709,28,1,0,0,5,47,659,740
1,02/08/2022,01FD-Thiagaraya College Metro,129825,106948,0,2040,22778,0,0,154643,3365,2825,6190,0,1500,1500,3403,852,4255,3402,742,4144,3444,79,35,5,0,5,71,775,970
1,02/08/2022,0101-Washermanpet,131579,107687,1000,1256,33950,0,0,167785,5245,6800,12045,0,23750,23750,3199,1153,4352,3006,1065,4071,3049,25,96,2,0,2,56,1093,1274
1,02/08/2022,0103-Mannadi,90814,102767,0,816,28790,0,0,120420,15525,10140,25665,0,0,0,2819,979,3798,3084,1010,4094,3118,32,99,0,0,1,31,953,1116
1,02/08/2022,0105-High Court,180472,252348,550,1712,78290,0,0,261024,1375,1525,2900,0,0,0,7053,2620,9673,7055,1996,9051,7112,43,213,1,0,6,71,2544,2878
1,02/08/2022,0109-Government Estate,103924,136510,1130,1600,41092,0,0,147746,3235,3135,6370,0,250,250,3772,1468,5240,4045,1446,5491,4211,40,289,0,1,4,69,1385,1788
1,02/08/2022,0111-LIC,111387,158807,2900,1976,28678,0,0,144941,960,830,1790,0,250,250,4569,1030,5599,5257,871,6128,5250,26,0,0,0,3,84,929,1042
1,02/08/2022,0113-Thousand Lights,166514,222203,1110,3448,39610,0,0,210682,470,490,960,0,0,0,6510,1452,7962,7427,1278,8705,7360,31,0,0,0,5,134,1307,1477
1,02/08/2022,0115-AG-DMS,134633,139980,500,1272,23420,0,0,159825,45,0,45,0,500,500,4543,812,5355,4448,752,5200,4573,32,164,0,0,2,52,755,1005
1,02/08/2022,0117-Teynampet,121257,130787,0,2328,26328,0,0,149913,0,0,0,0,0,0,3951,971,4922,4409,941,5350,4382,29,23,0,0,5,72,886,1015
1,02/08/2022,0119-Nandanam,117038,115504,1650,1408,25520,0,0,145616,0,0,0,0,0,0,3504,921,4425,3938,770,4708,3875,28,0,0,0,3,62,853,946
1,02/08/2022,0121-Saidapet,67769,72628,0,1200,19940,0,0,88909,2150,1910,4060,0,750,750,1870,712,2582,2192,649,2841,2142,18,0,0,0,2,48,661,729
1,02/08/2022,0123-Little Mount,98615,81930,70,1040,20080,0,0,119805,6055,5885,11940,0,1250,1250,2988,730,3718,2440,549,2989,2526,21,113,0,0,2,46,674,856
1,02/08/2022,0125-Guindy,178990,228515,50,5488,62580,0,0,247108,5175,5835,11010,0,500,500,6864,2179,9043,6400,1979,8379,6593,56,327,6,0,7,169,2010,2575
1,02/08/2022,0129-Nanganallur Road,73580,44357,500,352,9930,0,0,84362,9140,7015,16155,0,0,0,1252,309,1561,1347,305,1652,1311,5,0,0,0,1,11,296,313
1,02/08/2022,0131-Meenambakkam,155718,127400,700,1896,30936,0,0,189250,4955,11870,16825,0,0,0,3726,884,4610,3113,859,3972,3279,31,212,1,0,5,42,846,1137
1,02/08/2022,0133-Chennai International Airport,195842,290348,2900,4008,125790,0,0,328540,7405,14245,21650,0,11500,11500,5032,3340,8372,5323,3068,8391,5341,100,487,12,0,19,119,3251,3988
2,02/08/2022,0201-Puratchi Thalaivar Dr. M.G. Ramachandran Central,312332,394583,1904,6160,144110,0,0,464506,13820,2185,16005,0,6800,6800,11195,5042,16237,9300,6182,15482,10623,102,1811,12,7,11,263,4797,7003
2,02/08/2022,0203-Egmore,81871,110245,100,1864,46728,0,0,130563,7540,1815,9355,0,16000,16000,2421,1659,4080,2379,2113,4492,2600,27,506,12,0,9,73,1601,2228
2,02/08/2022,0205-Nehru Park,35032,38650,0,672,12140,0,0,47844,1560,2955,4515,0,0,0,1239,442,1681,1096,313,1409,1129,10,57,0,0,0,24,430,521
2,02/08/2022,0207-Kilpauk,37640,52298,0,584,16000,0,0,54224,940,355,1295,0,0,0,1367,578,1945,1454,509,1963,1473,11,72,2,0,1,25,553,664
2,02/08/2022,0209-Pachaiyappas College,84836,51494,0,552,12800,0,0,98188,0,0,0,0,27500,27500,1758,469,2227,1522,402,1924,1576,12,75,0,0,10,18,446,561
2,02/08/2022,0211-Shenoy Nagar,50600,42127,740,416,9900,0,0,61656,0,0,0,0,250,250,1220,345,1565,1321,372,1693,1328,13,43,0,0,3,17,329,405
2,02/08/2022,0213-Anna Nagar East,111542,105082,1800,1704,26526,0,0,141572,685,3640,4325,0,0,0,2912,958,3870,3016,855,3871,3103,29,148,0,0,1,69,887,1134
2,02/08/2022,0215-Anna Nagar Tower,95732,88542,330,1104,22190,0,0,119356,4015,8765,12780,250,250,500,2423,785,3208,2565,740,3305,2578,27,121,3,0,5,39,740,935
2,02/08/2022,0217-Thirumangalam,303574,280546,2970,5576,75188,0,0,387308,58335,19895,78230,0,500,500,7609,2496,10105,7675,2261,9936,7770,66,356,3,0,4,157,2330,2916
2,02/08/2022,0219-Koyambedu,204998,198904,1000,2384,68426,0,0,276808,5570,9710,15280,250,12250,12500,5101,2302,7403,4739,1809,6548,4812,43,351,1,0,9,93,2228,2725
2,02/08/2022,0221-Puratchi Thalaivi Dr. J. Jayalalithaa CMBT,68225,142292,0,1528,70800,0,0,140553,0,0,0,0,0,0,2100,2297,4397,3048,2995,6043,2811,40,235,8,0,6,59,2241,2589
2,02/08/2022,0223-Arumbakkam,69750,53176,0,1296,18384,0,0,89430,2350,1900,4250,0,15750,15750,1409,681,2090,1470,572,2042,1408,42,0,0,0,6,35,635,718
2,02/08/2022,0225-Vadapalani,143828,189502,2100,3344,75986,0,0,225258,8180,2570,10750,0,9000,9000,4110,2538,6648,4429,2255,6684,4420,55,324,0,0,11,131,2408,2929
2,02/08/2022,0227-Ashok Nagar,109876,118224,0,2440,36640,0,0,148956,8380,5755,14135,0,15500,15500,3115,1251,4366,3154,1145,4299,3178,36,178,4,0,1,79,1170,1468
2,02/08/2022,0229-Ekkattuthangal,109148,125448,3800,2064,26900,0,0,141912,2200,3885,6085,0,0,0,3618,978,4596,3832,848,4680,3955,22,236,1,0,7,85,891,1242
2,02/08/2022,0231-Arignar Anna Alandur,191959,181296,2100,2072,53480,0,0,249611,6685,9820,16505,500,4750,5250,5062,1741,6803,4697,1515,6212,4934,67,442,7,0,3,83,1657,2259
2,02/08/2022,0233-St. Thomas Mount,105515,96187,0,3896,28630,0,0,138041,1465,2685,4150,0,4500,4500,2597,951,3548,2538,911,3449,2600,28,135,0,0,3,76,873,1115
1,01/08/2022,01ED-Wimco Nagar Depot Metro,108070,67398,100,1520,24030,0,0,133720,400,290,690,0,7500,7500,1736,625,2361,1415,395,1810,1383,33,7,2,0,6,44,591,683
1,01/08/2022,01EF-Wimco Nagar Metro,167357,139764,1230,2752,39310,0,0,210649,13975,7965,21940,0,2500,2500,3167,1029,4196,3035,937,3972,3128,45,126,3,0,4,77,952,1207
1,01/08/2022,01F1-Thiruvotriyur Metro,166822,102608,100,1360,24690,0,0,192972,1535,775,2310,0,0,0,2677,696,3373,2661,606,3267,2615,38,0,2,0,6,45,650,741
1,01/08/2022,01F3-Thiruvotriyur Theradi Metro,148232,112198,0,1120,27750,0,0,177102,1435,2910,4345,0,0,0,2645,787,3432,2920,813,3733,2905,39,94,2,0,4,39,747,925
1,01/08/2022,01F5-Kaladipet Metro,172638,98985,100,1616,24820,0,0,199174,845,3105,3950,0,0,0,2828,758,3586,2793,671,3464,2773,30,0,0,0,5,48,711,794
1,01/08/2022,01F7-Tollgate Metro,91646,55070,0,912,17030,0,0,109588,50,590,640,0,250,250,1492,530,2022,1404,414,1818,1403,29,0,0,0,2,33,498,562
1,01/08/2022,01F9-New Washermenpet Metro,139021,92024,672,1112,25520,0,0,166325,815,2385,3200,0,1750,1750,2692,851,3543,2683,826,3509,2667,28,36,1,0,4,42,814,925
1,01/08/2022,01FB-Tondiarpet Metro,132271,91844,300,824,24440,0,0,157835,2065,3860,5925,0,250,250,2512,778,3290,2692,768,3460,2671,39,36,0,0,4,27,760,866
1,01/08/2022,01FD-Thiagaraya College Metro,154794,112515,0,1560,30190,0,0,186544,3430,4725,8155,0,2500,2500,3340,1043,4383,3359,895,4254,3359,34,39,2,0,3,55,993,1126
1,01/08/2022,0101-Washermanpet,124712,114459,2300,1656,42060,0,0,170728,6395,4415,10810,0,8250,8250,3159,1397,4556,2979,1255,4234,2996,23,87,2,0,2,56,1349,1519
1,01/08/2022,0103-Mannadi,102143,104012,700,928,29680,0,0,133451,54345,7465,61810,0,500,500,2762,1006,3768,3089,1292,4381,3103,26,93,0,1,0,38,971,1129
1,01/08/2022,0105-High Court,182388,228622,100,1848,68530,0,0,252866,1210,1670,2880,0,0,0,6387,2373,8760,6508,1848,8356,6542,44,151,0,0,3,76,2294,2568
1,01/08/2022,0109-Government Estate,103273,146476,850,2056,46070,0,0,152249,2825,2685,5510,0,1750,1750,3870,1653,5523,4179,1663,5842,4369,27,345,0,0,3,88,1550,2013
1,01/08/2022,0111-LIC,148184,161058,1800,2192,31782,0,0,183958,1255,555,1810,0,2000,2000,4416,1127,5543,5253,989,6242,5216,35,1,2,0,2,86,1023,1149
1,01/08/2022,0113-Thousand Lights,203011,219001,2550,3528,38840,0,0,247929,470,305,775,0,1250,1250,6387,1437,7824,7377,1326,8703,7262,38,0,0,0,5,137,1289,1469
1,01/08/2022,0115-AG-DMS,169118,143980,0,1736,28790,0,0,199644,0,0,0,0,2000,2000,4398,967,5365,4409,916,5325,4531,47,190,0,0,1,61,897,1196
1,01/08/2022,0117-Teynampet,110632,133415,500,2360,30430,0,0,143922,0,0,0,0,2000,2000,3826,1144,4970,4407,1081,5488,4322,34,2,1,0,3,78,1053,1171
1,01/08/2022,0119-Nandanam,127530,114136,130,1424,28830,0,0,157914,0,0,0,0,3250,3250,3179,1037,4216,3792,917,4709,3674,33,0,0,0,2,62,972,1069
1,01/08/2022,0121-Saidapet,77025,75264,150,1320,22630,0,0,101125,2770,2460,5230,0,7000,7000,1839,808,2647,2222,708,2930,2149,20,0,3,1,2,54,757,837
1,01/08/2022,0123-Little Mount,111001,87162,0,1944,22700,0,0,135645,5645,5940,11585,0,3250,3250,2955,815,3770,2582,596,3178,2645,30,132,3,0,2,61,762,990
1,01/08/2022,0125-Guindy,204415,243810,100,4432,78290,0,0,287237,7305,6770,14075,0,3000,3000,6782,2612,9394,6409,2416,8825,6509,43,381,1,0,6,180,2453,3064
1,01/08/2022,0129-Nanganallur Road,80012,44163,500,448,10790,0,0,91750,6060,7040,13100,0,0,0,1242,332,1574,1307,334,1641,1256,12,1,3,0,0,8,321,345
1,01/08/2022,0131-Meenambakkam,164021,135212,550,1880,41800,0,0,208251,4595,13225,17820,0,0,0,3622,1156,4778,3078,990,4068,3173,41,195,0,0,1,53,1142,1432
1,01/08/2022,0133-Chennai International Airport,226419,320809,250,6496,151911,0,0,385076,11300,12885,24185,0,6000,6000,5107,4109,9216,5397,3571,8968,5455,83,518,14,0,13,196,3937,4761
2,01/08/2022,0201-Puratchi Thalaivar Dr. M.G. Ramachandran Central,346441,436975,1240,10816,143450,0,0,501947,31185,3200,34385,0,6600,6600,13081,5127,18208,9161,6978,16139,11911,142,3207,3,0,19,397,4739,8507
2,01/08/2022,0203-Egmore,98400,122801,100,2872,54600,0,0,155972,8030,2675,10705,0,17750,17750,2625,1943,4568,2298,2007,4305,2687,21,607,3,0,9,115,1843,2598
2,01/08/2022,0205-Nehru Park,51617,40140,100,368,13170,0,0,65255,2660,4255,6915,0,4500,4500,1196,494,1690,1130,426,1556,1142,11,62,0,0,2,16,472,563
2,01/08/2022,0207-Kilpauk,48064,53667,0,800,15640,0,0,64504,575,265,840,0,0,0,1397,580,1977,1475,578,2053,1533,19,79,0,0,2,43,540,683
2,01/08/2022,0209-Pachaiyappas College,62491,46526,200,592,13260,0,0,76543,0,0,0,0,6000,6000,1490,505,1995,1356,449,1805,1374,6,65,0,0,1,23,480,575
2,01/08/2022,0211-Shenoy Nagar,49149,43013,100,472,10950,0,0,60671,0,0,0,0,1000,1000,1210,389,1599,1314,403,1717,1324,7,63,13,1,2,20,371,477
2,01/08/2022,0213-Anna Nagar East,119059,103213,500,1696,28230,0,0,149485,560,3670,4230,0,0,0,2810,1019,3829,2926,937,3863,2987,37,143,2,0,2,69,945,1198
2,01/08/2022,0215-Anna Nagar Tower,106493,93459,230,1456,26470,0,0,134649,5120,3825,8945,250,3250,3500,2395,931,3326,2643,893,3536,2628,30,148,0,0,2,56,862,1098
2,01/08/2022,0217-Thirumangalam,351854,285247,800,8504,81160,0,0,442318,69450,19045,88495,0,0,0,7496,2700,10196,7732,2493,10225,7707,62,428,7,0,5,170,2527,3199
2,01/08/2022,0219-Koyambedu,251394,211567,200,3320,76820,0,0,331734,11350,14660,26010,9250,22500,31750,5308,2538,7846,4729,1900,6629,4939,73,559,6,0,6,136,2447,3227
2,01/08/2022,0221-Puratchi Thalaivi Dr. J. Jayalalithaa CMBT,68439,168985,0,2736,92570,0,0,163745,0,0,0,0,0,0,2547,3012,5559,3050,3296,6346,2962,47,403,8,0,6,110,2945,3519
2,01/08/2022,0223-Arumbakkam,70285,54784,200,1224,20070,0,0,91779,5095,2150,7245,0,3750,3750,1367,715,2082,1501,571,2072,1436,40,2,1,0,7,42,674,766
2,01/08/2022,0225-Vadapalani,134473,185358,1600,2944,77590,0,0,216607,14190,3040,17230,0,9000,9000,3817,2581,6398,4246,2409,6655,4132,52,355,3,0,12,107,2470,2999
2,01/08/2022,0227-Ashok Nagar,119108,124113,600,2048,41400,0,0,163156,8010,6520,14530,0,11000,11000,3140,1364,4504,3275,1329,4604,3220,38,187,4,0,2,64,1299,1594
2,01/08/2022,0229-Ekkattuthangal,125398,126179,2300,1712,27470,0,0,156880,3820,4390,8210,0,0,0,3451,983,4434,3859,1024,4883,3926,28,254,3,0,5,74,897,1261
2,01/08/2022,0231-Arignar Anna Alandur,224496,193654,550,4768,64320,0,0,294134,7065,8330,15395,5000,4000,9000,5060,2071,7131,4745,1777,6522,4993,69,493,5,0,5,113,1956,2641
2,01/08/2022,0233-St. Thomas Mount,134890,97072,100,2328,25510,0,0,162828,2265,3675,5940,0,2250,2250,2670,849,3519,2550,909,3459,2709,48,244,3,0,6,83,778,1162
1,02/08/2022,01ED-Wimco Nagar Depot Metro,97070,62775,100,1400,19480,0,0,118050,140,335,475,0,12000,12000,1721,505,2226,1410,311,1721,1382,20,0,8,0,7,30,483,548
1,02/08/2022,01EF-Wimco Nagar Metro,164161,129708,620,2424,19710,0,0,186915,10695,6220,16915,0,2250,2250,3522,554,4076,3044,819,3863,3368,32,389,5,0,5,60,486,977
1,02/08/2022,01F1-Thiruvotriyur Metro,139523,98889,280,1664,17280,0,0,158747,1030,575,1605,0,0,0,2801,506,3307,2570,524,3094,2705,32,145,1,0,4,46,458,686
1,02/08/2022,01F3-Thiruvotriyur Theradi Metro,121364,109561,0,1216,24890,0,0,147470,955,3040,3995,0,0,0,2672,717,3389,2795,867,3662,2898,37,132,4,0,6,41,676,896
1,02/08/2022,01F5-Kaladipet Metro,125159,90186,100,896,18042,0,0,144197,760,2755,3515,0,0,0,2823,577,3400,2734,506,3240,2711,31,0,0,0,1,31,551,614
1,02/08/2022,01F7-Tollgate Metro,69976,55755,1000,840,14028,0,0,85844,85,150,235,0,0,0,1569,454,2023,1554,371,1925,1530,26,0,0,0,5,28,428,487
1,02/08/2022,01F9-New Washermenpet Metro,125313,88641,1150,856,21470,0,0,148789,915,2000,2915,0,0,0,2675,719,3394,2679,714,3393,2675,23,41,1,0,2,35,690,792
1,02/08/2022,01FB-Tondiarpet Metro,94814,88729,1200,1304,20790,0,0,118108,1890,3205,5095,0,500,500,2630,704,3334,2728,648,3376,2709,28,1,0,0,5,47,659,740
1,02/08/2022,01FD-Thiagaraya College Metro,129825,106948,0,2040,22778,0,0,154643,3365,2825,6190,0,1500,1500,3403,852,4255,3402,742,4144,3444,79,35,5,0,5,71,775,970
1,02/08/2022,0101-Washermanpet,131579,107687,1000,1256,33950,0,0,167785,5245,6800,12045,0,23750,23750,3199,1153,4352,3006,1065,4071,3049,25,96,2,0,2,56,1093,1274
1,02/08/2022,0103-Mannadi,90814,102767,0,816,28790,0,0,120420,15525,10140,25665,0,0,0,2819,979,3798,3084,1010,4094,3118,32,99,0,0,1,31,953,1116
1,02/08/2022,0105-High Court,180472,252348,550,1712,78290,0,0,261024,1375,1525,2900,0,0,0,7053,2620,9673,7055,1996,9051,7112,43,213,1,0,6,71,2544,2878
1,02/08/2022,0109-Government Estate,103924,136510,1130,1600,41092,0,0,147746,3235,3135,6370,0,250,250,3772,1468,5240,4045,1446,5491,4211,40,289,0,1,4,69,1385,1788
1,02/08/2022,0111-LIC,111387,158807,2900,1976,28678,0,0,144941,960,830,1790,0,250,250,4569,1030,5599,5257,871,6128,5250,26,0,0,0,3,84,929,1042
1,02/08/2022,0113-Thousand Lights,166514,222203,1110,3448,39610,0,0,210682,470,490,960,0,0,0,6510,1452,7962,7427,1278,8705,7360,31,0,0,0,5,134,1307,1477
1,02/08/2022,0115-AG-DMS,134633,139980,500,1272,23420,0,0,159825,45,0,45,0,500,500,4543,812,5355,4448,752,5200,4573,32,164,0,0,2,52,755,1005
1,02/08/2022,0117-Teynampet,121257,130787,0,2328,26328,0,0,149913,0,0,0,0,0,0,3951,971,4922,4409,941,5350,4382,29,23,0,0,5,72,886,1015
1,02/08/2022,0119-Nandanam,117038,115504,1650,1408,25520,0,0,145616,0,0,0,0,0,0,3504,921,4425,3938,770,4708,3875,28,0,0,0,3,62,853,946
1,02/08/2022,0121-Saidapet,67769,72628,0,1200,19940,0,0,88909,2150,1910,4060,0,750,750,1870,712,2582,2192,649,2841,2142,18,0,0,0,2,48,661,729
1,02/08/2022,0123-Little Mount,98615,81930,70,1040,20080,0,0,119805,6055,5885,11940,0,1250,1250,2988,730,3718,2440,549,2989,2526,21,113,0,0,2,46,674,856
1,02/08/2022,0125-Guindy,178990,228515,50,5488,62580,0,0,247108,5175,5835,11010,0,500,500,6864,2179,9043,6400,1979,8379,6593,56,327,6,0,7,169,2010,2575
1,02/08/2022,0129-Nanganallur Road,73580,44357,500,352,9930,0,0,84362,9140,7015,16155,0,0,0,1252,309,1561,1347,305,1652,1311,5,0,0,0,1,11,296,313
1,02/08/2022,0131-Meenambakkam,155718,127400,700,1896,30936,0,0,189250,4955,11870,16825,0,0,0,3726,884,4610,3113,859,3972,3279,31,212,1,0,5,42,846,1137
1,02/08/2022,0133-Chennai International Airport,195842,290348,2900,4008,125790,0,0,328540,7405,14245,21650,0,11500,11500,5032,3340,8372,5323,3068,8391,5341,100,487,12,0,19,119,3251,3988
2,02/08/2022,0201-Puratchi Thalaivar Dr. M.G. Ramachandran Central,312332,394583,1904,6160,144110,0,0,464506,13820,2185,16005,0,6800,6800,11195,5042,16237,9300,6182,15482,10623,102,1811,12,7,11,263,4797,7003
2,02/08/2022,0203-Egmore,81871,110245,100,1864,46728,0,0,130563,7540,1815,9355,0,16000,16000,2421,1659,4080,2379,2113,4492,2600,27,506,12,0,9,73,1601,2228
2,02/08/2022,0205-Nehru Park,35032,38650,0,672,12140,0,0,47844,1560,2955,4515,0,0,0,1239,442,1681,1096,313,1409,1129,10,57,0,0,0,24,430,521
2,02/08/2022,0207-Kilpauk,37640,52298,0,584,16000,0,0,54224,940,355,1295,0,0,0,1367,578,1945,1454,509,1963,1473,11,72,2,0,1,25,553,664
2,02/08/2022,0209-Pachaiyappas College,84836,51494,0,552,12800,0,0,98188,0,0,0,0,27500,27500,1758,469,2227,1522,402,1924,1576,12,75,0,0,10,18,446,561
2,02/08/2022,0211-Shenoy Nagar,50600,42127,740,416,9900,0,0,61656,0,0,0,0,250,250,1220,345,1565,1321,372,1693,1328,13,43,0,0,3,17,329,405
2,02/08/2022,0213-Anna Nagar East,111542,105082,1800,1704,26526,0,0,141572,685,3640,4325,0,0,0,2912,958,3870,3016,855,3871,3103,29,148,0,0,1,69,887,1134
2,02/08/2022,0215-Anna Nagar Tower,95732,88542,330,1104,22190,0,0,119356,4015,8765,12780,250,250,500,2423,785,3208,2565,740,3305,2578,27,121,3,0,5,39,740,935
2,02/08/2022,0217-Thirumangalam,303574,280546,2970,5576,75188,0,0,387308,58335,19895,78230,0,500,500,7609,2496,10105,7675,2261,9936,7770,66,356,3,0,4,157,2330,2916
2,02/08/2022,0219-Koyambedu,204998,198904,1000,2384,68426,0,0,276808,5570,9710,15280,250,12250,12500,5101,2302,7403,4739,1809,6548,4812,43,351,1,0,9,93,2228,2725
2,02/08/2022,0221-Puratchi Thalaivi Dr. J. Jayalalithaa CMBT,68225,142292,0,1528,70800,0,0,140553,0,0,0,0,0,0,2100,2297,4397,3048,2995,6043,2811,40,235,8,0,6,59,2241,2589
2,02/08/2022,0223-Arumbakkam,69750,53176,0,1296,18384,0,0,89430,2350,1900,4250,0,15750,15750,1409,681,2090,1470,572,2042,1408,42,0,0,0,6,35,635,718
2,02/08/2022,0225-Vadapalani,143828,189502,2100,3344,75986,0,0,225258,8180,2570,10750,0,9000,9000,4110,2538,6648,4429,2255,6684,4420,55,324,0,0,11,131,2408,2929
2,02/08/2022,0227-Ashok Nagar,109876,118224,0,2440,36640,0,0,148956,8380,5755,14135,0,15500,15500,3115,1251,4366,3154,1145,4299,3178,36,178,4,0,1,79,1170,1468
2,02/08/2022,0229-Ekkattuthangal,109148,125448,3800,2064,26900,0,0,141912,2200,3885,6085,0,0,0,3618,978,4596,3832,848,4680,3955,22,236,1,0,7,85,891,1242
2,02/08/2022,0231-Arignar Anna Alandur,191959,181296,2100,2072,53480,0,0,249611,6685,9820,16505,500,4750,5250,5062,1741,6803,4697,1515,6212,4934,67,442,7,0,3,83,1657,2259
2,02/08/2022,0233-St. Thomas Mount,105515,96187,0,3896,28630,0,0,138041,1465,2685,4150,0,4500,4500,2597,951,3548,2538,911,3449,2600,28,135,0,0,3,76,873,1115
1,03/08/2022,01ED-Wimco Nagar Depot Metro,83257,65815,0,960,22062,0,0,106279,130,390,520,0,4000,4000,1793,574,2367,1419,335,1754,1394,25,4,1,0,2,25,544,601
1,03/08/2022,01EF-Wimco Nagar Metro,129022,136347,400,2864,35056,0,0,167342,8865,6510,15375,0,500,500,3220,938,4158,3097,772,3869,3172,29,71,3,0,9,80,856,1048
1,03/08/2022,01F1-Thiruvotriyur Metro,118091,100552,100,1072,23398,0,0,142661,615,1100,1715,0,0,0,2698,641,3339,2610,568,3178,2594,34,11,0,1,6,34,605,691
1,03/08/2022,01F3-Thiruvotriyur Theradi Metro,104449,108083,1001,1504,24426,0,0,131380,970,2790,3760,0,0,0,2678,721,3399,2859,818,3677,2891,42,60,4,0,9,45,670,830
1,03/08/2022,01F5-Kaladipet Metro,116938,94750,200,1624,21426,0,0,140188,925,2755,3680,0,0,0,2902,681,3583,2794,617,3411,2766,26,0,0,0,6,46,633,711
1,03/08/2022,01F7-Tollgate Metro,62686,53003,0,712,13206,0,0,76604,85,85,170,0,250,250,1551,426,1977,1466,374,1840,1458,28,0,0,0,2,26,400,456
1,03/08/2022,01F9-New Washermenpet Metro,101169,93801,500,888,22542,0,0,125099,1030,1880,2910,0,1000,1000,2829,755,3584,2806,709,3515,2813,18,41,1,0,6,38,713,817
1,03/08/2022,01FB-Tondiarpet Metro,108661,95905,1400,1264,22324,0,0,133649,2135,3385,5520,0,1250,1250,2749,726,3475,2911,785,3696,2877,30,2,0,0,9,37,684,762
1,03/08/2022,01FD-Thiagaraya College Metro,117622,112045,0,1816,28434,0,0,147872,2830,2625,5455,0,250,250,3510,968,4478,3394,867,4261,3416,75,37,1,0,5,41,926,1085
1,03/08/2022,0101-Washermanpet,119812,113004,0,1288,37688,0,0,158788,11440,5055,16495,0,12750,12750,3342,1295,4637,3013,1178,4191,3096,24,128,1,0,1,57,1226,1437
1,03/08/2022,0103-Mannadi,81975,101074,800,920,28980,0,0,112675,13735,7415,21150,0,3000,3000,2752,996,3748,3008,1063,4071,3032,21,89,0,0,0,36,959,1105
1,03/08/2022,0105-High Court,163161,232739,0,1808,63968,0,0,228937,745,2010,2755,0,0,0,6540,2195,8735,6853,1862,8715,6903,43,152,1,0,7,73,2104,2380
1,03/08/2022,0109-Government Estate,94231,136820,666,1616,39400,0,0,135913,3545,2635,6180,0,0,0,3763,1380,5143,4025,1506,5531,4255,33,324,1,0,4,65,1297,1724
1,03/08/2022,0111-LIC,94261,163568,1050,1912,31118,0,0,128341,1310,925,2235,0,500,500,4559,1115,5674,5349,985,6334,5328,24,0,2,0,1,77,1008,1112
1,03/08/2022,0113-Thousand Lights,155935,225652,450,3312,39442,0,0,199139,490,405,895,0,2000,2000,6634,1457,8091,7534,1407,8941,7503,29,0,0,0,4,142,1290,1465
1,03/08/2022,0115-AG-DMS,136768,141523,900,1600,25438,0,0,164706,0,5,5,0,2000,2000,4496,873,5369,4463,791,5254,4586,40,129,0,0,1,68,787,1025
1,03/08/2022,0117-Teynampet,109103,135649,90,1952,29352,0,0,140497,0,0,0,0,2000,2000,3982,1082,5064,4459,1013,5472,4433,21,1,0,0,7,79,991,1099
1,03/08/2022,0119-Nandanam,100053,117683,700,1560,26828,0,0,129141,0,0,0,0,0,0,3493,954,4447,3910,887,4797,3888,34,26,0,0,4,58,890,1012
1,03/08/2022,0121-Saidapet,50336,77207,0,1040,23116,0,0,74492,5480,2345,7825,0,4000,4000,1915,807,2722,2228,700,2928,2203,19,0,3,0,2,46,753,823
1,03/08/2022,0123-Little Mount,85980,86160,1150,1096,21932,0,0,110158,5950,6420,12370,0,750,750,2970,774,3744,2521,612,3133,2605,34,130,0,0,0,44,725,933
1,03/08/2022,0125-Guindy,175445,243354,1200,5312,71786,0,0,253743,4370,4725,9095,0,0,0,7135,2469,9604,6405,2199,8604,6701,43,323,3,1,22,184,2269,2845
1,03/08/2022,0129-Nanganallur Road,63003,47533,500,464,10850,0,0,74817,5980,7315,13295,0,0,0,1319,344,1663,1446,317,1763,1397,15,0,3,0,5,14,316,353
1,03/08/2022,0131-Meenambakkam,150705,130046,500,1912,36078,0,0,189195,4425,11205,15630,0,0,0,3706,1024,4730,3043,892,3935,3188,39,191,2,0,1,62,973,1268
1,03/08/2022,0133-Chennai International Airport,166917,294638,2000,5576,128610,0,0,303103,12915,12820,25735,0,3750,3750,4956,3521,8477,5313,3458,8771,5370,74,388,13,1,18,162,3032,3688
2,03/08/2022,0201-Puratchi Thalaivar Dr. M.G. Ramachandran Central,229549,410112,1000,6928,168656,0,0,406133,16285,2090,18375,0,7550,7550,10818,5825,16643,9366,6490,15856,10322,104,1385,7,0,15,286,5539,7336
2,03/08/2022,0203-Egmore,84620,112779,500,1704,53552,0,0,140376,5910,2405,8315,0,10250,10250,2184,1906,4090,2362,2333,4695,2414,31,354,8,0,9,73,1834,2309
2,03/08/2022,0205-Nehru Park,46037,43952,200,584,14740,0,0,61561,1545,3545,5090,0,4750,4750,1336,541,1877,1185,531,1716,1234,11,99,0,0,0,26,512,648
2,03/08/2022,0207-Kilpauk,41253,54061,0,768,15874,0,0,57895,465,180,645,0,250,250,1416,576,1992,1510,524,2034,1538,12,70,0,0,2,32,544,660
2,03/08/2022,0209-Pachaiyappas College,47157,48164,600,464,13256,0,0,61477,110,50,160,0,6500,6500,1590,479,2069,1408,377,1785,1461,14,73,0,0,0,12,456,555
2,03/08/2022,0211-Shenoy Nagar,43532,44006,100,616,11086,0,0,55334,0,0,0,0,250,250,1239,396,1635,1354,392,1746,1349,8,53,0,0,3,15,379,458
2,03/08/2022,0213-Anna Nagar East,86243,103006,600,1296,27796,0,0,115935,645,4135,4780,0,0,0,2899,1009,3908,2922,886,3808,2965,32,146,0,0,3,57,942,1180
2,03/08/2022,0215-Anna Nagar Tower,83520,88298,500,1616,23910,0,0,109546,4685,7875,12560,0,0,0,2314,834,3148,2451,800,3251,2515,15,146,0,0,3,53,775,992
2,03/08/2022,0217-Thirumangalam,262376,293614,620,5392,85304,0,0,353692,58660,19415,78075,0,0,0,7719,2816,10535,7686,2450,10136,7848,55,354,3,0,10,186,2626,3234
2,03/08/2022,0219-Koyambedu,202338,207128,2400,2848,67158,0,0,274744,5075,8765,13840,7000,10000,17000,5458,2221,7679,4657,1929,6586,5098,62,619,1,0,12,108,2069,2871
2,03/08/2022,0221-Puratchi Thalaivi Dr. J. Jayalalithaa CMBT,58421,144815,200,1376,72940,0,0,132937,0,0,0,0,0,0,2086,2338,4424,2969,3199,6168,2839,44,253,6,0,3,59,2282,2647
2,03/08/2022,0223-Arumbakkam,64455,56189,0,1072,20840,0,0,86367,2890,1440,4330,0,8750,8750,1502,751,2253,1467,610,2077,1428,66,2,2,0,7,42,697,816
2,03/08/2022,0225-Vadapalani,124866,193072,400,3840,75198,0,0,204304,9080,1480,10560,0,6000,6000,4219,2543,6762,4276,2467,6743,4537,43,482,9,0,4,145,2377,3060
2,03/08/2022,0227-Ashok Nagar,97750,128254,450,1824,44452,0,0,144476,5160,7010,12170,0,3000,3000,3254,1496,4750,3138,1270,4408,3243,32,204,2,0,0,78,1410,1726
2,03/08/2022,0229-Ekkattuthangal,86381,128355,640,2816,32280,0,0,122117,2025,4520,6545,0,500,500,3561,1160,4721,3647,983,4630,3819,29,234,0,0,3,84,1046,1396
2,03/08/2022,0231-Arignar Anna Alandur,158998,188487,600,3024,59178,0,0,221800,7740,9005,16745,0,3250,3250,5073,1939,7012,4793,1787,6580,5009,60,402,4,0,7,117,1819,2409
2,03/08/2022,0233-St. Thomas Mount,87165,94894,500,1656,28624,0,0,117945,2115,2705,4820,0,3750,3750,2559,937,3496,2503,847,3350,2572,31,142,7,0,0,64,863,1107
1,04/08/2022,01ED-Wimco Nagar Depot Metro,75787,66182,0,1976,21016,0,0,98779,275,325,600,0,2000,2000,1709,566,2275,1437,377,1814,1446,21,0,8,0,5,45,527,606
1,04/08/2022,01EF-Wimco Nagar Metro,119270,125385,700,2232,30540,0,0,152742,7890,7440,15330,0,2250,2250,3110,804,3914,2912,780,3692,2982,22,98,5,0,9,63,743,940
1,04/08/2022,01F1-Thiruvotriyur Metro,98508,95388,1210,1256,23670,0,0,124644,585,530,1115,0,0,0,2539,649,3188,2438,562,3000,2421,35,7,0,0,5,41,609,697
1,04/08/2022,01F3-Thiruvotriyur Theradi Metro,93020,104584,58,1288,22940,0,0,117306,905,2950,3855,0,0,0,2583,664,3247,2753,746,3499,2818,29,97,3,0,1,43,608,781
1,04/08/2022,01F5-Kaladipet Metro,104488,92021,0,1536,22510,0,0,128534,1265,2920,4185,0,0,0,2589,711,3300,2654,613,3267,2665,29,0,0,0,1,57,651,738
1,04/08/2022,01F7-Tollgate Metro,62442,52926,0,648,13506,0,0,76596,75,260,335,0,0,0,1386,425,1811,1469,390,1859,1456,14,0,1,0,1,23,388,427
1,04/08/2022,01F9-New Washermenpet Metro,87479,82878,50,472,19718,0,0,107719,1235,1485,2720,0,750,750,2372,647,3019,2525,654,3179,2536,20,36,2,0,3,21,626,708
1,04/08/2022,01FB-Tondiarpet Metro,75190,86005,0,1312,23258,0,0,99760,2510,3065,5575,0,250,250,2143,763,2906,2538,710,3248,2527,25,3,0,0,6,40,723,797
1,04/08/2022,01FD-Thiagaraya College Metro,98983,103602,0,1216,25044,0,0,125243,3630,2195,5825,0,0,0,3013,867,3880,3271,805,4076,3280,48,32,2,0,5,52,816,955
1,04/08/2022,0101-Washermanpet,105427,99858,1100,1712,31334,0,0,139573,6605,3590,10195,0,13500,13500,2545,1068,3613,2766,1107,3873,2823,17,95,4,0,5,66,1013,1200
1,04/08/2022,0103-Mannadi,75727,94590,700,1456,25978,0,0,103861,8050,7820,15870,0,1500,1500,2425,921,3346,2771,1029,3800,2853,24,110,0,0,0,58,867,1059
1,04/08/2022,0105-High Court,143519,208967,0,1872,58616,0,0,204007,1525,1540,3065,0,0,0,6507,2047,8554,6058,1686,7744,6104,39,161,2,0,3,78,1950,2233
1,04/08/2022,0109-Government Estate,81366,128811,765,1752,37660,0,0,121543,4335,3020,7355,0,4000,4000,3580,1365,4945,3790,1373,5163,3973,30,288,3,0,3,74,1270,1668
1,04/08/2022,0111-LIC,83339,153444,630,2088,33390,0,0,119447,1035,975,2010,0,2000,2000,4509,1173,5682,4796,874,5670,4790,20,0,0,0,2,84,1075,1181
1,04/08/2022,0113-Thousand Lights,142139,200772,400,3576,36634,0,0,182749,595,455,1050,0,0,0,6374,1364,7738,6601,1202,7803,6549,43,0,0,0,3,139,1197,1382
1,04/08/2022,0115-AG-DMS,116864,138682,600,2272,23844,0,0,143580,0,0,0,0,2250,2250,4462,857,5319,4420,747,5167,4563,50,138,2,0,0,91,743,1024
1,04/08/2022,0117-Teynampet,86003,143747,10,2488,39942,0,0,128443,0,0,0,0,500,500,4134,1409,5543,4345,1327,5672,4340,47,0,1,0,3,99,1301,1451
1,04/08/2022,0119-Nandanam,92010,107244,1250,1664,24642,0,0,119566,0,0,0,0,250,250,3266,886,4152,3614,730,4344,3584,33,0,0,0,2,68,814,917
1,04/08/2022,0121-Saidapet,54325,72968,0,856,22870,0,0,78051,4895,2085,6980,0,12000,12000,1875,761,2636,2103,646,2749,2049,10,1,1,0,2,40,719,773
1,04/08/2022,0123-Little Mount,88772,80261,700,888,20272,0,0,110632,2820,5735,8555,0,250,250,2931,727,3658,2390,538,2928,2484,16,139,0,0,3,37,686,881
1,04/08/2022,0125-Guindy,134309,221859,900,4904,67400,0,0,207513,4295,5345,9640,0,0,0,6643,2302,8945,5936,2058,7994,6197,45,337,2,0,8,187,2061,2640
1,04/08/2022,0129-Nanganallur Road,59540,46210,600,488,11376,0,0,72004,4615,6260,10875,0,0,0,1291,350,1641,1404,319,1723,1336,15,0,0,0,0,15,329,359
1,04/08/2022,0131-Meenambakkam,130107,120966,18,2064,33580,0,0,165769,3885,13625,17510,0,0,0,3454,998,4452,2941,813,3754,3038,23,134,6,0,3,67,831,1064
1,04/08/2022,0133-Chennai International Airport,169246,302065,0,6176,135170,0,0,310592,10875,13245,24120,0,6750,6750,5196,3680,8876,5394,3307,8701,5424,60,471,17,0,19,167,3396,4130
2,04/08/2022,0201-Puratchi Thalaivar Dr. M.G. Ramachandran Central,259510,405086,2618,10040,140732,0,0,412900,13705,2145,15850,0,4700,4700,10789,4934,15723,9751,6317,16068,11237,91,2008,13,0,8,317,4622,7059
2,04/08/2022,0203-Egmore,74442,109985,500,1800,49468,0,0,126210,6855,4225,11080,0,10750,10750,2266,1751,4017,2363,2329,4692,2464,15,388,9,0,11,69,1683,2175
2,04/08/2022,0205-Nehru Park,35039,39297,100,592,12706,0,0,48437,2345,3995,6340,0,0,0,1225,466,1691,1082,334,1416,1119,10,73,0,0,1,23,438,545
2,04/08/2022,0207-Kilpauk,42495,48314,50,896,13950,0,0,57391,475,325,800,0,0,0,1407,507,1914,1348,461,1809,1405,3,68,0,0,1,35,475,582
2,04/08/2022,0209-Pachaiyappas College,44392,41548,0,376,10140,0,0,54908,540,790,1330,0,2000,2000,1552,391,1943,1339,396,1735,1356,14,59,0,0,0,17,370,460
2,04/08/2022,0211-Shenoy Nagar,46407,43175,0,816,10400,0,0,57623,0,0,0,0,250,250,1282,361,1643,1317,370,1687,1352,9,48,0,0,3,21,336,417
2,04/08/2022,0213-Anna Nagar East,84412,100402,800,1368,26198,0,0,112778,750,3515,4265,0,3000,3000,2923,934,3857,2941,835,3776,2985,22,135,0,0,5,56,865,1083
2,04/08/2022,0215-Anna Nagar Tower,87317,90162,400,1072,24130,0,0,112919,5545,8455,14000,0,1750,1750,2477,848,3325,2514,781,3295,2574,22,152,0,0,1,41,792,1008
2,04/08/2022,0217-Thirumangalam,259070,283433,600,5800,79656,0,0,345126,65725,22245,87970,0,500,500,7533,2691,10224,7566,2355,9921,7714,66,376,6,0,5,195,2484,3132
2,04/08/2022,0219-Koyambedu,194820,203603,1240,2976,71576,0,0,270612,14705,8660,23365,0,21750,21750,5210,2404,7614,4684,1824,6508,4849,59,427,5,0,13,114,2281,2899
2,04/08/2022,0221-Puratchi Thalaivi Dr. J. Jayalalithaa CMBT,64094,148082,0,1240,72750,0,0,138084,0,0,0,0,0,0,2163,2300,4463,3175,3181,6356,2943,84,312,7,0,7,48,2269,2727
2,04/08/2022,0223-Arumbakkam,57690,54051,500,1480,19380,0,0,79050,3345,1920,5265,0,6500,6500,1498,701,2199,1492,507,1999,1419,61,3,2,0,10,47,642,765
2,04/08/2022,0225-Vadapalani,125957,180000,200,2480,71846,0,0,200483,12640,2820,15460,0,5000,5000,4014,2359,6373,4093,2197,6290,4190,40,417,4,0,7,96,2237,2801
2,04/08/2022,0227-Ashok Nagar,100540,125697,340,2784,40724,0,0,144388,5815,6985,12800,0,6500,6500,3200,1358,4558,3173,1167,4340,3293,37,289,6,0,2,83,1262,1679
2,04/08/2022,0229-Ekkattuthangal,94794,120651,350,2064,25768,0,0,122976,1565,2130,3695,0,250,250,3590,920,4510,3592,875,4467,3802,30,314,2,0,4,83,814,1247
2,04/08/2022,0231-Arignar Anna Alandur,154873,177063,130,3000,52838,0,0,210841,7685,8435,16120,0,3250,3250,4855,1727,6582,4530,1449,5979,4798,52,418,3,0,3,100,1621,2197
2,04/08/2022,0233-St. Thomas Mount,88710,91984,300,2472,26412,0,0,117894,1695,2740,4435,0,4000,4000,2597,864,3461,2410,787,3197,2528,24,184,4,0,2,69,782,1065
1,05/08/2022,01ED-Wimco Nagar Depot Metro,78214,64017,0,752,19870,0,0,98836,185,1020,1205,0,3500,3500,1739,504,2243,1423,314,1737,1409,21,5,2,0,6,20,483,537
1,05/08/2022,01EF-Wimco Nagar Metro,106266,122753,1160,2648,29702,0,0,139776,8250,7160,15410,0,3250,3250,3018,805,3823,2891,826,3717,2938,32,65,2,0,2,74,723,898
1,05/08/2022,01F1-Thiruvotriyur Metro,111266,91245,940,1152,22244,0,0,135602,635,870,1505,0,0,0,2520,607,3127,2339,540,2879,2279,38,5,0,0,5,34,561,643
1,05/08/2022,01F3-Thiruvotriyur Theradi Metro,97980,109415,80,1184,29370,0,0,128614,910,2735,3645,0,0,0,2660,846,3506,2743,849,3592,2771,36,89,3,0,3,39,796,966
1,05/08/2022,01F5-Kaladipet Metro,92374,93333,10,1360,22940,0,0,116684,1030,2555,3585,0,0,0,2759,721,3480,2650,675,3325,2637,17,0,1,0,6,47,674,745
1,05/08/2022,01F7-Tollgate Metro,60728,56338,0,976,16054,0,0,77758,90,330,420,0,0,0,1523,537,2060,1495,396,1891,1475,19,1,0,0,8,33,482,543
1,05/08/2022,01F9-New Washermenpet Metro,91295,87960,0,840,22812,0,0,114947,885,1595,2480,0,750,750,2599,782,3381,2563,650,3213,2601,22,70,2,0,2,33,743,872
1,05/08/2022,01FB-Tondiarpet Metro,75381,87807,20,1352,21310,0,0,98063,1550,3085,4635,0,250,250,2485,710,3195,2614,690,3304,2594,21,0,0,0,4,44,664,733
1,05/08/2022,01FD-Thiagaraya College Metro,102059,103436,736,1336,26528,0,0,130659,5810,3220,9030,0,500,500,3267,934,4201,3125,815,3940,3127,61,32,1,0,2,47,892,1035
1,05/08/2022,0101-Washermanpet,102007,106284,350,1608,35400,0,0,139365,12040,3040,15080,0,12000,12000,3053,1198,4251,2848,1138,3986,2898,34,82,0,0,5,61,1140,1322
1,05/08/2022,0103-Mannadi,75837,102022,330,1448,30432,0,0,108047,12540,7575,20115,0,0,0,2722,1052,3774,2996,1042,4038,3014,23,103,2,0,1,47,1003,1179
1,05/08/2022,0105-High Court,133227,213443,300,1832,61596,0,0,196955,965,2570,3535,0,0,0,6016,2116,8132,6223,1576,7799,6229,42,131,0,0,4,67,2035,2279
1,05/08/2022,0109-Government Estate,81694,138426,990,1800,43490,0,0,127974,4465,2385,6850,0,3000,3000,3655,1552,5207,3888,1348,5236,4110,17,320,0,0,4,71,1455,1867
1,05/08/2022,0111-LIC,61686,139347,1700,1536,28778,0,0,93700,1550,560,2110,0,500,500,3883,981,4864,4489,834,5323,4457,16,0,0,0,3,63,907,989
1,05/08/2022,0113-Thousand Lights,127423,213108,450,3280,37352,0,0,168505,620,420,1040,0,1000,1000,6348,1389,7737,7123,1132,8255,7061,32,0,1,0,3,141,1186,1363
1,05/08/2022,0115-AG-DMS,95822,134523,0,1944,27866,0,0,125632,100,0,100,0,1000,1000,4218,957,5175,4043,689,4732,4197,26,158,1,0,1,79,865,1130
1,05/08/2022,0117-Teynampet,83899,140208,200,2024,32932,0,0,119055,0,0,0,0,0,0,4054,1189,5243,4477,955,5432,4438,41,1,0,1,4,79,1099,1225
1,05/08/2022,0119-Nandanam,94084,114792,900,1784,32228,0,0,128996,0,0,0,0,750,750,3252,1153,4405,3606,813,4419,3541,25,0,0,0,2,78,1067,1172
1,05/08/2022,0121-Saidapet,48197,72855,500,1320,22966,0,0,72983,1945,2050,3995,0,2000,2000,1857,794,2651,2047,605,2652,2007,19,6,3,0,5,49,740,822
1,05/08/2022,0123-Little Mount,91657,92050,800,1480,24160,0,0,118097,6720,7415,14135,250,2500,2750,3126,875,4001,2563,669,3232,2704,24,184,0,0,8,56,816,1088
1,05/08/2022,0125-Guindy,118769,230329,50,5408,73546,0,0,197773,4510,4985,9495,0,500,500,6529,2580,9109,5965,1927,7892,6239,48,318,3,0,14,205,2278,2866
1,05/08/2022,0129-Nanganallur Road,37456,44072,150,624,11146,0,0,49376,8735,7160,15895,0,0,0,1217,361,1578,1280,318,1598,1256,21,0,2,0,1,23,319,366
1,05/08/2022,0131-Meenambakkam,115907,119940,2150,1600,37202,0,0,156859,5790,14320,20110,0,0,0,3406,1054,4460,2732,838,3570,2834,28,137,4,0,5,52,998,1224
1,05/08/2022,0133-Chennai International Airport,163052,306825,2700,7968,118020,0,0,291740,8770,12705,21475,0,6250,6250,5669,3236,8905,5382,3577,8959,5995,65,1077,17,0,11,193,2956,4319
2,05/08/2022,0201-Puratchi Thalaivar Dr. M.G. Ramachandran Central,215198,425268,3740,8136,148966,0,0,376040,13545,2485,16030,0,5700,5700,10867,5215,16082,10153,6828,16981,11527,94,2078,3,0,21,319,4852,7367
2,05/08/2022,0203-Egmore,71034,122272,0,1808,57812,0,0,130654,8470,2705,11175,0,13750,13750,2177,2023,4200,2567,2359,4926,2635,21,354,4,0,18,78,1940,2415
2,05/08/2022,0205-Nehru Park,38047,40118,0,432,12924,0,0,51403,870,2555,3425,0,4500,4500,1182,482,1664,1088,369,1457,1116,6,80,0,0,1,18,458,563
2,05/08/2022,0207-Kilpauk,32057,48856,0,864,13878,0,0,46799,450,580,1030,0,250,250,1339,517,1856,1389,489,1878,1422,11,67,3,0,2,41,461,585
2,05/08/2022,0209-Pachaiyappas College,39702,42138,200,736,11560,0,0,52198,530,540,1070,0,4000,4000,1343,447,1790,1267,343,1610,1285,9,83,0,0,1,20,421,534
2,05/08/2022,0211-Shenoy Nagar,33048,39022,1700,728,10394,0,0,45870,0,0,0,0,3000,3000,1119,367,1486,1165,363,1528,1179,7,53,0,0,0,29,335,424
2,05/08/2022,0213-Anna Nagar East,80377,100779,900,1408,27562,0,0,110247,740,3370,4110,0,0,0,2751,995,3746,2838,917,3755,2888,17,132,0,0,2,62,924,1137
2,05/08/2022,0215-Anna Nagar Tower,66835,86318,100,1912,22932,0,0,91779,4280,7095,11375,0,1000,1000,2376,802,3178,2380,743,3123,2459,19,184,4,0,0,53,741,1001
2,05/08/2022,0217-Thirumangalam,232304,284130,1550,6232,83454,0,0,323540,65175,17905,83080,0,1500,1500,7541,2852,10393,7424,2339,9763,7537,58,451,4,0,6,208,2593,3320
2,05/08/2022,0219-Koyambedu,176373,199314,0,3648,71798,0,0,251819,4845,9205,14050,2500,19250,21750,5031,2363,7394,4493,1911,6404,4682,45,449,8,0,14,141,2259,2916
2,05/08/2022,0221-Puratchi Thalaivi Dr. J. Jayalalithaa CMBT,62007,153173,0,1832,69278,0,0,133117,0,0,0,0,0,0,2079,2274,4353,3798,3955,7753,3314,80,217,12,0,5,79,2203,2596
2,05/08/2022,0223-Arumbakkam,49521,52128,0,784,19702,0,0,70007,1630,1485,3115,0,5000,5000,1389,537,1926,1415,500,1915,1325,38,3,4,0,5,31,685,766
2,05/08/2022,0225-Vadapalani,105741,185895,2992,3544,74834,0,0,187111,11630,2620,14250,0,4000,4000,4026,2586,6612,4279,2302,6581,4307,37,396,4,0,9,139,2414,2999
2,05/08/2022,0227-Ashok Nagar,99916,123448,100,2560,39060,0,0,141636,7980,6045,14025,0,12000,12000,3263,1339,4602,3062,1165,4227,3269,27,348,0,0,2,93,1211,1681
2,05/08/2022,0229-Ekkattuthangal,84542,122891,1727,2864,31000,0,0,120133,340,560,900,0,0,0,3548,1137,4685,3419,863,4282,3648,15,290,1,0,7,115,998,1426
2,05/08/2022,0231-Arignar Anna Alandur,133092,180710,100,3680,56860,0,0,193732,7940,10355,18295,0,3750,3750,4830,1873,6703,4387,1552,5939,4729,59,467,4,0,5,126,1751,2412
2,05/08/2022,0233-St. Thomas Mount,76640,99930,0,1992,29260,0,0,107892,955,5080,6035,0,6750,6750,2775,988,3763,2406,831,3237,2678,35,346,10,0,0,80,876,1347
1,06/08/2022,01ED-Wimco Nagar Depot Metro,60215,66272,0,1656,28360,0,0,90231,65,245,310,0,2500,2500,1494,718,2212,1212,396,1608,1203,16,0,0,0,6,46,674,742
1,06/08/2022,01EF-Wimco Nagar Metro,100609,127986,0,2256,45556,0,0,148421,8000,5240,13240,0,0,0,2685,1143,3828,2525,1028,3553,2543,34,102,2,0,14,64,1080,1296
1,06/08/2022,01F1-Thiruvotriyur Metro,96971,93651,1100,1688,29060,0,0,128819,720,750,1470,0,0,0,2312,797,3109,2214,714,2928,2160,56,0,0,0,9,54,738,857
1,06/08/2022,01F3-Thiruvotriyur Theradi Metro,94469,111180,0,2744,28272,0,0,125485,865,2400,3265,0,0,0,2621,846,3467,2546,939,3485,2741,36,260,9,0,12,89,753,1159
1,06/08/2022,01F5-Kaladipet Metro,87354,85764,0,1608,26570,0,0,115532,730,1920,2650,0,0,0,2214,816,3030,2257,721,2978,2190,19,0,1,0,9,53,765,847
1,06/08/2022,01F7-Tollgate Metro,47933,48153,300,960,14718,0,0,63911,180,370,550,0,0,0,1339,504,1843,1255,455,1710,1224,20,1,1,0,10,25,452,509
1,06/08/2022,01F9-New Washermenpet Metro,77071,81910,1000,1208,25950,0,0,105229,1010,1720,2730,0,0,0,2271,831,3102,2092,821,2913,2183,18,146,0,0,7,43,788,1002
1,06/08/2022,01FB-Tondiarpet Metro,70986,83071,380,1640,28208,0,0,101214,1775,2525,4300,0,1000,1000,2081,916,2997,2189,762,2951,2151,29,1,2,0,5,52,855,944
1,06/08/2022,01FD-Thiagaraya College Metro,104586,110749,600,1880,38480,0,0,145546,7255,5560,12815,0,2250,2250,3028,1263,4291,2937,1027,3964,2900,107,63,3,0,9,67,1193,1442
1,06/08/2022,0101-Washermanpet,90747,104765,250,2176,43016,0,0,136189,6005,5920,11925,0,9250,9250,2615,1462,4077,2536,1288,3824,2514,21,101,5,0,8,85,1364,1584
1,06/08/2022,0103-Mannadi,78834,96518,0,1336,33750,0,0,113920,7660,6245,13905,0,1500,1500,2426,1140,3566,2574,1184,3758,2630,27,173,1,0,4,57,1080,1342
1,06/08/2022,0105-High Court,100404,195016,0,2880,73642,0,0,176926,2135,1745,3880,0,0,0,4696,2470,7166,4734,2057,6791,4871,26,362,0,0,13,105,2315,2821
1,06/08/2022,0109-Government Estate,75627,136958,100,1856,49018,0,0,126601,5845,4745,10590,0,750,750,3403,1730,5133,3451,1681,5132,3743,32,523,13,0,2,76,1615,2261
1,06/08/2022,0111-LIC,76656,127430,400,1936,37326,0,0,116318,1460,335,1795,0,0,0,3041,1273,4314,3687,1021,4708,3646,23,0,0,0,4,83,1176,1286
1,06/08/2022,0113-Thousand Lights,99017,173610,1780,3592,46082,0,0,150471,460,250,710,0,0,0,4529,1648,6177,5206,1400,6606,5100,29,0,0,0,1,140,1399,1569
1,06/08/2022,0115-AG-DMS,71153,91953,0,2288,24004,0,0,97445,0,25,25,0,1250,1250,2456,729,3185,2423,764,3187,2604,8,196,1,0,3,86,755,1049
1,06/08/2022,0117-Teynampet,74848,104034,2400,1960,29712,0,0,108920,0,0,0,0,0,0,2637,1088,3725,3143,989,4132,3055,19,0,0,0,5,79,990,1093
1,06/08/2022,0119-Nandanam,55597,95424,0,2744,38476,0,0,96817,0,0,0,0,0,0,2230,1379,3609,2456,939,3395,2377,26,0,5,0,8,104,1243,1386
1,06/08/2022,0121-Saidapet,46421,60217,200,1648,24738,0,0,73007,3515,1115,4630,0,6500,6500,1282,849,2131,1456,811,2267,1398,12,0,0,0,3,64,754,833
1,06/08/2022,0123-Little Mount,69622,65011,0,1112,22192,0,0,92926,7355,3845,11200,0,6000,6000,1910,771,2681,1549,620,2169,1675,19,211,0,0,6,37,724,997
1,06/08/2022,0125-Guindy,107672,223525,40,4664,93932,0,0,206308,4075,3015,7090,0,500,500,5012,3128,8140,4699,2673,7372,4933,45,541,2,0,19,172,2714,3493
1,06/08/2022,0129-Nanganallur Road,43107,42745,0,768,14810,0,0,58685,11425,5360,16785,0,0,0,987,476,1463,1076,465,1541,1018,18,0,3,0,3,26,435,485
1,06/08/2022,0131-Meenambakkam,103503,113415,300,2360,44236,0,0,150399,5695,12450,18145,0,0,0,2630,1236,3866,2199,1127,3326,2305,29,240,3,0,3,74,1169,1518
1,06/08/2022,0133-Chennai International Airport,143160,323399,700,9256,167242,0,0,320358,13130,10125,23255,0,2250,2250,4439,4619,9058,4817,3992,8809,4938,59,778,15,0,15,290,4084,5241
2,06/08/2022,0201-Puratchi Thalaivar Dr. M.G. Ramachandran Central,229801,422026,725,9776,156948,0,0,397250,12125,2105,14230,0,3050,3050,10197,5569,15766,8044,7642,15686,10484,94,3268,18,0,30,392,5101,8903
2,06/08/2022,0203-Egmore,65339,125550,530,2408,63620,0,0,131897,6160,2040,8200,0,4000,4000,2003,2221,4224,2520,2598,5118,2463,23,439,14,0,20,99,2086,2681
2,06/08/2022,0205-Nehru Park,36231,52843,100,960,26068,0,0,63359,1590,1630,3220,0,2000,2000,1099,819,1918,1100,604,1704,1078,22,115,5,0,11,40,827,1020
2,06/08/2022,0207-Kilpauk,27014,46729,0,552,16470,0,0,44036,405,245,650,0,250,250,1225,571,1796,1179,533,1712,1225,14,125,0,0,2,27,531,699
2,06/08/2022,0209-Pachaiyappas College,30707,40921,950,808,12438,0,0,44903,790,610,1400,0,2000,2000,1268,470,1738,1157,401,1558,1182,13,79,0,0,3,24,432,551
2,06/08/2022,0211-Shenoy Nagar,35060,35875,1200,984,11950,0,0,49194,0,0,0,0,0,0,919,430,1349,927,424,1351,974,7,84,1,0,1,41,383,517
2,06/08/2022,0213-Anna Nagar East,76080,105816,300,1576,36948,0,0,114904,870,2265,3135,0,3000,3000,2648,1302,3950,2679,1078,3757,2730,20,255,0,1,7,68,1211,1562
2,06/08/2022,0215-Anna Nagar Tower,55895,90188,0,1792,32060,0,0,89747,4725,4810,9535,0,0,0,2081,1143,3224,2156,969,3125,2235,19,302,0,0,0,70,1046,1437
2,06/08/2022,0217-Thirumangalam,185716,265076,1900,5968,102886,0,0,296470,97570,16875,114445,0,0,0,5867,3430,9297,5915,3075,8990,6000,56,677,7,0,7,231,3168,4146
2,06/08/2022,0219-Koyambedu,139030,184833,200,3008,82626,0,0,224864,6220,5015,11235,0,9750,9750,3950,2662,6612,3536,2093,5629,3752,53,671,10,0,12,130,2571,3447
2,06/08/2022,0221-Puratchi Thalaivi Dr. J. Jayalalithaa CMBT,60134,163127,300,2056,81710,0,0,144200,0,0,0,0,0,0,2026,2664,4690,3578,4179,7757,3123,56,485,7,0,5,85,2534,3172
2,06/08/2022,0223-Arumbakkam,45182,52159,0,1144,24756,0,0,71082,1835,610,2445,0,4500,4500,1167,613,1780,1203,655,1858,1111,45,6,5,0,5,40,824,925
2,06/08/2022,0225-Vadapalani,102743,219148,450,6040,95126,0,0,204359,23170,4910,28080,0,4000,4000,4372,3340,7712,4310,3333,7643,4686,39,923,3,0,11,248,3030,4254
2,06/08/2022,0227-Ashok Nagar,102476,127035,0,4888,47146,0,0,154510,8910,4020,12930,0,12000,12000,2899,1576,4475,2683,1478,4161,3012,37,535,9,0,4,112,1438,2135
2,06/08/2022,0229-Ekkattuthangal,70549,84065,160,1896,29582,0,0,102187,540,755,1295,0,1000,1000,2112,1028,3140,2024,850,2874,2192,22,323,0,0,4,82,929,1360
2,06/08/2022,0231-Arignar Anna Alandur,123430,187419,300,3968,80022,0,0,207720,8555,9100,17655,0,2750,2750,3943,2299,6242,3801,2164,5965,3990,64,599,7,0,13,121,2383,3187
2,06/08/2022,0233-St. Thomas Mount,71720,99593,0,2664,42312,0,0,116696,2555,1740,4295,0,10875,10875,2170,1380,3550,2056,1072,3128,2150,25,251,8,0,3,104,1231,1622
1,07/08/2022,01ED-Wimco Nagar Depot Metro,37538,53825,200,1728,27456,0,0,66922,105,95,200,0,500,500,811,702,1513,833,416,1249,807,16,0,0,0,12,49,653,730
1,07/08/2022,01EF-Wimco Nagar Metro,57792,83514,100,1816,40196,0,0,99904,14135,3375,17510,0,0,0,1274,1010,2284,1319,965,2284,1313,42,88,1,1,21,51,937,1141
1,07/08/2022,01F1-Thiruvotriyur Metro,54722,70308,0,2720,30676,0,0,88118,770,700,1470,0,0,0,1184,851,2035,1288,742,2030,1271,30,0,0,0,12,69,769,880
1,07/08/2022,01F3-Thiruvotriyur Theradi Metro,63736,94630,0,1728,41432,0,0,106896,1365,2180,3545,0,0,0,1565,1105,2670,1678,1153,2831,1705,41,105,5,0,26,50,1024,1251
1,07/08/2022,01F5-Kaladipet Metro,42701,65131,400,1400,30594,0,0,75095,1220,1085,2305,0,0,0,1172,898,2070,1304,829,2133,1238,22,0,0,0,16,49,852,939
1,07/08/2022,01F7-Tollgate Metro,30974,40558,0,1008,21246,0,0,53228,345,225,570,0,0,0,734,668,1402,746,603,1349,701,21,1,0,0,17,36,595,670
1,07/08/2022,01F9-New Washermenpet Metro,38486,58510,0,936,29738,0,0,69160,1025,660,1685,0,0,0,1031,921,1952,1149,833,1982,1094,14,27,0,0,9,31,883,964
1,07/08/2022,01FB-Tondiarpet Metro,45104,53948,400,1168,24920,0,0,71592,2870,1645,4515,0,0,0,1066,750,1816,1135,758,1893,1071,16,2,0,0,8,36,712,774
1,07/08/2022,01FD-Thiagaraya College Metro,58162,77560,0,1680,36256,0,0,96098,5640,2340,7980,0,0,0,1569,1131,2700,1548,1017,2565,1567,58,50,1,0,11,60,1052,1232
1,07/08/2022,0101-Washermanpet,66080,77554,300,1392,41392,0,0,109164,15825,6115,21940,0,16250,16250,1266,1331,2597,1315,1248,2563,1312,15,175,1,0,11,55,1272,1529
1,07/08/2022,0103-Mannadi,41680,65493,0,2008,36044,0,0,79732,12565,4920,17485,0,1500,1500,1079,1195,2274,1131,1072,2203,1128,20,143,0,0,7,61,1120,1351
1,07/08/2022,0105-High Court,29022,70650,0,1296,37346,0,0,67664,915,405,1320,0,0,0,1317,1272,2589,1231,1083,2314,1320,6,194,0,0,10,53,1210,1473
1,07/08/2022,0109-Government Estate,47005,91434,300,1152,42434,0,0,90891,1720,1500,3220,0,2500,2500,1930,1410,3340,2015,1417,3432,2113,18,342,5,0,16,40,1338,1759
1,07/08/2022,0111-LIC,19791,47749,750,1968,21724,0,0,44233,930,515,1445,0,0,0,915,774,1689,1032,655,1687,1078,8,51,1,0,8,73,686,827
1,07/08/2022,0113-Thousand Lights,30746,66291,50,2024,34324,0,0,67144,4480,220,4700,0,2000,2000,1135,1195,2330,1436,989,2425,1249,12,0,0,0,9,66,1071,1158
1,07/08/2022,0115-AG-DMS,26145,44908,0,744,21378,0,0,48267,0,0,0,0,0,0,814,492,1306,848,601,1449,889,10,140,4,0,2,28,586,770
1,07/08/2022,0117-Teynampet,22955,44339,0,1120,22550,0,0,46625,0,0,0,0,2000,2000,741,790,1531,990,784,1774,867,8,1,1,0,7,43,730,790
1,07/08/2022,0119-Nandanam,26614,45922,0,1992,24786,0,0,53392,1590,950,2540,0,0,0,795,896,1691,897,710,1607,844,10,0,5,0,12,61,820,908
1,07/08/2022,0121-Saidapet,26347,48301,0,1400,28116,0,0,55863,1505,855,2360,0,4000,4000,649,935,1584,867,818,1685,782,14,2,2,0,8,47,867,940
1,07/08/2022,0123-Little Mount,32051,55561,132,1544,25182,0,0,58909,12115,2755,14870,0,0,0,1149,873,2022,1017,666,1683,1159,18,234,3,0,8,54,797,1114
1,07/08/2022,0125-Guindy,59372,156139,200,3712,87618,0,0,150902,6855,1180,8035,0,0,0,2408,2834,5242,2476,2387,4863,2525,34,450,7,0,24,130,2393,3038
1,07/08/2022,0129-Nanganallur Road,12933,24329,0,936,12344,0,0,26213,17800,4400,22200,0,0,0,347,394,741,479,325,804,425,9,0,0,0,3,23,362,397
1,07/08/2022,0131-Meenambakkam,54187,83016,0,4448,42940,0,0,101575,6390,4200,10590,0,0,0,1303,1176,2479,1101,917,2018,1253,23,276,3,0,8,79,1114,1503
1,07/08/2022,0133-Chennai International Airport,114405,306060,335,8328,181476,0,0,304544,14460,7865,22325,0,0,0,3487,4909,8396,3458,4411,7869,3776,67,991,15,1,46,260,4283,5663
2,07/08/2022,0201-Puratchi Thalaivar Dr. M.G. Ramachandran Central,177869,363910,650,9672,181924,0,0,370115,23425,1585,25010,0,700,700,6377,6199,12576,4568,7042,11610,6533,77,2934,18,0,51,373,5677,9130
2,07/08/2022,0203-Egmore,45143,108473,400,2840,66858,0,0,115241,7655,2115,9770,0,2750,2750,1398,2295,3693,1512,2476,3988,1578,25,442,7,0,9,119,2147,2749
2,07/08/2022,0205-Nehru Park,17345,27601,0,1120,13666,0,0,32131,1235,1215,2450,0,2500,2500,518,518,1036,526,419,945,570,10,84,0,0,3,50,461,608
2,07/08/2022,0207-Kilpauk,16758,26574,0,576,10238,0,0,27572,190,370,560,0,0,0,530,375,905,587,411,998,608,5,110,0,0,7,23,339,484
2,07/08/2022,0209-Pachaiyappas College,22347,25336,150,352,11768,0,0,34617,990,410,1400,0,6000,6000,552,397,949,551,366,917,542,9,57,0,0,2,13,382,463
2,07/08/2022,0211-Shenoy Nagar,18166,23264,0,624,9226,0,0,28016,0,0,0,0,3500,3500,477,326,803,518,353,871,549,11,77,1,0,7,25,300,421
2,07/08/2022,0213-Anna Nagar East,37916,69107,0,2056,29434,0,0,69406,1455,1175,2630,0,0,0,1623,1066,2689,1634,909,2543,1671,18,177,1,0,8,74,969,1247
2,07/08/2022,0215-Anna Nagar Tower,41033,64410,2500,1400,26010,0,0,70943,6225,2915,9140,0,0,0,1336,914,2250,1301,1009,2310,1453,8,330,1,0,2,52,851,1244
2,07/08/2022,0217-Thirumangalam,111112,201350,950,6480,98314,0,0,216856,104725,7640,112365,0,0,0,3645,3246,6891,3676,3040,6716,3813,53,728,5,0,22,216,2978,4002
2,07/08/2022,0219-Koyambedu,87720,145760,800,3488,83060,0,0,175068,5640,4600,10240,0,5500,5500,2401,2697,5098,2197,2268,4465,2296,51,587,16,0,26,143,2575,3398
2,07/08/2022,0221-Puratchi Thalaivi Dr. J. Jayalalithaa CMBT,45990,148721,0,2360,98672,0,0,147022,0,0,0,0,0,0,1623,3174,4797,2276,3568,5844,1932,69,424,3,0,14,94,3063,3667
2,07/08/2022,0223-Arumbakkam,35381,40225,0,1128,24814,0,0,61323,2690,260,2950,0,10000,10000,668,687,1355,763,708,1471,663,35,1,6,0,17,51,836,946
2,07/08/2022,0225-Vadapalani,106126,204944,106,5976,93572,0,0,205780,19520,3400,22920,0,6000,6000,3705,3228,6933,3298,3280,6578,4022,35,1380,4,0,45,255,2859,4578
2,07/08/2022,0227-Ashok Nagar,48323,81724,100,2352,41008,0,0,91783,7400,3380,10780,0,12000,12000,1553,1398,2951,1531,1315,2846,1631,23,311,0,0,5,91,1294,1724
2,07/08/2022,0229-Ekkattuthangal,36840,53764,20,1264,23264,0,0,61388,935,0,935,0,0,0,1111,817,1928,1146,862,2008,1216,16,357,2,0,0,57,748,1180
2,07/08/2022,0231-Arignar Anna Alandur,161834,155467,350,3896,62902,0,0,228982,10065,3540,13605,0,2250,2250,4347,1843,6190,3508,2222,5730,3985,45,831,609,0,19,135,1833,3472
2,07/08/2022,0233-St. Thomas Mount,44948,75658,0,2800,39256,0,0,87004,3780,2360,6140,0,2500,2500,1189,1263,2452,1188,1101,2289,1298,27,320,3,0,4,95,1153,1602
1,08/08/2022,01ED-Wimco Nagar Depot Metro,85951,68159,200,1352,23604,0,0,111107,365,570,935,0,3250,3250,1760,626,2386,1432,385,1817,1424,23,1,1,0,4,39,584,652
1,08/08/2022,01EF-Wimco Nagar Metro,150677,137673,400,3344,38428,0,0,192849,18265,6250,24515,0,0,0,3249,1035,4284,3153,966,4119,3129,59,55,2,0,5,95,929,1145
1,08/08/2022,01F1-Thiruvotriyur Metro,136390,99759,200,1392,22350,0,0,160332,695,920,1615,0,0,0,2671,645,3316,2653,630,3283,2597,55,0,2,0,9,43,600,709
1,08/08/2022,01F3-Thiruvotriyur Theradi Metro,112583,110862,200,1080,28030,0,0,141893,1825,2680,4505,0,0,0,2596,790,3386,2865,805,3670,2853,62,54,4,0,5,35,744,904
1,08/08/2022,01F5-Kaladipet Metro,133836,95001,2300,1464,22462,0,0,160062,1335,2510,3845,0,0,0,2796,704,3500,2785,662,3447,2738,20,0,0,0,2,46,655,723
1,08/08/2022,01F7-Tollgate Metro,74807,57975,0,1256,15140,0,0,91203,110,160,270,0,0,0,1623,508,2131,1622,471,2093,1600,27,0,0,0,6,36,464,533
1,08/08/2022,01F9-New Washermenpet Metro,111870,97481,200,1304,25022,0,0,138396,1190,2090,3280,0,250,250,2850,834,3684,2850,827,3677,2863,30,72,1,0,6,53,784,946
1,08/08/2022,01FB-Tondiarpet Metro,123573,95240,700,1224,26068,0,0,151565,2115,2860,4975,0,250,250,2580,829,3409,2751,756,3507,2694,44,2,0,0,3,41,769,859
1,08/08/2022,01FD-Thiagaraya College Metro,143202,110716,310,1456,22394,0,0,167362,5080,2520,7600,0,1000,1000,3610,771,4381,3382,963,4345,3590,80,235,1,0,1,54,706,1077
1,08/08/2022,0101-Washermanpet,129312,113814,478,2152,39172,0,0,171114,7280,5225,12505,0,20500,20500,3290,1335,4625,2995,1141,4136,3067,25,119,0,0,2,74,1259,1479
1,08/08/2022,0103-Mannadi,88784,108562,1701,1024,31324,0,0,122833,7490,5955,13445,0,1500,1500,2875,1092,3967,3236,1141,4377,3251,22,94,0,0,5,42,1041,1204
1,08/08/2022,0105-High Court,140128,227551,0,2104,67048,0,0,209280,865,1640,2505,0,0,0,6340,2317,8657,6449,1978,8427,6546,46,210,2,0,4,88,2200,2550
1,08/08/2022,0109-Government Estate,115939,146754,950,2256,45426,0,0,164571,19260,3135,22395,0,4500,4500,3880,1646,5526,4125,1548,5673,4379,29,355,3,0,9,89,1515,2000
1,08/08/2022,0111-LIC,82040,150720,2124,3120,34958,0,0,122242,2250,750,3000,0,1000,1000,4089,1250,5339,4694,1072,5766,4667,18,0,0,0,5,99,1126,1248
1,08/08/2022,0113-Thousand Lights,166291,220823,500,3440,40624,0,0,210855,735,335,1070,0,1750,1750,6443,1489,7932,7387,1415,8802,7252,34,0,0,0,6,150,1302,1492
1,08/08/2022,0115-AG-DMS,120112,142768,260,1304,25340,0,0,147016,160,0,160,0,3000,3000,4504,648,5152,4422,817,5239,4579,27,229,1,0,1,57,785,1100
1,08/08/2022,0117-Teynampet,121584,141928,0,1960,30492,0,0,154036,0,0,0,0,3000,3000,4075,1119,5194,4696,1063,5759,4622,36,1,0,0,1,81,1026,1145
1,08/08/2022,0119-Nandanam,105708,121751,700,2096,32418,0,0,140922,605,4240,4845,0,1500,1500,3319,1210,4529,3885,962,4847,3854,38,0,0,0,2,92,1091,1223
1,08/08/2022,0121-Saidapet,56505,77170,500,1400,23698,0,0,82103,2045,2320,4365,0,250,250,1819,844,2663,2200,793,2993,2170,15,0,0,0,0,61,757,833
1,08/08/2022,0123-Little Mount,88587,87285,0,1800,23026,0,0,113413,7845,6445,14290,0,250,250,2954,840,3794,2547,631,3178,2603,23,131,0,0,7,62,766,989
1,08/08/2022,0125-Guindy,148144,240949,734,5584,74802,0,0,229264,6945,5825,12770,0,1000,1000,6925,2620,9545,6488,2286,8774,6571,47,269,2,0,9,186,2355,2868
1,08/08/2022,0129-Nanganallur Road,57007,47403,1700,408,12292,0,0,71407,8845,7565,16410,0,0,0,1305,386,1691,1394,352,1746,1339,11,0,2,0,1,12,356,382
1,08/08/2022,0131-Meenambakkam,154971,132048,1000,1704,39422,0,0,197097,6105,12115,18220,0,0,0,3650,1093,4743,3032,866,3898,3128,47,211,3,0,7,46,1017,1331
1,08/08/2022,0133-Chennai International Airport,174371,318173,1136,6288,143404,0,0,325199,10700,12460,23160,0,3750,3750,5222,3894,9116,5422,3496,8918,5616,71,662,34,0,12,188,3429,4396
2,08/08/2022,0201-Puratchi Thalaivar Dr. M.G. Ramachandran Central,287916,441466,4190,11696,171928,0,0,475730,28250,3105,31355,0,11950,11950,11984,6102,18086,9574,6902,16476,11309,115,2262,7,0,9,442,5584,8419
2,08/08/2022,0203-Egmore,77287,121745,1100,2200,59186,0,0,139773,8710,3505,12215,0,9750,9750,2457,2069,4526,2460,2327,4787,2542,29,430,9,0,11,90,1939,2508
2,08/08/2022,0205-Nehru Park,49431,41065,200,456,12328,0,0,62415,4245,3605,7850,0,2000,2000,1243,466,1709,1184,391,1575,1215,9,88,0,0,2,18,444,561
2,08/08/2022,0207-Kilpauk,37576,55113,1500,720,17812,0,0,57608,670,360,1030,0,250,250,1369,620,1989,1471,535,2006,1498,6,87,0,0,2,34,584,713
2,08/08/2022,0209-Pachaiyappas College,56553,50316,0,424,14892,0,0,71869,670,740,1410,0,11000,11000,1602,567,2169,1481,527,2008,1495,10,81,1,0,1,17,542,652
2,08/08/2022,0211-Shenoy Nagar,48089,44827,30,872,11998,0,0,60989,0,0,0,0,2000,2000,1204,429,1633,1315,455,1770,1347,9,46,0,0,1,36,393,485
2,08/08/2022,0213-Anna Nagar East,104511,105880,200,2328,30110,0,0,137149,925,3235,4160,0,3000,3000,2881,1087,3968,2999,972,3971,3002,28,140,0,0,4,64,1004,1240
2,08/08/2022,0215-Anna Nagar Tower,83144,97692,1300,1648,21696,0,0,107788,7405,3925,11330,0,1250,1250,2624,784,3408,2724,856,3580,2905,22,303,1,0,1,49,721,1097
2,08/08/2022,0217-Thirumangalam,291385,294014,530,5808,81224,0,0,378947,73725,21345,95070,0,500,500,7760,2760,10520,7858,2556,10414,8045,77,517,10,0,7,207,2513,3331
2,08/08/2022,0219-Koyambedu,206284,219889,800,3480,75886,0,0,286450,12280,14115,26395,0,30500,30500,5582,2491,8073,4743,1943,6686,5262,54,739,5,0,11,140,2415,3364
2,08/08/2022,0221-Puratchi Thalaivi Dr. J. Jayalalithaa CMBT,71460,176305,500,3584,95914,0,0,171458,0,0,0,0,0,0,2564,3133,5697,3142,3413,6555,3141,37,444,0,0,4,143,2979,3607
2,08/08/2022,0223-Arumbakkam,68680,53810,1008,976,19826,0,0,90490,2255,1245,3500,0,2250,2250,1422,507,1929,1468,652,2120,1377,46,0,0,0,6,34,685,771
2,08/08/2022,0225-Vadapalani,130374,189764,1493,3808,68946,0,0,204621,10900,2290,13190,0,4500,4500,4261,2390,6651,4438,2537,6975,4624,37,545,3,0,11,143,2179,2918
2,08/08/2022,0227-Ashok Nagar,94410,127174,0,2016,45526,0,0,141952,6720,8025,14745,0,3000,3000,3133,1558,4691,3117,1469,4586,3181,28,201,4,0,3,87,1449,1772
2,08/08/2022,0229-Ekkattuthangal,101109,126787,926,1624,28370,0,0,132029,0,310,310,0,250,250,3523,1004,4527,3792,1087,4879,3920,24,282,8,0,9,71,910,1304
2,08/08/2022,0231-Arignar Anna Alandur,158328,180485,562,2888,56796,0,0,218574,9990,8635,18625,0,5000,5000,4836,1715,6551,4631,1659,6290,4784,40,368,2,0,4,106,1729,2249
2,08/08/2022,0233-St. Thomas Mount,96969,96600,522,1880,29404,0,0,128775,1720,2625,4345,0,4500,4500,2623,998,3621,2496,883,3379,2583,27,190,4,0,2,75,902,1200
1,09/08/2022,01ED-Wimco Nagar Depot Metro,68610,60900,100,1008,20388,0,0,90106,170,380,550,0,2500,2500,1437,529,1966,1283,300,1583,1250,20,0,2,0,14,29,497,562
1,09/08/2022,01EF-Wimco Nagar Metro,98029,105677,0,2224,28778,0,0,129031,9555,7250,16805,0,250,250,2418,763,3181,2244,783,3027,2368,24,197,0,0,7,64,709,1001
1,09/08/2022,01F1-Thiruvotriyur Metro,82161,80757,700,1392,21364,0,0,105617,440,910,1350,0,0,0,2022,612,2634,2006,537,2543,1966,29,5,0,0,10,43,575,662
1,09/08/2022,01F3-Thiruvotriyur Theradi Metro,86078,100424,200,1088,29928,0,0,117294,1090,2475,3565,0,0,0,2251,839,3090,2350,871,3221,2358,37,99,2,0,10,37,778,963
1,09/08/2022,01F5-Kaladipet Metro,82598,74994,100,1432,18588,0,0,102718,640,1990,2630,0,0,0,2091,567,2658,2016,530,2546,2025,14,61,0,0,9,38,528,650
1,09/08/2022,01F7-Tollgate Metro,47234,44869,60,704,13782,0,0,61780,30,150,180,0,0,0,1196,459,1655,1194,360,1554,1154,15,2,0,0,4,24,422,467
1,09/08/2022,01F9-New Washermenpet Metro,77228,71297,50,1136,19052,0,0,97466,1010,1210,2220,0,0,0,2003,635,2638,1898,564,2462,1981,18,117,0,0,6,42,585,768
1,09/08/2022,01FB-Tondiarpet Metro,70086,73663,200,1320,22250,0,0,93856,2630,2850,5480,0,0,0,1947,711,2658,2040,626,2666,1996,20,7,1,0,7,36,671,742
1,09/08/2022,01FD-Thiagaraya College Metro,98884,83414,200,1104,21424,0,0,121612,3600,1940,5540,0,2000,2000,2588,727,3315,2420,618,3038,2438,93,75,0,0,7,40,679,894
1,09/08/2022,0101-Washermanpet,87608,94675,1000,2088,34602,0,0,125298,6775,5730,12505,0,10500,10500,2463,1181,3644,2313,1119,3432,2391,20,141,1,0,12,86,1097,1357
1,09/08/2022,0103-Mannadi,66298,84966,150,1184,28306,0,0,95938,8670,5145,13815,0,1500,1500,2121,942,3063,2291,977,3268,2362,23,182,1,0,1,35,907,1149
1,09/08/2022,0105-High Court,86461,159693,500,2232,63568,0,0,152761,1175,1475,2650,0,0,0,3770,2134,5904,3853,1750,5603,3894,26,214,0,0,9,79,2027,2355
1,09/08/2022,0109-Government Estate,77425,114620,800,1712,38810,0,0,118747,2945,2820,5765,0,1500,1500,2906,1399,4305,3154,1278,4432,3280,22,347,0,0,0,67,1296,1732
1,09/08/2022,0111-LIC,45772,84572,1800,1664,22338,0,0,71574,925,410,1335,0,0,0,2105,787,2892,2532,627,3159,2485,30,0,0,0,7,59,694,790
1,09/08/2022,0113-Thousand Lights,108503,166369,700,3168,35718,0,0,148089,410,315,725,0,0,0,4635,1303,5938,5366,1080,6446,5235,15,0,4,0,6,121,1130,1276
1,09/08/2022,0115-AG-DMS,61041,77936,0,1592,18170,0,0,80803,40,0,40,0,1000,1000,2118,458,2576,2186,551,2737,2296,10,156,0,0,3,51,567,787
1,09/08/2022,0117-Teynampet,71369,93203,1000,1552,21510,0,0,95431,0,0,0,0,250,250,2584,775,3359,3086,731,3817,2994,18,1,3,0,4,55,706,787
1,09/08/2022,0119-Nandanam,85270,92295,600,1576,25564,0,0,113010,1300,1925,3225,0,2000,2000,2531,924,3455,2905,689,3594,2852,35,5,1,0,6,67,827,941
1,09/08/2022,0121-Saidapet,35031,51962,400,1344,19132,0,0,55907,2810,905,3715,0,3000,3000,1163,677,1840,1407,602,2009,1309,20,0,0,0,4,48,628,700
1,09/08/2022,0123-Little Mount,61110,71635,700,1200,20928,0,0,83938,3795,4180,7975,0,1250,1250,2195,750,2945,1986,541,2527,2045,9,163,0,0,3,50,682,907
1,09/08/2022,0125-Guindy,108526,183401,1200,6008,64248,0,0,179982,4955,4475,9430,0,2500,2500,4847,2223,7070,4669,1853,6522,4713,37,328,0,0,7,176,1939,2487
1,09/08/2022,0129-Nanganallur Road,31665,33167,600,264,9920,0,0,42449,11005,5385,16390,0,0,0,811,302,1113,942,249,1191,862,9,2,0,0,3,9,286,309
1,09/08/2022,0131-Meenambakkam,97409,96913,500,1696,33930,0,0,133535,5870,12090,17960,0,0,0,2514,954,3468,2026,803,2829,2129,23,218,6,0,6,61,895,1209
1,09/08/2022,0133-Chennai International Airport,133826,287375,800,7048,143532,0,0,285206,11680,10220,21900,0,4500,4500,4125,3932,8057,4635,3417,8052,4632,54,653,18,0,8,209,3520,4462
2,09/08/2022,0201-Puratchi Thalaivar Dr. M.G. Ramachandran Central,240281,359147,770,9312,115534,0,0,365897,17120,2245,19365,0,6550,6550,9816,4129,13945,7010,6417,13427,9509,86,3256,6,0,19,343,3617,7327
2,09/08/2022,0203-Egmore,68870,102589,250,2008,49050,0,0,120178,8260,2320,10580,0,5000,5000,1889,1737,3626,2039,2082,4121,2099,25,508,17,0,9,85,1619,2263
2,09/08/2022,0205-Nehru Park,30514,36350,0,848,13288,0,0,44650,1620,1730,3350,0,2500,2500,948,497,1445,927,379,1306,934,12,71,1,0,1,34,449,568
2,09/08/2022,0207-Kilpauk,31918,41944,400,688,14736,0,0,47742,450,280,730,0,250,250,986,516,1502,1064,438,1502,1086,12,74,0,0,4,34,481,605
2,09/08/2022,0209-Pachaiyappas College,36009,35069,0,536,10064,0,0,46609,1140,710,1850,0,10000,10000,1060,382,1442,1031,336,1367,1051,15,77,2,0,1,21,354,470
2,09/08/2022,0211-Shenoy Nagar,27038,34988,50,776,11536,0,0,39400,0,0,0,0,0,0,928,422,1350,977,381,1358,948,9,35,0,0,2,30,366,442
2,09/08/2022,0213-Anna Nagar East,71013,88337,100,1472,28120,0,0,100705,1130,2895,4025,0,1500,1500,2322,1005,3327,2396,811,3207,2396,15,145,0,0,3,57,936,1156
2,09/08/2022,0215-Anna Nagar Tower,68932,75698,0,1560,20284,0,0,90776,3275,3545,6820,0,250,250,2027,735,2762,2062,720,2782,2147,23,232,0,0,0,63,668,986
2,09/08/2022,0217-Thirumangalam,194927,244657,210,6064,82526,0,0,283727,89295,15845,105140,0,1500,1500,5826,2775,8601,5944,2433,8377,6053,55,538,3,0,14,221,2514,3345
2,09/08/2022,0219-Koyambedu,131995,163664,2400,3960,63468,0,0,201823,6100,7900,14000,0,7500,7500,3883,2111,5994,3397,1871,5268,3706,40,643,3,0,17,157,1943,2803
2,09/08/2022,0221-Puratchi Thalaivi Dr. J. Jayalalithaa CMBT,61102,126295,220,1648,59804,0,0,122774,0,0,0,0,0,0,2099,1982,4081,2624,2612,5236,2582,61,536,4,0,3,77,1900,2581
2,09/08/2022,0223-Arumbakkam,42231,51182,400,976,23114,0,0,66721,355,255,610,0,2250,2250,1169,595,1764,1259,546,1805,1152,37,7,0,0,13,41,770,868
2,09/08/2022,0225-Vadapalani,116452,198459,800,5352,80056,0,0,202660,17720,3800,21520,0,6000,6000,4079,2817,6896,4099,2764,6863,4496,57,809,3,0,12,229,2496,3606
2,09/08/2022,0227-Ashok Nagar,79994,97949,2095,2280,39854,0,0,124223,5580,3885,9465,0,9000,9000,2262,1376,3638,2295,1152,3447,2297,38,195,2,0,1,92,1258,1586
2,09/08/2022,0229-Ekkattuthangal,76403,108749,318,1688,25048,0,0,103457,0,0,0,0,500,500,3144,901,4045,3267,721,3988,3345,27,263,3,0,4,65,813,1175
2,09/08/2022,0231-Arignar Anna Alandur,127349,164720,0,2656,57784,0,0,187789,6530,6290,12820,0,2250,2250,4003,1724,5727,3923,1511,5434,4042,42,512,0,0,13,93,1680,2340
2,09/08/2022,0233-St. Thomas Mount,73864,89626,600,2680,34110,0,0,111254,2520,2150,4670,0,9750,9750,2043,1142,3185,2010,1005,3015,2096,20,207,0,0,3,96,1035,1361
1,10/08/2022,01ED-Wimco Nagar Depot Metro,77445,66532,0,1472,20424,0,0,99341,95,255,350,0,5250,5250,1735,551,2286,1472,334,1806,1460,25,0,2,0,3,45,514,589
1,10/08/2022,01EF-Wimco Nagar Metro,127327,133505,800,2792,26616,0,0,157535,8260,6440,14700,0,750,750,3377,745,4122,3095,771,3866,3289,64,237,2,1,6,85,649,1044
1,10/08/2022,01F1-Thiruvotriyur Metro,111574,101201,100,1368,23030,0,0,136072,780,685,1465,0,0,0,2701,656,3357,2675,587,3262,2635,28,0,1,0,5,46,609,689
1,10/08/2022,01F3-Thiruvotriyur Theradi Metro,103318,117206,1900,1392,29760,0,0,136370,1050,2915,3965,0,0,0,2780,851,3631,2975,875,3850,2963,47,88,3,0,11,43,788,980
1,10/08/2022,01F5-Kaladipet Metro,110937,99825,100,1208,22470,0,0,134715,1005,2610,3615,0,0,0,3003,708,3711,2934,492,3426,2901,22,0,0,0,11,39,669,741
1,10/08/2022,01F7-Tollgate Metro,56619,57380,0,1536,16190,0,0,74345,485,275,760,0,0,0,1583,306,1889,1552,444,1996,1509,21,0,0,0,3,24,483,531
1,10/08/2022,01F9-New Washermenpet Metro,100172,92165,700,984,23172,0,0,125028,755,2110,2865,0,1250,1250,2801,774,3575,2700,698,3398,2742,22,73,0,0,2,38,737,872
1,10/08/2022,01FB-Tondiarpet Metro,94541,92811,2000,1264,23754,0,0,121559,2385,3225,5610,0,1000,1000,2609,785,3394,2757,714,3471,2726,24,0,1,0,3,42,728,798
1,10/08/2022,01FD-Thiagaraya College Metro,120894,112014,500,1528,26124,0,0,149046,2995,3720,6715,0,1500,1500,3522,941,4463,3507,809,4316,3500,88,43,0,0,2,54,879,1066
1,10/08/2022,0101-Washermanpet,97731,116710,736,1920,38756,0,0,139143,13810,4460,18270,0,8750,8750,3302,1353,4655,3145,1277,4422,3180,24,77,2,0,6,74,1281,1464
1,10/08/2022,0103-Mannadi,91557,107674,0,1048,31660,0,0,124265,8730,8740,17470,0,0,0,2885,1103,3988,3194,1105,4299,3195,21,111,1,0,1,42,1038,1214
1,10/08/2022,0105-High Court,154125,239926,200,1736,71272,0,0,227333,800,1465,2265,0,0,0,6707,2466,9173,6812,1934,8746,6908,28,231,0,1,7,77,2358,2702
1,10/08/2022,0109-Government Estate,101835,136938,2681,1320,37372,0,0,143208,5700,2390,8090,0,3000,3000,3819,1345,5164,4068,1376,5444,4333,22,432,3,0,0,50,1258,1765
1,10/08/2022,0111-LIC,96178,167729,1000,1400,36704,0,0,135282,1730,820,2550,0,0,0,4667,1246,5913,5354,1079,6433,5289,37,0,0,0,2,58,1172,1269
1,10/08/2022,0113-Thousand Lights,141288,231530,1950,3272,49044,0,0,195554,870,270,1140,0,1000,1000,6567,1639,8206,7446,1441,8887,7319,47,0,0,0,2,132,1593,1774
1,10/08/2022,0115-AG-DMS,99160,148272,0,1928,29840,0,0,130928,0,0,0,0,1000,1000,4574,890,5464,4577,795,5372,4680,32,149,0,0,1,80,919,1181
1,10/08/2022,0117-Teynampet,96194,140035,850,1592,29436,0,0,128072,0,0,0,0,2000,2000,4194,1064,5258,4695,953,5648,4608,30,0,1,0,3,65,963,1062
1,10/08/2022,0119-Nandanam,84836,123780,1655,1976,33282,0,0,121749,1845,5265,7110,0,1500,1500,3533,1194,4727,3975,975,4950,3902,24,0,1,0,2,80,1101,1208
1,10/08/2022,0121-Saidapet,56107,77655,100,1232,21664,0,0,79103,2700,1960,4660,0,6750,6750,1923,770,2693,2313,678,2991,2270,12,1,0,0,1,49,715,778
1,10/08/2022,0123-Little Mount,85876,88946,0,1568,23378,0,0,110822,4495,6410,10905,0,250,250,3029,848,3877,2599,588,3187,2656,28,120,0,0,5,62,765,980
1,10/08/2022,0125-Guindy,130352,249009,0,4712,74246,0,0,209310,6790,5185,11975,0,500,500,7220,2568,9788,6684,2176,8860,6894,48,339,3,0,5,171,2316,2882
1,10/08/2022,0129-Nanganallur Road,43496,46010,500,152,10190,0,0,54338,6160,7180,13340,0,0,0,1300,301,1601,1408,304,1712,1363,8,0,1,0,2,6,290,307
1,10/08/2022,0131-Meenambakkam,124611,131026,1308,2040,38308,0,0,166267,4375,12290,16665,0,0,0,3665,1106,4771,3056,923,3979,3174,34,192,2,0,1,64,1040,1333
1,10/08/2022,0133-Chennai International Airport,190767,304250,650,7168,110078,0,0,308663,9600,13965,23565,0,5250,5250,5765,3055,8820,5553,3172,8725,6150,45,1129,15,0,7,189,2734,4119
2,10/08/2022,0201-Puratchi Thalaivar Dr. M.G. Ramachandran Central,261962,426147,950,8776,145026,0,0,416714,19830,2135,21965,0,5700,5700,12225,5179,17404,9788,6615,16403,11654,109,2624,11,0,9,350,4754,7857
2,10/08/2022,0203-Egmore,63289,111412,100,2656,51376,0,0,117421,8475,3310,11785,0,8500,8500,2244,1851,4095,2527,2371,4898,2470,23,330,6,0,4,113,1713,2189
2,10/08/2022,0205-Nehru Park,39521,43876,0,808,14976,0,0,55305,1865,3410,5275,0,0,0,1307,563,1870,1238,401,1639,1239,17,74,1,0,0,31,525,648
2,10/08/2022,0207-Kilpauk,41687,55784,40,1040,16356,0,0,59123,545,255,800,0,250,250,1470,612,2082,1574,516,2090,1604,9,80,0,0,5,43,563,700
2,10/08/2022,0209-Pachaiyappas College,46026,52566,0,536,15074,0,0,61636,1800,640,2440,0,6000,6000,1688,570,2258,1577,412,1989,1577,16,72,0,0,3,22,532,645
2,10/08/2022,0211-Shenoy Nagar,44336,43274,1000,480,11156,0,0,56972,0,0,0,0,500,500,1278,394,1672,1331,368,1699,1325,13,43,0,0,0,22,365,443
2,10/08/2022,0213-Anna Nagar East,81265,101400,100,1768,26224,0,0,109357,735,3800,4535,0,3000,3000,2826,954,3780,2973,862,3835,2999,24,145,2,0,2,68,858,1099
2,10/08/2022,0215-Anna Nagar Tower,91226,95015,1300,1736,24194,0,0,118456,5180,7545,12725,0,0,0,2544,867,3411,2690,721,3411,2740,27,161,1,0,1,55,794,1039
2,10/08/2022,0217-Thirumangalam,271771,297908,2340,6232,72906,0,0,353249,68270,20650,88920,0,0,0,8278,2488,10766,8135,2290,10425,8413,64,675,6,0,3,198,2251,3197
2,10/08/2022,0219-Koyambedu,190780,214547,1900,3360,73182,0,0,269222,7115,10220,17335,0,14250,14250,5428,2382,7810,5083,1920,7003,5193,66,513,6,0,8,139,2286,3018
2,10/08/2022,0221-Puratchi Thalaivi Dr. J. Jayalalithaa CMBT,67643,162523,200,2448,79072,0,0,149363,0,0,0,0,0,0,2495,2549,5044,3464,3399,6863,3260,35,481,5,0,3,111,2440,3075
2,10/08/2022,0223-Arumbakkam,65072,59037,400,1528,22076,0,0,89076,725,285,1010,0,7500,7500,1518,684,2202,1632,616,2248,1488,32,2,1,0,9,23,749,816
2,10/08/2022,0225-Vadapalani,136338,193909,1000,5016,65434,0,0,207788,13720,3490,17210,0,11000,11000,4549,2278,6827,4623,2230,6853,4885,38,663,1,0,7,145,2053,2907
2,10/08/2022,0227-Ashok Nagar,94459,125832,500,2104,39830,0,0,136893,5040,6010,11050,0,4000,4000,3304,1354,4658,3222,1244,4466,3375,33,341,2,0,0,92,1220,1688
2,10/08/2022,0229-Ekkattuthangal,86394,128496,1000,2312,27478,0,0,117184,0,0,0,0,250,250,3694,987,4681,3903,928,4831,4019,15,256,0,0,5,82,880,1238
2,10/08/2022,0231-Arignar Anna Alandur,151126,189420,1110,3424,58688,0,0,214348,6265,9175,15440,0,4250,4250,5125,1787,6912,4863,1535,6398,5077,55,436,8,0,5,108,1752,2364
2,10/08/2022,0233-St. Thomas Mount,85580,96461,100,1616,27632,0,0,114928,2570,3895,6465,0,3000,3000,2689,912,3601,2598,779,3377,2624,23,163,1,0,0,62,830,1079
1,11/08/2022,01ED-Wimco Nagar Depot Metro,76624,69662,0,1464,23156,0,0,101244,95,510,605,0,5000,5000,1813,600,2413,1481,355,1836,1464,18,12,4,0,6,43,568,651
1,11/08/2022,01EF-Wimco Nagar Metro,116945,135594,0,2592,35714,0,0,155251,9560,6895,16455,0,3000,3000,3246,932,4178,3132,846,3978,3133,37,108,5,0,8,72,849,1079
1,11/08/2022,01F1-Thiruvotriyur Metro,101439,101428,500,1520,25642,0,0,129101,690,830,1520,0,0,0,2651,718,3369,2625,530,3155,2541,39,0,1,0,6,49,661,756
1,11/08/2022,01F3-Thiruvotriyur Theradi Metro,99849,121185,700,1376,33134,0,0,135059,1090,2655,3745,0,0,0,2800,927,3727,3010,877,3887,3021,25,112,2,0,8,42,869,1058
1,11/08/2022,01F5-Kaladipet Metro,113699,99832,1750,984,26934,0,0,143367,730,2675,3405,0,0,0,2869,806,3675,2813,631,3444,2727,24,0,3,0,9,40,772,848
1,11/08/2022,01F7-Tollgate Metro,56602,57289,1500,1144,16022,0,0,75268,160,210,370,0,0,0,1605,523,2128,1538,433,1971,1515,21,3,0,0,5,39,491,559
1,11/08/2022,01F9-New Washermenpet Metro,89172,92965,500,1080,24656,0,0,115408,985,1575,2560,0,1750,1750,2723,833,3556,2704,727,3431,2726,13,79,0,0,1,43,790,926
1,11/08/2022,01FB-Tondiarpet Metro,87632,93949,792,888,27290,0,0,116602,1425,3220,4645,0,750,750,2651,863,3514,2700,676,3376,2632,43,2,2,0,5,28,833,913
1,11/08/2022,01FD-Thiagaraya College Metro,112951,119630,500,2344,31566,0,0,147361,5160,2170,7330,0,500,500,3630,1081,4711,3483,871,4354,3563,44,132,0,0,1,76,997,1250
1,11/08/2022,0101-Washermanpet,93358,118069,1500,1920,40674,0,0,137452,5705,4025,9730,0,7500,7500,3361,1379,4740,3105,1123,4228,3179,21,150,1,0,4,71,1308,1555
1,11/08/2022,0103-Mannadi,81403,110874,320,1112,34092,0,0,116927,9830,8410,18240,0,0,0,2987,1166,4153,3268,1080,4348,3235,27,82,1,0,1,46,1115,1272
1,11/08/2022,0105-High Court,136941,225895,920,2440,62752,0,0,203053,890,1645,2535,0,0,0,6490,2207,8697,6573,1813,8386,6685,34,279,2,0,2,100,2083,2500
1,11/08/2022,0109-Government Estate,89904,142832,1360,2248,40854,0,0,134366,3010,3625,6635,0,6000,6000,3912,1458,5370,4041,1553,5594,4417,31,492,5,0,5,101,1329,1963
1,11/08/2022,0111-LIC,68111,151228,1400,2280,32716,0,0,104507,1075,1065,2140,0,0,0,4252,1147,5399,4833,934,5767,4771,24,0,1,0,1,79,1053,1158
1,11/08/2022,0113-Thousand Lights,123854,218992,1200,3768,46316,0,0,175138,385,270,655,0,0,0,6262,1686,7948,7149,1446,8595,7007,47,0,0,0,5,147,1507,1706
1,11/08/2022,0115-AG-DMS,97552,136696,300,1752,24950,0,0,124554,5,0,5,0,1250,1250,4283,864,5147,4258,790,5048,4393,33,180,0,0,0,70,758,1041
1,11/08/2022,0117-Teynampet,74391,144351,615,2016,32092,0,0,109114,0,0,0,0,0,0,4234,1203,5437,4730,951,5681,4649,23,0,5,0,5,79,1080,1192
1,11/08/2022,0119-Nandanam,84062,114978,1410,1416,28782,0,0,115670,1925,3495,5420,0,250,250,3336,1015,4351,3806,776,4582,3714,25,0,1,0,2,61,939,1028
1,11/08/2022,0121-Saidapet,45460,77450,50,1416,25710,0,0,72636,2380,1725,4105,0,2250,2250,1842,859,2701,2158,697,2855,2087,9,14,4,0,0,47,822,896
1,11/08/2022,0123-Little Mount,85999,84293,0,1544,22536,0,0,110079,3825,5815,9640,0,2250,2250,2927,828,3755,2436,559,2995,2499,29,146,0,0,2,64,757,998
1,11/08/2022,0125-Guindy,120979,238763,100,5536,68860,0,0,195475,4565,5530,10095,0,3000,3000,6990,2368,9358,6450,1973,8423,6689,53,492,0,0,8,197,2135,2885
1,11/08/2022,0129-Nanganallur Road,41700,46008,820,816,13688,0,0,57024,9840,7475,17315,0,0,0,1140,420,1560,1293,336,1629,1226,10,0,1,0,0,13,397,421
1,11/08/2022,0131-Meenambakkam,133151,127356,700,1840,36876,0,0,172567,4070,11910,15980,0,0,0,3525,1061,4586,3006,819,3825,3088,28,208,2,1,4,57,996,1296
1,11/08/2022,0133-Chennai International Airport,147520,323768,978,9568,150282,0,0,308348,9735,10620,20355,0,6750,6750,5133,4077,9210,5666,3415,9081,5619,50,594,8,0,14,239,3704,4609
2,11/08/2022,0201-Puratchi Thalaivar Dr. M.G. Ramachandran Central,274330,451072,1224,8384,129184,0,0,413122,14195,3115,17310,0,14200,14200,13150,4639,17789,10450,6936,17386,13056,92,3654,10,0,19,324,4197,8296
2,11/08/2022,0203-Egmore,71307,120215,550,1624,55102,0,0,128583,5735,3550,9285,0,12750,12750,2243,1918,4161,2998,2431,5429,2683,25,350,11,0,7,67,1821,2281
2,11/08/2022,0205-Nehru Park,32279,44619,0,472,14948,0,0,47699,1660,3440,5100,0,1250,1250,1359,533,1892,1265,400,1665,1248,18,66,1,0,3,20,511,619
2,11/08/2022,0207-Kilpauk,36224,54659,0,760,15900,0,0,52884,400,350,750,0,0,0,1517,567,2084,1573,513,2086,1581,18,82,1,0,4,37,530,672
2,11/08/2022,0209-Pachaiyappas College,47543,46838,0,376,14194,0,0,62113,620,780,1400,0,7000,7000,1499,532,2031,1404,413,1817,1390,11,77,1,0,3,15,500,607
2,11/08/2022,0211-Shenoy Nagar,30977,42422,200,352,12180,0,0,43709,590,1230,1820,0,0,0,1238,413,1651,1282,362,1644,1251,10,48,0,0,1,13,397,469
2,11/08/2022,0213-Anna Nagar East,80547,100187,750,1720,27902,0,0,110919,1350,3195,4545,0,500,500,2756,1005,3761,2901,848,3749,2889,17,141,0,0,5,71,914,1148
2,11/08/2022,0215-Anna Nagar Tower,72248,91456,350,1296,23094,0,0,96988,4130,7460,11590,0,250,250,2497,827,3324,2658,682,3340,2663,19,141,5,0,2,38,767,972
2,11/08/2022,0217-Thirumangalam,269205,306958,450,5272,77846,0,0,352773,81640,20475,102115,0,2000,2000,8390,2653,11043,8123,2443,10566,8505,62,994,4,0,11,194,2418,3683
2,11/08/2022,0219-Koyambedu,176916,208415,1100,2584,73432,0,0,254032,5405,10225,15630,0,7500,7500,5375,2376,7751,4824,1790,6614,4971,53,648,2,0,6,99,2332,3140
2,11/08/2022,0221-Puratchi Thalaivi Dr. J. Jayalalithaa CMBT,79033,176405,100,2264,64340,0,0,145737,0,0,0,0,0,0,2828,2082,4910,4361,4681,9042,4184,56,906,6,0,5,95,1970,3038
2,11/08/2022,0223-Arumbakkam,50629,56979,100,1176,22692,0,0,74597,1805,395,2200,0,6500,6500,1482,803,2285,1543,538,2081,1415,51,4,1,0,5,37,753,851
2,11/08/2022,0225-Vadapalani,122407,183352,2500,3216,56504,0,0,184627,11560,2860,14420,0,5000,5000,4647,1946,6593,4545,2120,6665,4875,40,818,4,0,4,123,1789,2778
2,11/08/2022,0227-Ashok Nagar,101637,126734,650,2624,34830,0,0,139741,5535,6645,12180,0,3500,3500,3489,1223,4712,3172,1124,4296,3517,35,588,7,0,0,104,1087,1821
2,11/08/2022,0229-Ekkattuthangal,84331,123425,100,3264,28244,0,0,115939,0,0,0,0,0,0,3484,1030,4514,3617,738,4355,3791,21,311,0,0,3,111,893,1339
2,11/08/2022,0231-Arignar Anna Alandur,136274,193303,750,3624,60684,0,0,201332,7590,9090,16680,0,0,0,5200,1774,6974,4733,1569,6302,5053,41,551,1,0,4,127,1755,2479
2,11/08/2022,0233-St. Thomas Mount,79726,98328,500,3072,31230,0,0,114528,1665,2185,3850,0,7250,7250,2631,1049,3680,2528,692,3220,2559,21,223,1,0,1,81,952,1279
1,12/08/2022,01ED-Wimco Nagar Depot Metro,56850,69901,100,1880,24720,0,0,83550,150,290,440,0,500,500,1736,649,2385,1453,388,1841,1441,23,0,0,0,3,55,588,669
1,12/08/2022,01EF-Wimco Nagar Metro,114545,143240,800,3432,39826,0,0,158603,9585,6380,15965,0,250,250,3455,1061,4516,3219,933,4152,3244,54,60,2,0,12,95,958,1181
1,12/08/2022,01F1-Thiruvotriyur Metro,89011,97487,0,1640,26820,0,0,117471,775,570,1345,0,0,0,2599,745,3344,2408,576,2984,2387,29,0,2,0,4,53,693,781
1,12/08/2022,01F3-Thiruvotriyur Theradi Metro,85580,120036,220,1912,35514,0,0,123226,1065,2750,3815,0,0,0,2799,1002,3801,2921,939,3860,2922,31,94,2,0,6,60,930,1123
1,12/08/2022,01F5-Kaladipet Metro,92218,96402,0,1144,26174,0,0,119536,910,2490,3400,0,0,0,2788,798,3586,2730,661,3391,2636,19,0,1,0,4,42,762,828
1,12/08/2022,01F7-Tollgate Metro,56333,57769,0,904,16990,0,0,74227,45,175,220,0,0,0,1578,525,2103,1501,374,1875,1476,36,0,0,0,7,25,501,569
1,12/08/2022,01F9-New Washermenpet Metro,85321,92181,200,920,21006,0,0,107447,925,2040,2965,0,250,250,2778,708,3486,2678,741,3419,2780,19,153,1,0,3,33,673,882
1,12/08/2022,01FB-Tondiarpet Metro,85028,96736,150,1048,27172,0,0,113398,2130,3175,5305,0,500,500,2607,892,3499,2811,796,3607,2725,30,0,3,0,0,37,846,916
1,12/08/2022,01FD-Thiagaraya College Metro,101198,116351,670,1624,27796,0,0,131288,2300,4415,6715,0,500,500,3656,971,4627,3504,848,4352,3559,50,92,3,0,7,60,903,1115
1,12/08/2022,0101-Washermanpet,91992,118677,400,2088,43514,0,0,137994,11495,3550,15045,0,11500,11500,3628,1475,5103,2977,1247,4224,3076,28,152,1,0,4,80,1394,1659
1,12/08/2022,0103-Mannadi,75994,114944,600,1368,36800,0,0,114762,9145,6355,15500,0,0,0,3029,1256,4285,3260,1110,4370,3296,21,123,2,1,5,53,1192,1397
1,12/08/2022,0105-High Court,119868,233747,300,2080,74040,0,0,196288,1590,1415,3005,0,0,0,6399,2522,8921,6471,1843,8314,6553,40,196,7,0,6,98,2399,2746
1,12/08/2022,0109-Government Estate,81347,139034,650,2304,39118,0,0,123419,2725,2605,5330,0,750,750,3973,1445,5418,4002,1482,5484,4340,28,435,1,0,3,92,1314,1873
1,12/08/2022,0111-LIC,79038,160214,1650,2056,39736,0,0,122480,1050,605,1655,0,0,0,4258,1338,5596,4896,999,5895,4834,36,2,0,0,3,83,1242,1366
1,12/08/2022,0113-Thousand Lights,119552,234367,706,4384,53954,0,0,178596,775,345,1120,0,0,0,6655,1945,8600,7265,1501,8766,7249,36,0,3,0,10,186,1710,1945
1,12/08/2022,0115-AG-DMS,110386,150569,300,1784,35694,0,0,148164,5,0,5,0,0,0,4661,1188,5849,4374,862,5236,4512,33,191,0,0,0,63,1084,1371
1,12/08/2022,0117-Teynampet,74299,148684,100,1864,39026,0,0,115289,0,0,0,0,0,0,4297,1388,5685,4599,984,5583,4557,31,10,2,0,5,76,1281,1405
1,12/08/2022,0119-Nandanam,68803,125538,620,2208,42464,0,0,114095,1990,4610,6600,0,0,0,3330,1484,4814,3615,1019,4634,3540,29,0,0,0,4,88,1380,1501
1,12/08/2022,0121-Saidapet,41841,76511,400,1928,24410,0,0,68579,1635,2285,3920,0,0,0,1852,901,2753,2132,649,2781,2110,21,1,1,0,1,72,806,902
1,12/08/2022,0123-Little Mount,67030,92845,1050,1640,29614,0,0,99334,4060,5510,9570,0,1000,1000,3102,1040,4142,2394,618,3012,2546,16,229,0,0,1,67,960,1273
1,12/08/2022,0125-Guindy,119199,284079,1500,7024,107924,0,0,235647,4735,5595,10330,0,0,0,7293,3784,11077,6393,2333,8726,6930,51,619,2,0,7,283,3281,4243
1,12/08/2022,0129-Nanganallur Road,43521,48174,1000,848,13652,0,0,59021,13685,7795,21480,0,0,0,1257,439,1696,1376,361,1737,1327,14,0,0,0,0,23,403,440
1,12/08/2022,0131-Meenambakkam,114749,136890,100,2792,43814,0,0,161455,6045,12255,18300,0,0,0,3742,1274,5016,3009,925,3934,3161,35,225,6,0,3,78,1186,1533
1,12/08/2022,0133-Chennai International Airport,158361,337333,400,8304,158560,0,0,325625,16040,10495,26535,0,7500,7500,4460,4371,8831,5733,3760,9493,5732,54,617,11,0,26,251,3874,4833
2,12/08/2022,0201-Puratchi Thalaivar Dr. M.G. Ramachandran Central,262692,514489,1400,11016,165862,0,0,440970,15110,1955,17065,0,2350,2350,12644,5882,18526,11944,9063,21007,14180,95,3347,1,0,21,445,5214,9123
2,12/08/2022,0203-Egmore,66542,147191,360,2312,65388,0,0,134602,9975,3755,13730,0,12250,12250,2401,2327,4728,3454,3134,6588,3340,16,487,4,0,12,103,2191,2813
2,12/08/2022,0205-Nehru Park,40659,46632,200,776,17898,0,0,59533,3415,2430,5845,0,4000,4000,1277,652,1929,1177,515,1692,1212,5,71,0,0,3,29,613,721
2,12/08/2022,0207-Kilpauk,34526,54620,0,656,15890,0,0,51072,575,305,880,0,0,0,1552,587,2139,1503,481,1984,1562,20,117,0,0,0,32,548,717
2,12/08/2022,0209-Pachaiyappas College,43834,49644,1100,1144,14370,0,0,60448,930,670,1600,0,8000,8000,1607,577,2184,1469,441,1910,1474,14,81,0,0,2,39,530,666
2,12/08/2022,0211-Shenoy Nagar,40718,42924,100,680,12324,0,0,53822,1120,1590,2710,0,4000,4000,1250,453,1703,1245,390,1635,1264,10,48,1,0,0,28,419,506
2,12/08/2022,0213-Anna Nagar East,77626,106219,0,2040,29888,0,0,109554,3235,3420,6655,0,0,0,2945,1107,4052,2988,865,3853,3023,26,168,2,0,3,81,1009,1289
2,12/08/2022,0215-Anna Nagar Tower,72804,96118,100,3032,26278,0,0,102214,3780,7740,11520,0,1000,1000,2579,933,3512,2627,830,3457,2686,19,205,4,0,3,40,872,1143
2,12/08/2022,0217-Thirumangalam,228140,304780,1353,8032,95800,0,0,333325,84975,20605,105580,0,0,0,7904,3278,11182,7561,2503,10064,7886,54,640,5,0,9,264,2965,3937
2,12/08/2022,0219-Koyambedu,171952,240455,500,3512,97814,0,0,273778,9255,8190,17445,0,8250,8250,5659,3224,8883,5190,2448,7638,5303,58,660,6,0,21,147,3154,4046
2,12/08/2022,0221-Puratchi Thalaivi Dr. J. Jayalalithaa CMBT,76429,227081,570,2904,73240,0,0,153143,0,0,0,0,0,0,3184,2463,5647,6760,8330,15090,5821,23,1098,3,0,3,126,2278,3531
2,12/08/2022,0223-Arumbakkam,48752,57787,0,888,23630,0,0,73270,1400,320,1720,0,5500,5500,1490,846,2336,1501,623,2124,1394,39,0,2,0,5,35,792,873
2,12/08/2022,0225-Vadapalani,115190,204731,1368,5352,80174,0,0,202084,14120,3090,17210,0,5000,5000,4604,2780,7384,4495,2521,7016,4822,43,683,4,0,6,203,2530,3469
2,12/08/2022,0227-Ashok Nagar,104196,145086,400,3784,44338,0,0,152718,7795,6940,14735,0,12000,12000,3914,1577,5491,3396,1439,4835,3906,32,777,0,0,3,143,1404,2359
2,12/08/2022,0229-Ekkattuthangal,70751,138478,350,4552,46838,0,0,122491,0,0,0,0,250,250,3647,1691,5338,3258,760,4018,3603,18,432,0,0,3,175,1475,2103
2,12/08/2022,0231-Arignar Anna Alandur,147694,217136,550,4352,80066,0,0,232662,9795,8345,18140,0,750,750,5474,2414,7888,4787,1794,6581,5210,45,699,11,0,11,163,2415,3344
2,12/08/2022,0233-St. Thomas Mount,70799,111400,0,4944,38934,0,0,114677,1710,3000,4710,0,8000,8000,2822,1355,4177,2472,911,3383,2748,22,351,0,0,1,123,1207,1704
1,13/08/2022,01ED-Wimco Nagar Depot Metro,53924,65620,131,1000,30620,0,0,85675,165,50,215,0,2500,2500,1436,757,2193,1128,435,1563,1095,16,3,0,0,9,30,728,786
1,13/08/2022,01EF-Wimco Nagar Metro,93103,120924,500,3440,45412,0,0,142455,8710,3455,12165,0,0,0,2440,1193,3633,2271,1019,3290,2323,42,138,3,0,12,91,1079,1365
1,13/08/2022,01F1-Thiruvotriyur Metro,81298,89465,500,1936,34860,0,0,118594,435,670,1105,0,0,0,2050,942,2992,1933,736,2669,1840,52,0,2,0,7,59,897,1017
1,13/08/2022,01F3-Thiruvotriyur Theradi Metro,81438,112705,100,2072,42426,0,0,126036,1065,1920,2985,0,0,0,2331,1203,3534,2438,1106,3544,2406,23,85,1,0,11,63,1123,1306
1,13/08/2022,01F5-Kaladipet Metro,77773,83288,200,2096,28816,0,0,108885,720,1345,2065,0,0,0,2210,879,3089,2058,797,2855,2009,24,1,2,0,7,73,809,916
1,13/08/2022,01F7-Tollgate Metro,43394,50178,0,1624,18748,0,0,63766,600,130,730,0,0,0,1295,643,1938,1179,488,1667,1180,22,6,1,0,6,59,552,646
1,13/08/2022,01F9-New Washermenpet Metro,61531,74479,0,1008,25154,0,0,87693,885,1305,2190,0,250,250,2056,814,2870,1972,712,2684,1953,24,74,0,0,7,36,765,906
1,13/08/2022,01FB-Tondiarpet Metro,69956,80521,150,1560,31184,0,0,102850,2840,2170,5010,0,0,0,1961,968,2929,1958,832,2790,1930,23,3,0,0,5,52,912,995
1,13/08/2022,01FD-Thiagaraya College Metro,93332,102258,400,2352,35798,0,0,131882,5045,4355,9400,0,2750,2750,2790,1181,3971,2618,1009,3627,2625,79,45,3,0,19,78,1087,1311
1,13/08/2022,0101-Washermanpet,78350,102964,24,2080,45526,0,0,125980,10765,4985,15750,0,11000,11000,2446,1510,3956,2232,1252,3484,2277,22,175,0,0,7,81,1420,1705
1,13/08/2022,0103-Mannadi,73573,96346,1300,1632,33070,0,0,109575,10805,7875,18680,0,4500,4500,2425,1156,3581,2354,1285,3639,2584,18,345,1,0,9,70,1067,1510
1,13/08/2022,0105-High Court,85327,176889,500,4152,77292,0,0,167271,2520,2000,4520,0,0,0,3715,2621,6336,3789,2129,5918,4009,25,337,5,0,13,149,2403,2932
1,13/08/2022,0109-Government Estate,78223,139619,200,3504,44222,0,0,126149,3810,2645,6455,0,1250,1250,3375,1603,4978,3328,1777,5105,3877,23,739,0,0,10,129,1419,2320
1,13/08/2022,0111-LIC,31423,74004,100,1424,29546,0,0,62493,805,480,1285,0,2500,2500,1468,998,2466,1844,800,2644,1773,7,0,0,0,4,58,917,986
1,13/08/2022,0113-Thousand Lights,63216,142370,1300,3080,49542,0,0,117138,275,75,350,0,0,0,3224,1682,4906,3885,1447,5332,3719,34,0,0,0,6,111,1509,1660
1,13/08/2022,0115-AG-DMS,54695,86351,0,1680,25718,0,0,82093,45,0,45,0,0,0,2296,855,3151,2151,676,2827,2305,25,174,5,0,2,66,773,1045
1,13/08/2022,0117-Teynampet,44565,75470,0,1128,28732,0,0,74425,0,0,0,0,0,0,1699,1011,2710,2028,768,2796,1909,7,0,0,0,4,48,944,1003
1,13/08/2022,0119-Nandanam,41105,75535,300,1320,33466,0,0,76191,1640,1210,2850,0,0,0,1675,1127,2802,1844,814,2658,1728,31,0,4,0,14,52,1036,1137
1,13/08/2022,0121-Saidapet,26819,56480,100,1496,28474,0,0,56889,4435,810,5245,0,5000,5000,1011,964,1975,1173,772,1945,1086,12,0,0,0,4,55,864,935
1,13/08/2022,0123-Little Mount,44245,63078,200,2032,27400,0,0,73877,3760,2360,6120,0,1000,1000,1512,957,2469,1282,640,1922,1379,22,201,0,0,3,73,868,1167
1,13/08/2022,0125-Guindy,92299,196541,400,5208,88204,0,0,186111,4180,2940,7120,0,1500,1500,3966,2963,6929,3576,2377,5953,3999,35,773,6,0,8,197,2429,3448
1,13/08/2022,0129-Nanganallur Road,22991,36763,0,760,15462,0,0,39213,10795,4080,14875,0,0,0,676,481,1157,864,383,1247,766,8,1,3,0,2,22,447,483
1,13/08/2022,0131-Meenambakkam,76456,109011,1500,3296,46540,0,0,127792,6875,8635,15510,0,0,0,2278,1330,3608,1887,1059,2946,2036,26,303,1,0,11,95,1234,1670
1,13/08/2022,0133-Chennai International Airport,131259,324365,510,9912,182700,0,0,324381,15545,6500,22045,0,5500,5500,3993,5006,8999,4313,4269,8582,4445,59,843,28,0,33,279,4371,5613
2,13/08/2022,0201-Puratchi Thalaivar Dr. M.G. Ramachandran Central,211425,453710,500,12576,192294,0,0,416795,11050,1455,12505,0,2600,2600,9143,6744,15887,7923,8241,16164,10071,71,3283,13,0,28,473,5900,9768
2,13/08/2022,0203-Egmore,66633,131287,300,2528,67236,0,0,136697,6470,2380,8850,0,12500,12500,1885,2335,4220,2592,3149,5741,2540,28,456,10,0,15,109,2183,2801
2,13/08/2022,0205-Nehru Park,28228,45032,50,1312,20020,0,0,49610,2185,1260,3445,0,4000,4000,979,745,1724,981,566,1547,1038,9,141,0,0,3,60,671,884
2,13/08/2022,0207-Kilpauk,25585,42607,0,872,16978,0,0,43435,365,125,490,0,0,0,890,607,1497,911,528,1439,980,14,118,0,0,3,38,552,725
2,13/08/2022,0209-Pachaiyappas College,35064,37374,0,1176,12330,0,0,48570,2030,350,2380,0,8000,8000,1078,460,1538,966,358,1324,1026,10,127,0,0,4,20,434,595
2,13/08/2022,0211-Shenoy Nagar,32312,37655,0,696,13810,0,0,46818,1140,810,1950,0,5000,5000,957,494,1451,925,422,1347,942,13,84,1,0,6,28,461,593
2,13/08/2022,0213-Anna Nagar East,54665,91714,100,2080,33970,0,0,90815,1100,1225,2325,0,0,0,2242,1224,3466,2187,1044,3231,2259,31,218,1,0,11,87,1122,1470
2,13/08/2022,0215-Anna Nagar Tower,57216,82528,200,1568,30164,0,0,89148,3040,4180,7220,0,1000,1000,1888,1058,2946,1888,1011,2899,2007,21,272,2,0,1,60,969,1325
2,13/08/2022,0217-Thirumangalam,161991,249128,743,8176,104298,0,0,275208,106560,8680,115240,0,0,0,5220,3517,8737,5101,3027,8128,5325,57,759,6,0,17,289,3198,4326
2,13/08/2022,0219-Koyambedu,137805,194079,1500,5592,87060,0,0,231957,6350,4400,10750,5000,9750,14750,4040,2978,7018,3430,2464,5894,3912,55,955,7,0,29,208,2785,4039
2,13/08/2022,0221-Puratchi Thalaivi Dr. J. Jayalalithaa CMBT,64814,203413,0,3032,90264,0,0,158110,0,0,0,0,0,0,2375,2954,5329,4767,6704,11471,4191,32,857,8,0,12,113,2758,3780
2,13/08/2022,0223-Arumbakkam,33914,46932,0,1304,23462,0,0,58680,5350,300,5650,0,2000,2000,983,869,1852,1073,642,1715,957,25,4,2,0,6,48,817,902
2,13/08/2022,0225-Vadapalani,98985,211887,200,7408,93410,0,0,200003,26940,5130,32070,0,2000,2000,4118,3352,7470,3849,3213,7062,4410,33,990,3,0,31,292,2918,4267
2,13/08/2022,0227-Ashok Nagar,63480,112302,300,3304,53962,0,0,121046,5245,4410,9655,0,4500,4500,2310,1874,4184,2177,1499,3676,2296,28,297,9,0,4,131,1714,2183
2,13/08/2022,0229-Ekkattuthangal,44958,81212,1032,1872,33084,0,0,80946,1290,0,1290,0,500,500,1906,1126,3032,1647,763,2410,1856,18,389,2,0,5,77,1024,1515
2,13/08/2022,0231-Arignar Anna Alandur,114805,184101,0,4672,84966,0,0,204443,8820,5075,13895,0,1750,1750,3647,2528,6175,3244,2199,5443,3603,48,812,24,0,13,161,2439,3497
2,13/08/2022,0233-St. Thomas Mount,59743,103548,400,4008,48558,0,0,112709,1130,1230,2360,0,2125,2125,1926,1593,3519,1920,1194,3114,2010,31,336,8,0,7,130,1436,1948
1,14/08/2022,01ED-Wimco Nagar Depot Metro,38743,60310,150,2264,30470,0,0,71627,360,355,715,0,0,0,956,794,1750,960,457,1417,922,29,12,0,0,16,65,733,855
1,14/08/2022,01EF-Wimco Nagar Metro,53359,93847,100,2904,44412,0,0,100775,8305,3100,11405,0,0,0,1429,1150,2579,1443,1049,2492,1450,40,129,2,0,35,80,1062,1348
1,14/08/2022,01F1-Thiruvotriyur Metro,53245,79207,800,1744,40244,0,0,96033,1090,485,1575,0,0,0,1262,1057,2319,1408,882,2290,1252,37,20,0,0,18,51,1005,1131
1,14/08/2022,01F3-Thiruvotriyur Theradi Metro,60763,92073,0,2752,39290,0,0,102805,1685,1395,3080,0,0,0,1533,1115,2648,1693,1094,2787,1671,22,125,0,0,24,83,1012,1266
1,14/08/2022,01F5-Kaladipet Metro,42137,66055,400,1840,31882,0,0,76259,950,955,1905,0,0,0,1238,921,2159,1274,863,2137,1217,16,15,2,0,13,58,862,966
1,14/08/2022,01F7-Tollgate Metro,29966,39767,400,960,20584,0,0,51910,380,155,535,0,0,0,700,652,1352,771,555,1326,698,20,12,0,0,12,30,616,690
1,14/08/2022,01F9-New Washermenpet Metro,41077,59949,0,824,24352,0,0,66253,1035,810,1845,0,250,250,1333,741,2074,1300,762,2062,1302,16,155,0,0,14,29,691,905
1,14/08/2022,01FB-Tondiarpet Metro,40897,61803,200,1904,31192,0,0,74193,2415,1040,3455,0,0,0,1077,942,2019,1196,941,2137,1134,32,21,1,0,17,54,890,1015
1,14/08/2022,01FD-Thiagaraya College Metro,60032,83720,150,1952,38968,0,0,101102,6165,5830,11995,0,500,500,1629,1219,2848,1681,1094,2775,1701,36,107,4,0,11,72,1144,1374
1,14/08/2022,0101-Washermanpet,52654,80414,550,1752,44530,0,0,99486,9300,3625,12925,0,10250,10250,1339,1432,2771,1341,1268,2609,1375,11,186,3,0,15,62,1353,1630
1,14/08/2022,0103-Mannadi,35863,67789,0,1672,37630,0,0,75165,21025,6725,27750,0,0,0,1053,1234,2287,1153,1146,2299,1165,11,159,0,0,11,60,1165,1406
1,14/08/2022,0105-High Court,36747,92887,400,2480,50794,0,0,90421,1095,935,2030,0,0,0,1521,1762,3283,1419,1209,2628,1630,14,311,2,0,17,95,1632,2071
1,14/08/2022,0109-Government Estate,52572,98456,140,3416,38632,0,0,94760,3965,1565,5530,0,0,0,1998,1412,3410,1714,1593,3307,2242,8,676,0,0,20,114,1255,2073
1,14/08/2022,0111-LIC,25591,60166,500,1584,26338,0,0,54013,1425,550,1975,0,3000,3000,1088,883,1971,1349,715,2064,1281,11,47,6,0,18,57,807,946
1,14/08/2022,0113-Thousand Lights,27429,70758,856,2264,36442,0,0,66991,420,25,445,0,2000,2000,1146,1260,2406,1463,1111,2574,1304,14,36,0,1,7,88,1135,1281
1,14/08/2022,0115-AG-DMS,22494,43017,0,1032,18758,0,0,42284,235,5,240,0,0,0,817,614,1431,744,518,1262,865,12,185,0,0,5,40,569,811
1,14/08/2022,0117-Teynampet,19182,43746,100,912,23516,0,0,43710,0,0,0,0,1000,1000,673,809,1482,867,762,1629,793,5,5,1,0,13,42,769,835
1,14/08/2022,0119-Nandanam,19985,47266,0,1104,26774,0,0,47863,1395,775,2170,0,0,0,759,922,1681,871,734,1605,794,14,70,1,0,10,38,860,993
1,14/08/2022,0121-Saidapet,22775,43544,350,1336,25188,0,0,49649,1740,580,2320,2000,6000,8000,582,824,1406,743,694,1437,667,4,25,1,0,8,50,761,849
1,14/08/2022,0123-Little Mount,26857,48155,400,824,24736,0,0,52817,11480,2080,13560,0,0,0,929,796,1725,825,531,1356,903,12,183,0,0,5,31,761,992
1,14/08/2022,0125-Guindy,62571,150459,500,4104,84038,0,0,151213,5695,3300,8995,0,0,0,2217,2631,4848,2156,2383,4539,2292,30,580,7,0,21,138,2386,3162
1,14/08/2022,0129-Nanganallur Road,10760,24642,100,648,13584,0,0,25092,12725,2290,15015,0,0,0,298,403,701,459,378,837,373,7,14,0,0,4,22,382,429
1,14/08/2022,0131-Meenambakkam,45269,87620,200,2376,46878,0,0,94723,6515,5120,11635,0,0,0,1320,1271,2591,1142,1114,2256,1259,18,294,5,0,12,66,1212,1607
1,14/08/2022,0133-Chennai International Airport,105297,299729,0,11304,191396,0,0,307997,15155,3315,18470,0,2250,2250,3210,5264,8474,2871,4566,7437,3267,33,921,26,0,50,317,4704,6051
2,14/08/2022,0201-Puratchi Thalaivar Dr. M.G. Ramachandran Central,186762,387745,700,9544,185854,0,0,382860,14795,1160,15955,0,1650,1650,6824,6325,13149,4669,7721,12390,7222,60,3572,34,0,51,376,5754,9847
2,14/08/2022,0203-Egmore,46580,111308,201,2424,64324,0,0,113529,10610,2390,13000,0,5000,5000,1581,2203,3784,1734,2493,4227,1760,10,476,4,0,36,92,2087,2705
2,14/08/2022,0205-Nehru Park,19845,32128,0,520,14422,0,0,34787,2340,375,2715,0,2000,2000,665,509,1174,608,563,1171,686,2,192,0,0,5,23,483,705
2,14/08/2022,0207-Kilpauk,14135,27317,0,424,12294,0,0,26853,165,95,260,0,0,0,536,419,955,509,379,888,579,4,167,1,0,3,20,398,593
2,14/08/2022,0209-Pachaiyappas College,15992,25592,0,160,11188,0,0,27340,870,530,1400,0,2000,2000,553,387,940,542,383,925,560,7,66,6,0,3,6,376,464
2,14/08/2022,0211-Shenoy Nagar,18627,24193,500,416,10826,0,0,30369,1330,360,1690,0,0,0,520,383,903,502,319,821,508,11,73,0,0,9,16,358,467
2,14/08/2022,0213-Anna Nagar East,36906,61275,170,1552,26054,0,0,64682,1325,1085,2410,0,0,0,1263,914,2177,1294,859,2153,1363,22,212,2,0,10,61,850,1157
2,14/08/2022,0215-Anna Nagar Tower,36508,61438,100,1448,26492,0,0,64548,4060,2230,6290,0,0,0,1209,930,2139,1251,891,2142,1308,10,264,6,0,4,54,846,1184
2,14/08/2022,0217-Thirumangalam,100988,195362,300,6672,98496,0,0,206456,122550,7770,130320,0,0,0,3355,3269,6624,3228,3040,6268,3467,40,795,10,0,23,248,2941,4057
2,14/08/2022,0219-Koyambedu,75399,147930,50,4072,79424,0,0,158945,5410,3005,8415,5000,2250,7250,2457,2606,5063,2425,2302,4727,2520,32,623,8,0,52,175,2469,3359
2,14/08/2022,0221-Puratchi Thalaivi Dr. J. Jayalalithaa CMBT,49062,155637,0,2776,97012,0,0,148850,0,0,0,0,0,0,1689,3114,4803,2271,3878,6149,2139,39,675,5,0,13,115,2978,3825
2,14/08/2022,0223-Arumbakkam,18168,38256,700,952,22616,0,0,42436,1080,285,1365,0,0,0,673,809,1482,737,645,1382,634,27,24,0,0,19,39,762,871
2,14/08/2022,0225-Vadapalani,90766,205014,0,7816,105708,0,0,204290,29350,4560,33910,0,2500,2500,3222,3733,6955,3180,3734,6914,3638,39,1038,4,0,41,263,3289,4674
2,14/08/2022,0227-Ashok Nagar,30425,79339,175,1848,45564,0,0,78012,4845,3165,8010,0,0,0,1226,1553,2779,1350,1337,2687,1331,8,276,3,0,4,83,1440,1814
2,14/08/2022,0229-Ekkattuthangal,29164,46973,50,1128,21316,0,0,51658,0,0,0,0,0,0,917,713,1630,957,678,1635,995,10,242,0,0,9,49,654,964
2,14/08/2022,0231-Arignar Anna Alandur,76453,137501,300,3792,69846,0,0,150391,8490,3420,11910,0,0,0,2377,2033,4410,2158,2019,4177,2404,41,679,13,0,23,106,1996,2858
2,14/08/2022,0233-St. Thomas Mount,45050,83805,300,4624,43814,0,0,93788,1085,435,1520,0,1000,1000,1252,1426,2678,1299,1278,2577,1399,12,299,12,0,27,139,1283,1772
1,15/08/2022,01ED-Wimco Nagar Depot Metro,42969,59288,0,1632,29040,0,0,73641,470,210,680,0,2000,2000,980,737,1717,1028,559,1587,946,17,0,8,0,9,48,682,764
1,15/08/2022,01EF-Wimco Nagar Metro,63261,106627,0,2776,52252,0,0,118289,18375,3670,22045,0,0,0,1603,1293,2896,1710,1105,2815,1633,31,70,2,0,37,71,1230,1441
1,15/08/2022,01F1-Thiruvotriyur Metro,61117,84256,0,2176,37780,0,0,101073,855,555,1410,0,0,0,1475,1022,2497,1610,838,2448,1529,40,3,0,0,10,67,949,1069
1,15/08/2022,01F3-Thiruvotriyur Theradi Metro,74948,96113,0,2168,26670,0,0,103786,1590,2080,3670,0,0,0,2072,767,2839,1900,1195,3095,2225,30,448,0,0,20,66,680,1244
1,15/08/2022,01F5-Kaladipet Metro,55119,73098,0,1432,30592,0,0,87143,2065,1240,3305,0,0,0,1442,888,2330,1628,879,2507,1525,12,0,1,0,19,44,837,913
1,15/08/2022,01F7-Tollgate Metro,35770,47218,0,1144,21192,0,0,58106,235,415,650,0,0,0,901,648,1549,983,578,1561,898,16,1,0,0,14,36,611,678
1,15/08/2022,01F9-New Washermenpet Metro,56501,70947,100,1120,31016,0,0,88737,915,1335,2250,0,500,500,1507,962,2469,1614,839,2453,1564,13,71,0,0,6,42,922,1054
1,15/08/2022,01FB-Tondiarpet Metro,51759,68036,200,1232,28368,0,0,81559,2700,2325,5025,0,0,0,1411,883,2294,1652,945,2597,1506,22,5,1,0,19,36,837,920
1,15/08/2022,01FD-Thiagaraya College Metro,74712,93878,0,1784,37324,0,0,113820,8450,3035,11485,0,1250,1250,2113,1213,3326,2054,1031,3085,2149,37,149,0,0,19,68,1142,1415
1,15/08/2022,0101-Washermanpet,71964,90235,500,1344,44744,0,0,118552,9885,4045,13930,0,20000,20000,1687,1442,3129,1771,1528,3299,1732,15,129,2,0,27,50,1396,1619
1,15/08/2022,0103-Mannadi,44716,67200,2040,2072,34432,0,0,83260,6725,4345,11070,0,1500,1500,1210,1167,2377,1316,1175,2491,1303,14,130,0,0,10,49,1111,1314
1,15/08/2022,0105-High Court,47329,115467,200,4152,58600,0,0,110281,1050,1105,2155,0,0,0,2165,1961,4126,2094,1349,3443,2212,18,278,2,0,29,95,1853,2275
1,15/08/2022,0109-Government Estate,54897,108484,0,1968,49416,0,0,106281,3765,1940,5705,0,2500,2500,2105,1726,3831,2237,1519,3756,2405,12,432,0,0,17,70,1615,2146
1,15/08/2022,0111-LIC,20326,60673,0,1712,28576,0,0,50614,925,745,1670,0,0,0,926,952,1878,1311,806,2117,1222,3,4,0,0,8,57,874,946
1,15/08/2022,0113-Thousand Lights,27640,71203,150,2480,32184,0,0,62454,230,75,305,0,0,0,1274,1088,2362,1695,982,2677,1534,7,0,0,0,11,87,984,1089
1,15/08/2022,0115-AG-DMS,31016,54504,0,880,21804,0,0,53700,95,0,95,0,0,0,1142,716,1858,1211,553,1764,1222,15,105,0,0,4,34,660,818
1,15/08/2022,0117-Teynampet,21969,55539,0,1104,25606,0,0,48679,0,0,0,0,0,0,1015,864,1879,1350,793,2143,1205,8,0,0,0,5,42,803,858
1,15/08/2022,0119-Nandanam,26158,52140,200,1280,26620,0,0,54258,2075,650,2725,0,0,0,852,907,1759,1131,815,1946,1025,23,0,3,0,9,48,857,940
1,15/08/2022,0121-Saidapet,21264,44187,200,1304,24330,0,0,47098,2270,425,2695,0,2000,2000,611,811,1422,861,760,1621,775,9,0,0,0,6,44,757,816
1,15/08/2022,0123-Little Mount,25097,46097,60,1480,21258,0,0,47895,3100,2550,5650,0,250,250,914,690,1604,898,621,1519,920,16,139,0,0,10,45,638,848
1,15/08/2022,0125-Guindy,61298,164901,600,6280,88658,0,0,156836,9960,2460,12420,0,0,0,2611,2848,5459,2575,2631,5206,2677,26,493,2,0,28,179,2513,3241
1,15/08/2022,0129-Nanganallur Road,15369,26284,300,360,14188,0,0,30217,21570,4555,26125,0,0,0,410,424,834,501,378,879,426,12,0,4,0,2,13,412,443
1,15/08/2022,0131-Meenambakkam,63513,93762,200,1760,43886,0,0,109359,9805,5455,15260,0,0,0,1687,1175,2862,1378,1117,2495,1593,15,374,0,0,16,66,1135,1606
1,15/08/2022,0133-Chennai International Airport,113911,323940,500,11224,194464,0,0,320099,12690,6220,18910,0,750,750,3681,5366,9047,3868,4511,8379,3982,39,944,38,0,62,327,4753,6163
2,15/08/2022,0201-Puratchi Thalaivar Dr. M.G. Ramachandran Central,217710,450736,430,13720,218724,0,0,450584,24645,2975,27620,0,3050,3050,8387,7466,15853,5426,8441,13867,8296,81,3974,16,0,43,536,6712,11362
2,15/08/2022,0203-Egmore,57847,113624,300,3104,70262,0,0,131513,15415,3380,18795,0,12000,12000,1638,2452,4090,1735,2446,4181,1667,20,384,13,0,20,126,2309,2872
2,15/08/2022,0205-Nehru Park,20116,32181,200,656,16432,0,0,37404,1895,775,2670,0,1000,1000,643,616,1259,615,568,1183,631,10,110,4,0,3,31,565,723
2,15/08/2022,0207-Kilpauk,14066,29092,100,472,13634,0,0,28272,340,95,435,0,0,0,557,487,1044,603,474,1077,604,8,73,3,0,0,19,460,563
2,15/08/2022,0209-Pachaiyappas College,29210,27351,600,392,10746,0,0,40948,1800,240,2040,0,10000,10000,599,385,984,641,334,975,664,5,101,0,0,3,17,366,492
2,15/08/2022,0211-Shenoy Nagar,19618,27842,0,936,11526,0,0,32080,700,640,1340,0,2500,2500,586,425,1011,664,420,1084,662,8,55,5,0,5,34,378,485
2,15/08/2022,0213-Anna Nagar East,40692,65188,600,1872,30490,0,0,73654,1875,1280,3155,0,3000,3000,1246,1077,2323,1295,980,2275,1299,14,188,14,0,14,67,993,1290
2,15/08/2022,0215-Anna Nagar Tower,33690,62294,0,1384,26690,0,0,61764,5415,1820,7235,0,1000,1000,1217,936,2153,1310,851,2161,1335,10,235,6,0,1,52,869,1173
2,15/08/2022,0217-Thirumangalam,109385,215748,650,6600,103330,0,0,219965,124250,6535,130785,0,0,0,3665,3413,7078,3996,3294,7290,4040,31,668,16,0,29,240,3102,4086
2,15/08/2022,0219-Koyambedu,104566,174487,60,3728,88362,0,0,196716,10965,3450,14415,0,1000,1000,3333,2903,6236,2651,2527,5178,3092,32,938,35,0,38,173,2743,3959
2,15/08/2022,0221-Puratchi Thalaivi Dr. J. Jayalalithaa CMBT,83541,191858,50,4240,96896,0,0,184727,0,0,0,0,0,0,3009,3222,6231,2378,3889,6267,3275,22,1624,10,0,10,170,2916,4752
2,15/08/2022,0223-Arumbakkam,23071,42997,0,1568,25322,0,0,49961,915,755,1670,0,4000,4000,693,912,1605,850,609,1459,745,24,11,0,0,16,57,839,947
2,15/08/2022,0225-Vadapalani,92690,214007,750,7304,108400,0,0,209144,21100,4920,26020,0,2500,2500,3455,3792,7247,3702,3731,7433,3875,38,898,3,0,30,269,3340,4578
2,15/08/2022,0227-Ashok Nagar,68858,92794,430,1920,43268,0,0,114476,8995,2910,11905,0,9000,9000,1682,1474,3156,1734,1571,3305,1823,13,438,2,0,14,84,1365,1916
2,15/08/2022,0229-Ekkattuthangal,25648,48925,210,1240,22080,0,0,49178,0,0,0,0,250,250,856,760,1616,1028,837,1865,1039,10,179,0,0,5,53,697,944
2,15/08/2022,0231-Arignar Anna Alandur,79204,156567,0,4624,80014,0,0,163842,10465,4290,14755,0,1000,1000,2463,2323,4786,2497,2424,4921,2683,44,605,3,0,25,162,2287,3126
2,15/08/2022,0233-St. Thomas Mount,42857,88739,348,3792,48048,0,0,95045,2595,1025,3620,0,500,500,1330,1557,2887,1463,1217,2680,1471,22,330,5,0,7,134,1399,1897
1,16/08/2022,01ED-Wimco Nagar Depot Metro,74104,68147,50,992,21844,0,0,96990,260,525,785,0,1500,1500,1762,571,2333,1498,365,1863,1463,17,0,2,0,4,29,546,598
1,16/08/2022,01EF-Wimco Nagar Metro,138704,139919,450,2224,35840,0,0,177218,23905,6475,30380,0,500,500,3256,949,4205,3252,798,4050,3248,64,70,1,0,7,68,874,1084
1,16/08/2022,01F1-Thiruvotriyur Metro,119945,99487,640,1656,22300,0,0,144541,1305,575,1880,0,0,0,2573,636,3209,2620,642,3262,2582,40,7,0,0,5,52,585,689
1,16/08/2022,01F3-Thiruvotriyur Theradi Metro,96681,114699,1281,1600,27302,0,0,126864,1390,2825,4215,0,0,0,2647,777,3424,2941,836,3777,2949,33,82,2,0,3,49,709,878
1,16/08/2022,01F5-Kaladipet Metro,115945,92780,200,2024,20142,0,0,138311,880,2500,3380,0,0,0,2760,646,3406,2778,634,3412,2742,19,0,1,0,2,32,616,670
1,16/08/2022,01F7-Tollgate Metro,61062,54723,1300,1592,14352,0,0,78306,130,110,240,0,0,0,1493,474,1967,1489,375,1864,1477,18,0,0,0,1,46,430,495
1,16/08/2022,01F9-New Washermenpet Metro,108717,87662,100,760,19850,0,0,129427,1900,2120,4020,0,750,750,2691,703,3394,2725,681,3406,2706,32,35,1,0,3,29,671,771
1,16/08/2022,01FB-Tondiarpet Metro,88464,92347,4000,2720,21672,0,0,116856,2720,3180,5900,0,500,500,2561,723,3284,2820,756,3576,2777,24,2,1,0,4,43,676,750
1,16/08/2022,01FD-Thiagaraya College Metro,112407,109768,500,1280,26730,0,0,140917,4255,3340,7595,0,250,250,3395,933,4328,3454,847,4301,3406,78,9,0,0,4,52,876,1019
1,16/08/2022,0101-Washermanpet,109017,115240,700,2144,37066,0,0,148927,9380,5180,14560,0,11250,11250,3289,1302,4591,3193,1107,4300,3197,32,99,7,0,1,73,1220,1432
1,16/08/2022,0103-Mannadi,86911,108760,400,1360,30768,0,0,119439,7255,7650,14905,0,1500,1500,2925,1097,4022,3278,1102,4380,3277,28,99,2,0,1,56,1031,1217
1,16/08/2022,0105-High Court,146248,237420,1500,2456,62634,0,0,212838,1925,1710,3635,0,0,0,6827,2170,8997,6765,2025,8790,7085,30,476,0,0,2,102,2029,2639
1,16/08/2022,0109-Government Estate,93541,137494,1450,1160,40778,0,0,136929,3720,3570,7290,0,500,500,3728,1432,5160,4030,1513,5543,4256,28,386,3,0,0,52,1348,1817
1,16/08/2022,0111-LIC,92817,161208,150,2312,32092,0,0,127371,1730,595,2325,0,0,0,4436,1133,5569,5268,1072,6340,5210,23,0,0,0,0,98,1007,1128
1,16/08/2022,0113-Thousand Lights,128007,230242,4400,3648,42758,0,0,178813,855,250,1105,0,250,250,6606,1427,8033,7658,1568,9226,7529,34,0,2,0,8,150,1375,1569
1,16/08/2022,0115-AG-DMS,103987,145491,400,1784,27122,0,0,133293,150,0,150,0,250,250,4521,953,5474,4593,855,5448,4659,33,132,0,0,1,70,853,1089
1,16/08/2022,0117-Teynampet,92975,142446,1800,1584,29932,0,0,126291,0,0,0,0,5250,5250,4175,1103,5278,4788,981,5769,4670,32,2,1,0,3,59,982,1079
1,16/08/2022,0119-Nandanam,87677,115924,894,984,30050,0,0,119605,2600,3640,6240,0,4000,4000,3188,1078,4266,3812,931,4743,3664,41,0,0,0,2,40,1012,1095
1,16/08/2022,0121-Saidapet,50859,75023,100,1248,22192,0,0,74399,3115,1875,4990,0,4500,4500,1784,819,2603,2248,733,2981,2159,14,0,0,0,2,52,746,814
1,16/08/2022,0123-Little Mount,81539,86913,100,2376,21392,0,0,105407,4360,6675,11035,0,1000,1000,2832,823,3655,2639,671,3310,2673,13,107,2,0,5,63,719,909
1,16/08/2022,0125-Guindy,175055,247077,1870,5672,76866,0,0,259463,9665,5505,15170,0,9500,9500,6999,2709,9708,6774,2459,9233,6776,39,296,3,0,11,190,2405,2944
1,16/08/2022,0129-Nanganallur Road,57580,48712,700,408,12288,0,0,70976,7095,7650,14745,0,0,0,1282,381,1663,1440,305,1745,1385,12,0,0,0,2,13,360,387
1,16/08/2022,0131-Meenambakkam,143137,124804,100,2424,35360,0,0,181021,8885,17370,26255,0,0,0,3589,1018,4607,2978,766,3744,3075,23,156,2,0,0,65,939,1185
1,16/08/2022,0133-Chennai International Airport,203291,317288,1550,7976,142812,0,0,355629,8210,11960,20170,0,5500,5500,5219,3924,9143,5609,3416,9025,5663,76,535,15,0,12,244,3531,4413
2,16/08/2022,0201-Puratchi Thalaivar Dr. M.G. Ramachandran Central,275626,458786,1350,16128,166416,0,0,459520,40895,5295,46190,0,7650,7650,13188,6153,19341,9774,6773,16547,12065,115,2746,3,0,25,622,5265,8776
2,16/08/2022,0203-Egmore,78485,124341,750,3640,63760,0,0,146635,17880,4715,22595,0,15750,15750,2547,2291,4838,2364,2199,4563,2451,21,404,1,0,14,147,2091,2678
2,16/08/2022,0205-Nehru Park,38709,39170,0,696,12856,0,0,52261,2770,2020,4790,0,0,0,1179,470,1649,1132,402,1534,1122,10,40,0,0,0,25,439,514
2,16/08/2022,0207-Kilpauk,38085,49912,700,552,12308,0,0,51645,525,445,970,0,0,0,1319,447,1766,1492,410,1902,1510,18,86,0,0,1,25,416,546
2,16/08/2022,0209-Pachaiyappas College,48366,46818,0,400,12980,0,0,61746,1230,480,1710,0,4500,4500,1512,504,2016,1464,432,1896,1435,14,62,3,0,2,16,478,575
2,16/08/2022,0211-Shenoy Nagar,41910,41666,1145,544,10802,0,0,54401,2560,1220,3780,0,2000,2000,1153,382,1535,1281,353,1634,1270,16,46,0,0,1,20,349,432
2,16/08/2022,0213-Anna Nagar East,93470,97914,1200,1512,25806,0,0,121988,1805,3560,5365,0,4500,4500,2774,934,3708,2935,851,3786,2901,23,119,0,0,3,53,859,1057
2,16/08/2022,0215-Anna Nagar Tower,91705,91584,2428,1496,20974,0,0,116603,7025,8855,15880,0,750,750,2490,757,3247,2783,763,3546,2761,26,125,0,0,1,56,681,889
2,16/08/2022,0217-Thirumangalam,256514,283137,1400,5424,77316,0,0,340654,71355,20755,92110,0,0,0,7455,2636,10091,7768,2536,10304,7821,57,399,10,0,4,204,2374,3048
2,16/08/2022,0219-Koyambedu,222312,233861,1300,4264,78566,0,0,306442,16895,9340,26235,15250,19250,34500,6311,2589,8900,4903,2077,6980,5665,59,1023,4,0,15,185,2411,3697
2,16/08/2022,0221-Puratchi Thalaivi Dr. J. Jayalalithaa CMBT,130715,216696,0,7864,85934,0,0,224513,0,0,0,0,0,0,4489,2987,7476,3280,3325,6605,4735,59,1769,6,0,17,285,2603,4739
2,16/08/2022,0223-Arumbakkam,47440,52003,200,1688,19160,0,0,68488,1625,335,1960,0,2750,2750,1304,722,2026,1472,577,2049,1375,21,1,4,0,1,46,653,726
2,16/08/2022,0225-Vadapalani,116691,183425,450,4224,68190,0,0,189555,14860,2750,17610,0,7000,7000,4062,2368,6430,4433,2274,6707,4475,41,397,4,0,6,168,2139,2755
2,16/08/2022,0227-Ashok Nagar,106926,125113,1180,2648,40780,0,0,151534,8435,7755,16190,0,10500,10500,3067,1408,4475,3277,1323,4600,3258,34,191,5,0,3,82,1275,1590
2,16/08/2022,0229-Ekkattuthangal,102720,117870,1500,2680,24604,0,0,131504,0,0,0,0,500,500,3156,892,4048,3777,1097,4874,3700,25,189,0,0,3,84,763,1064
2,16/08/2022,0231-Arignar Anna Alandur,164349,195454,1400,4424,64400,0,0,234573,10050,7035,17085,0,6000,6000,5217,1911,7128,4901,1669,6570,5033,49,399,7,0,7,150,1970,2582
2,16/08/2022,0233-St. Thomas Mount,88511,98342,100,3352,29344,0,0,121307,1685,2520,4205,0,1750,1750,2572,1023,3595,2542,931,3473,2662,29,183,0,0,0,120,887,1219
1,17/08/2022,01ED-Wimco Nagar Depot Metro,92368,67629,400,1712,19838,0,0,114318,50,370,420,0,3250,3250,1864,542,2406,1543,333,1876,1516,29,0,2,0,4,36,491,562
1,17/08/2022,01EF-Wimco Nagar Metro,119526,136981,680,3080,34810,0,0,158096,12195,7095,19290,0,750,750,3285,911,4196,3200,981,4181,3220,68,49,3,0,7,70,831,1028
1,17/08/2022,01F1-Thiruvotriyur Metro,109642,103366,1300,1584,23510,0,0,136036,575,760,1335,0,0,0,2704,661,3365,2723,597,3320,2679,37,0,1,0,3,44,618,703
1,17/08/2022,01F3-Thiruvotriyur Theradi Metro,110316,116569,335,1704,26930,0,0,139285,1295,3345,4640,0,0,0,2780,768,3548,3000,825,3825,3046,34,107,4,0,7,53,702,907
1,17/08/2022,01F5-Kaladipet Metro,108294,100024,200,1032,24498,0,0,134024,1175,2800,3975,0,0,0,2979,758,3737,2838,691,3529,2811,30,0,0,0,3,34,718,785
1,17/08/2022,01F7-Tollgate Metro,55493,55409,100,728,14544,0,0,70865,110,430,540,0,0,0,1529,472,2001,1519,393,1912,1501,22,0,0,0,1,24,440,487
1,17/08/2022,01F9-New Washermenpet Metro,89996,90976,350,936,22782,0,0,114064,745,1835,2580,0,1250,1250,2740,793,3533,2718,747,3465,2724,17,53,1,0,0,38,758,867
1,17/08/2022,01FB-Tondiarpet Metro,92086,99827,1130,1352,26256,0,0,120824,2350,3670,6020,0,500,500,2683,867,3550,2912,851,3763,2885,32,2,1,0,4,43,812,894
1,17/08/2022,01FD-Thiagaraya College Metro,111195,111602,500,1608,23228,0,0,136531,3855,2455,6310,0,250,250,3627,823,4450,3525,847,4372,3605,91,105,2,0,0,50,770,1018
1,17/08/2022,0101-Washermanpet,111255,117741,1666,1456,39444,0,0,153821,7905,3760,11665,0,12250,12250,3354,1346,4700,3185,1223,4408,3204,31,101,1,0,6,61,1280,1480
1,17/08/2022,0103-Mannadi,83683,109833,300,1344,32248,0,0,117575,11390,8335,19725,0,0,0,2941,1097,4038,3273,1103,4376,3263,39,48,0,0,1,54,1037,1179
1,17/08/2022,0105-High Court,139951,234286,250,2392,71018,0,0,213611,865,1510,2375,0,0,0,6575,2485,9060,6563,1944,8507,6652,40,184,1,0,5,96,2345,2671
1,17/08/2022,0109-Government Estate,96172,144958,634,1568,43234,0,0,141608,4435,4195,8630,0,1000,1000,3889,1557,5446,4219,1547,5766,4405,17,332,1,0,5,66,1436,1857
1,17/08/2022,0111-LIC,97670,170800,1800,2032,36686,0,0,138188,1255,700,1955,0,0,0,4668,1287,5955,5434,1144,6578,5386,38,0,0,0,2,89,1174,1303
1,17/08/2022,0113-Thousand Lights,125222,234721,1130,3584,45584,0,0,175520,355,380,735,0,1000,1000,6806,1657,8463,7656,1472,9128,7628,36,0,3,1,2,151,1461,1654
1,17/08/2022,0115-AG-DMS,92565,148211,300,2864,28588,0,0,124317,80,0,80,0,0,0,4535,1030,5565,4630,836,5466,4701,30,107,0,0,1,101,901,1140
1,17/08/2022,0117-Teynampet,96943,143747,2100,1720,28806,0,0,129569,0,0,0,0,1250,1250,4348,1078,5426,4827,978,5805,4769,21,0,0,0,1,70,977,1069
1,17/08/2022,0119-Nandanam,93078,118478,2400,1848,29770,0,0,127096,2490,4320,6810,0,0,0,3341,1099,4440,3879,928,4807,3801,31,0,0,0,4,76,1001,1112
1,17/08/2022,0121-Saidapet,52008,77778,20,1344,21760,0,0,75132,1935,1835,3770,0,4500,4500,1880,789,2669,2330,776,3106,2275,14,0,2,0,2,57,721,796
1,17/08/2022,0123-Little Mount,100990,89190,800,1424,21254,0,0,124468,4015,6050,10065,0,2000,2000,3107,805,3912,2691,674,3365,2745,17,129,0,0,4,60,715,925
1,17/08/2022,0125-Guindy,134811,248534,700,5640,77272,0,0,218423,7270,6360,13630,0,6000,6000,6968,2706,9674,6683,2498,9181,6782,48,282,4,0,1,217,2396,2948
1,17/08/2022,0129-Nanganallur Road,52093,46398,500,904,11176,0,0,64673,11285,7615,18900,0,0,0,1286,348,1634,1397,326,1723,1346,12,0,1,1,0,22,321,357
1,17/08/2022,0131-Meenambakkam,143484,127084,600,2896,34838,0,0,181818,6590,15935,22525,0,0,0,3719,1004,4723,2995,848,3843,3142,13,182,3,0,1,70,933,1202
1,17/08/2022,0133-Chennai International Airport,166802,307587,4750,5912,135290,0,0,312754,7615,11045,18660,0,9000,9000,5212,3699,8911,5577,3324,8901,5581,67,483,9,0,15,184,3354,4112
2,17/08/2022,0201-Puratchi Thalaivar Dr. M.G. Ramachandran Central,249264,437473,1995,11696,154982,0,0,417937,20710,1870,22580,0,5200,5200,12442,5613,18055,9613,6976,16589,11728,131,2589,9,0,14,473,5028,8244
2,17/08/2022,0203-Egmore,72889,124486,630,2936,62632,0,0,139087,11505,3950,15455,0,14000,14000,2282,2219,4501,2421,2428,4849,2491,21,372,3,0,10,121,2070,2597
2,17/08/2022,0205-Nehru Park,35610,43242,0,712,15386,0,0,51708,2970,1120,4090,0,2500,2500,1224,539,1763,1150,450,1600,1171,14,62,2,0,1,25,500,604
2,17/08/2022,0207-Kilpauk,38935,56340,600,624,16708,0,0,56867,500,385,885,0,1000,1000,1493,619,2112,1582,559,2141,1600,18,82,1,0,0,27,577,705
2,17/08/2022,0209-Pachaiyappas College,53281,52476,200,648,15530,0,0,69659,1260,500,1760,0,11000,11000,1655,591,2246,1592,471,2063,1568,22,52,0,0,2,16,562,654
2,17/08/2022,0211-Shenoy Nagar,33485,44341,0,952,11104,0,0,45541,1340,1550,2890,0,3000,3000,1262,421,1683,1358,426,1784,1365,15,45,2,0,0,36,379,477
2,17/08/2022,0213-Anna Nagar East,86838,103061,200,2272,29654,0,0,118964,730,3520,4250,0,1500,1500,2806,1059,3865,2916,995,3911,2927,28,102,1,0,1,64,970,1166
2,17/08/2022,0215-Anna Nagar Tower,98818,98599,450,1512,21768,0,0,122548,3475,3910,7385,0,10250,10250,2714,807,3521,2769,846,3615,2939,16,301,1,0,2,62,724,1106
2,17/08/2022,0217-Thirumangalam,272416,289563,600,5376,78790,0,0,357182,64610,20860,85470,0,500,500,7779,2689,10468,7872,2468,10340,7990,71,410,5,0,4,182,2442,3114
2,17/08/2022,0219-Koyambedu,195431,223766,2200,3968,71332,0,0,272931,9705,13685,23390,0,14500,14500,5770,2332,8102,5074,2035,7109,5546,55,782,7,0,14,147,2237,3242
2,17/08/2022,0221-Puratchi Thalaivi Dr. J. Jayalalithaa CMBT,82525,165589,350,3304,72212,0,0,158391,0,0,0,0,0,0,2929,2393,5322,3026,3630,6656,3551,51,919,3,0,3,124,2241,3341
2,17/08/2022,0223-Arumbakkam,47496,57934,500,1032,23042,0,0,72070,185,280,465,0,2750,2750,1459,807,2266,1475,583,2058,1410,53,2,0,0,8,40,751,854
2,17/08/2022,0225-Vadapalani,115928,187132,714,3920,74258,0,0,194820,8770,2150,10920,0,6000,6000,4000,2548,6548,4347,2274,6621,4381,35,379,1,0,8,165,2343,2931
2,17/08/2022,0227-Ashok Nagar,86805,131237,150,2504,46288,0,0,135747,6370,6615,12985,0,0,0,3171,1553,4724,3275,1326,4601,3303,26,194,0,0,1,94,1409,1724
2,17/08/2022,0229-Ekkattuthangal,87625,123933,700,2640,30272,0,0,121237,0,0,0,0,250,250,3383,1070,4453,3729,951,4680,3759,24,191,0,0,1,80,945,1241
2,17/08/2022,0231-Arignar Anna Alandur,157648,195880,300,4416,64334,0,0,226698,7680,9155,16835,0,6000,6000,5226,1921,7147,4819,1826,6645,5095,50,466,2,0,8,130,1946,2602
2,17/08/2022,0233-St. Thomas Mount,92295,96058,0,2192,26500,0,0,120987,2160,3350,5510,0,2375,2375,2672,909,3581,2622,841,3463,2676,24,172,4,0,1,84,794,1079
1,18/08/2022,01ED-Wimco Nagar Depot Metro,69689,63333,200,1208,21670,0,0,92767,90,315,405,0,1000,1000,1777,565,2342,1332,331,1663,1305,18,0,0,0,7,35,527,587
1,18/08/2022,01EF-Wimco Nagar Metro,128951,132216,1560,2160,29948,0,0,162619,9755,6100,15855,0,250,250,3439,804,4243,3236,850,4086,3199,66,58,6,1,11,57,729,928
1,18/08/2022,01F1-Thiruvotriyur Metro,107458,98260,1200,880,20936,0,0,130474,895,950,1845,0,0,0,2793,563,3356,2626,505,3131,2579,32,1,1,0,6,28,541,609
1,18/08/2022,01F3-Thiruvotriyur Theradi Metro,98215,116303,0,1376,27082,0,0,126673,895,2865,3760,0,0,0,2876,770,3646,2983,849,3832,3016,28,99,2,0,3,43,713,888
1,18/08/2022,01F5-Kaladipet Metro,101871,104960,60,1168,27354,0,0,130453,835,2810,3645,0,0,0,2966,816,3782,2970,696,3666,2870,17,0,1,0,11,35,785,849
1,18/08/2022,01F7-Tollgate Metro,61305,55719,0,832,14330,0,0,76467,145,365,510,0,250,250,1607,459,2066,1555,358,1913,1536,26,0,0,0,3,29,404,462
1,18/08/2022,01F9-New Washermenpet Metro,86453,97046,50,896,23800,0,0,111199,925,1890,2815,0,250,250,2903,790,3693,2878,769,3647,2890,31,66,1,0,3,26,768,895
1,18/08/2022,01FB-Tondiarpet Metro,91225,96555,0,1232,24072,0,0,116529,2245,3685,5930,0,1750,1750,2794,814,3608,2911,745,3656,2848,26,0,2,0,5,40,756,829
1,18/08/2022,01FD-Thiagaraya College Metro,107861,115713,700,1696,29152,0,0,139409,2620,2795,5415,0,750,750,3550,977,4527,3557,854,4411,3541,63,27,0,0,2,58,915,1065
1,18/08/2022,0101-Washermanpet,88760,122087,600,2264,41764,0,0,133388,5650,3815,9465,0,5000,5000,3537,1470,5007,3229,1238,4467,3298,27,119,2,0,6,90,1371,1615
1,18/08/2022,0103-Mannadi,71190,112506,5040,1176,32304,0,0,109710,8790,10815,19605,0,0,0,3017,1098,4115,3251,1068,4319,3347,18,166,3,0,1,43,1049,1280
1,18/08/2022,0105-High Court,129861,235193,865,1944,65350,0,0,198020,1400,1725,3125,0,0,0,6787,2224,9011,6583,1940,8523,6902,37,408,0,0,2,87,2151,2685
1,18/08/2022,0109-Government Estate,88803,145505,660,1760,40784,0,0,132007,4190,2745,6935,0,2750,2750,4006,1479,5485,4205,1457,5662,4538,25,459,0,0,5,83,1354,1926
1,18/08/2022,0111-LIC,77092,172958,1500,2320,36354,0,0,117266,985,710,1695,0,250,250,4829,1305,6134,5513,1107,6620,5508,33,1,0,0,4,90,1173,1301
1,18/08/2022,0113-Thousand Lights,116862,237030,1950,3816,49950,0,0,172578,545,455,1000,0,0,0,6733,1796,8529,7589,1477,9066,7518,30,0,0,0,5,160,1587,1782
1,18/08/2022,0115-AG-DMS,100148,151961,500,2096,31362,0,0,134106,0,0,0,0,3000,3000,4637,1065,5702,4623,772,5395,4762,24,149,0,0,1,85,955,1214
1,18/08/2022,0117-Teynampet,91961,141810,500,2456,28966,0,0,123883,0,0,0,0,2000,2000,4447,1092,5539,4722,1024,5746,4699,30,0,1,0,2,87,971,1091
1,18/08/2022,0119-Nandanam,72192,116246,1500,1496,27796,0,0,102984,2000,4760,6760,0,1000,1000,3372,1050,4422,3855,834,4689,3792,27,0,0,0,2,69,950,1048
1,18/08/2022,0121-Saidapet,43197,78234,300,1312,23590,0,0,68399,3100,1640,4740,0,500,500,1929,844,2773,2241,718,2959,2194,15,0,0,0,1,56,781,853
1,18/08/2022,0123-Little Mount,83035,87209,0,1448,21630,0,0,106113,3285,6035,9320,0,250,250,3140,804,3944,2517,547,3064,2634,21,162,2,0,6,62,723,976
1,18/08/2022,0125-Guindy,123793,250279,650,6728,71896,0,0,203067,4870,5215,10085,0,3000,3000,7415,2527,9942,6709,2259,8968,7038,41,455,0,0,6,222,2155,2879
1,18/08/2022,0129-Nanganallur Road,44352,49644,100,336,13038,0,0,57826,9785,7470,17255,0,0,0,1325,403,1728,1457,296,1753,1406,8,0,0,0,3,14,386,411
1,18/08/2022,0131-Meenambakkam,127120,131335,0,1952,37286,0,0,166358,4445,14410,18855,0,0,0,3760,1069,4829,2995,941,3936,3179,28,255,6,0,2,65,993,1349
1,18/08/2022,0133-Chennai International Airport,155616,324721,3375,10144,135422,0,0,304557,8595,10875,19470,0,7500,7500,5620,3725,9345,5705,3573,9278,6049,50,867,13,0,10,238,3356,4534
2,18/08/2022,0201-Puratchi Thalaivar Dr. M.G. Ramachandran Central,251841,451173,3211,10736,145932,0,0,411720,15675,3430,19105,0,7950,7950,12445,5330,17775,10644,7327,17971,12691,107,2834,3,0,13,423,4768,8148
2,18/08/2022,0203-Egmore,70942,133640,100,2072,61030,0,0,134144,10485,2720,13205,0,9500,9500,2500,2101,4601,2925,2527,5452,2987,21,532,2,0,12,90,1978,2635
2,18/08/2022,0205-Nehru Park,36852,51083,30,744,20796,0,0,58422,1925,3095,5020,0,4000,4000,1403,743,2146,1316,522,1838,1318,18,68,1,0,3,24,707,821
2,18/08/2022,0207-Kilpauk,32282,57775,526,656,17786,0,0,51250,250,320,570,0,0,0,1539,644,2183,1576,514,2090,1615,10,86,0,0,1,33,596,726
2,18/08/2022,0209-Pachaiyappas College,54595,54126,0,624,15762,0,0,70981,640,550,1190,0,8000,8000,1710,611,2321,1634,451,2085,1631,15,68,2,0,2,26,576,689
2,18/08/2022,0211-Shenoy Nagar,38866,44246,200,752,11568,0,0,51386,1730,1530,3260,0,0,0,1236,424,1660,1342,417,1759,1350,18,53,0,0,0,29,390,490
2,18/08/2022,0213-Anna Nagar East,68406,110932,150,1952,31376,0,0,101884,955,3515,4470,0,1500,1500,2998,1170,4168,3166,878,4044,3167,18,155,0,0,2,75,1076,1326
2,18/08/2022,0215-Anna Nagar Tower,73460,100812,1543,1784,25614,0,0,102401,2020,3935,5955,0,500,500,2751,908,3659,2855,768,3623,2907,24,210,0,0,5,45,855,1139
2,18/08/2022,0217-Thirumangalam,225505,293131,4200,7120,78124,0,0,314949,79455,18425,97880,0,1500,1500,7984,2740,10724,7911,2337,10248,8108,60,505,4,0,7,235,2442,3253
2,18/08/2022,0219-Koyambedu,175858,236371,600,3656,87174,0,0,267288,6875,13920,20795,0,17750,17750,5701,2891,8592,5332,2130,7462,5525,52,628,4,0,11,141,2774,3610
2,18/08/2022,0221-Puratchi Thalaivi Dr. J. Jayalalithaa CMBT,53998,172339,500,2216,81396,0,0,138110,0,0,0,0,0,0,2230,2514,4744,4320,4329,8649,3572,32,335,4,0,4,90,2541,3006
2,18/08/2022,0223-Arumbakkam,47235,56408,200,1208,22432,0,0,71075,1005,345,1350,0,750,750,1476,857,2333,1503,634,2137,1400,37,0,2,0,4,50,783,876
2,18/08/2022,0225-Vadapalani,105981,198620,0,5024,79580,0,0,190585,12730,3420,16150,0,2000,2000,4201,2786,6987,4366,2558,6924,4562,45,526,3,0,7,191,2545,3317
2,18/08/2022,0227-Ashok Nagar,116867,138942,1900,4256,35744,0,0,158767,6580,6430,13010,0,3000,3000,3855,1323,5178,3383,1329,4712,3964,36,713,0,0,3,157,1126,2035
2,18/08/2022,0229-Ekkattuthangal,74989,122861,1900,2288,30842,0,0,110019,0,0,0,0,0,0,3579,1112,4691,3503,889,4392,3677,18,269,0,0,3,93,985,1368
2,18/08/2022,0231-Arignar Anna Alandur,148386,192380,200,4024,61148,0,0,213758,5945,8250,14195,0,4750,4750,5229,1864,7093,4884,1664,6548,5085,40,411,5,0,4,133,1837,2430
2,18/08/2022,0233-St. Thomas Mount,72883,100854,400,2872,32168,0,0,108323,3415,2570,5985,0,2000,2000,2761,1138,3899,2619,882,3501,2665,20,152,2,0,4,106,1009,1293
1,19/08/2022,01ED-Wimco Nagar Depot Metro,51687,58183,1300,1016,20682,0,0,74685,150,160,310,0,6250,6250,1323,528,1851,1181,370,1551,1161,19,0,0,0,6,30,502,557
1,19/08/2022,01EF-Wimco Nagar Metro,81645,102554,150,2112,30070,0,0,113977,7985,5515,13500,0,0,0,2382,790,3172,2166,785,2951,2233,54,101,5,0,17,63,699,939
1,19/08/2022,01F1-Thiruvotriyur Metro,71426,69611,200,1368,18200,0,0,91194,570,885,1455,0,0,0,1876,506,2382,1719,451,2170,1686,68,0,3,0,8,38,471,588
1,19/08/2022,01F3-Thiruvotriyur Theradi Metro,70315,95131,1300,1568,27902,0,0,101085,980,2335,3315,0,0,0,2052,792,2844,2225,849,3074,2281,27,111,3,0,7,44,707,899
1,19/08/2022,01F5-Kaladipet Metro,58435,71137,0,984,22228,0,0,81647,690,1655,2345,0,0,0,1877,661,2538,1819,562,2381,1793,20,0,0,0,5,34,623,682
1,19/08/2022,01F7-Tollgate Metro,41357,43575,0,720,14558,0,0,56635,300,180,480,0,0,0,1083,450,1533,1073,356,1429,1047,28,0,0,0,7,29,402,466
1,19/08/2022,01F9-New Washermenpet Metro,59718,70908,0,568,22168,0,0,82454,820,1225,2045,0,250,250,1899,686,2585,1871,584,2455,1874,13,44,1,0,4,22,659,743
1,19/08/2022,01FB-Tondiarpet Metro,58939,73484,1362,1344,24250,0,0,85895,2095,2340,4435,0,0,0,1861,775,2636,1916,712,2628,1861,23,0,0,0,9,47,719,798
1,19/08/2022,01FD-Thiagaraya College Metro,76063,83927,400,1400,27564,0,0,105427,3610,4040,7650,0,4000,4000,2341,897,3238,2212,756,2968,2222,47,21,0,0,5,49,839,961
1,19/08/2022,0101-Washermanpet,73374,86605,800,1760,33614,0,0,109548,9480,6190,15670,0,11000,11000,2282,1122,3404,2043,1001,3044,2092,18,88,1,0,11,65,1039,1222
1,19/08/2022,0103-Mannadi,66502,85358,82,1720,31980,0,0,100284,8270,6325,14595,0,3000,3000,2063,1068,3131,2196,962,3158,2233,19,82,0,0,3,46,1007,1157
1,19/08/2022,0105-High Court,62639,121483,200,1224,43758,0,0,107821,1100,3190,4290,0,0,0,2970,1426,4396,3001,1264,4265,3167,20,243,1,0,5,56,1434,1759
1,19/08/2022,0109-Government Estate,73288,118165,200,2296,43022,0,0,118806,3755,3330,7085,0,4250,4250,2923,1549,4472,3117,1304,4421,3254,18,256,1,0,4,88,1417,1784
1,19/08/2022,0111-LIC,44136,91566,700,1960,24236,0,0,71032,750,395,1145,0,0,0,2231,846,3077,2730,716,3446,2720,20,0,0,0,2,79,745,846
1,19/08/2022,0113-Thousand Lights,67386,138931,300,3072,35838,0,0,106596,475,405,880,0,0,0,3678,1302,4980,4182,1155,5337,4134,19,0,2,0,7,123,1154,1305
1,19/08/2022,0115-AG-DMS,54004,74609,200,1936,16772,0,0,72912,210,0,210,0,0,0,2035,588,2623,2087,516,2603,2217,17,155,0,0,2,73,503,750
1,19/08/2022,0117-Teynampet,51259,86171,1330,1480,21872,0,0,75941,0,0,0,0,3000,3000,2325,814,3139,2717,702,3419,2687,18,0,2,0,2,65,721,808
1,19/08/2022,0119-Nandanam,52318,84622,1300,1808,25076,0,0,80502,1590,2200,3790,0,500,500,2283,938,3221,2556,751,3307,2508,26,0,2,0,7,78,828,941
1,19/08/2022,0121-Saidapet,25210,49199,350,1680,19884,0,0,47124,1110,1185,2295,0,0,0,1052,699,1751,1179,619,1798,1158,5,1,2,0,2,61,628,699
1,19/08/2022,0123-Little Mount,56499,65969,300,1272,19892,0,0,77963,2275,3075,5350,0,250,250,2086,713,2799,1796,495,2291,1876,13,131,3,0,4,56,647,854
1,19/08/2022,0125-Guindy,77725,185054,400,5224,72394,0,0,155743,4075,3060,7135,0,3000,3000,4521,2517,7038,4249,2017,6266,4480,15,335,1,0,9,187,2148,2695
1,19/08/2022,0129-Nanganallur Road,27272,29645,0,336,8730,0,0,36338,4360,3610,7970,0,0,0,732,265,997,807,236,1043,767,9,0,0,0,4,14,255,282
1,19/08/2022,0131-Meenambakkam,81446,96032,0,3472,30934,0,0,115852,4530,12170,16700,0,0,0,2419,931,3350,1966,809,2775,2163,10,242,4,0,3,105,836,1200
1,19/08/2022,0133-Chennai International Airport,137037,301888,1300,9256,152112,0,0,299705,9590,9385,18975,0,3000,3000,4383,4233,8616,4461,3788,8249,4792,72,750,11,1,21,280,3766,4901
2,19/08/2022,0201-Puratchi Thalaivar Dr. M.G. Ramachandran Central,188801,364741,1358,8960,138026,0,0,337145,13245,1680,14925,0,7050,7050,8588,4843,13431,7017,6848,13865,8861,86,2510,9,0,24,333,4402,7364
2,19/08/2022,0203-Egmore,55144,109207,200,2936,56038,0,0,114318,6550,3260,9810,0,11500,11500,1730,2017,3747,2179,2104,4283,2121,16,293,7,0,17,108,1878,2319
2,19/08/2022,0205-Nehru Park,27201,35868,0,824,14080,0,0,42105,7520,485,8005,0,4000,4000,934,534,1468,887,480,1367,921,14,86,0,0,3,33,490,626
2,19/08/2022,0207-Kilpauk,27853,40516,0,928,13804,0,0,42585,415,175,590,0,0,0,978,501,1479,1047,441,1488,1086,7,92,0,0,1,46,455,601
2,19/08/2022,0209-Pachaiyappas College,36693,33569,0,704,11220,0,0,48617,770,440,1210,0,12000,12000,989,406,1395,923,330,1253,933,12,64,0,0,1,22,376,475
2,19/08/2022,0211-Shenoy Nagar,23482,32621,0,864,10164,0,0,34510,2550,940,3490,0,0,0,888,375,1263,900,343,1243,908,8,44,3,0,3,34,337,429
2,19/08/2022,0213-Anna Nagar East,61581,79888,100,1352,23772,0,0,86805,1175,2175,3350,0,0,0,2157,860,3017,2168,766,2934,2238,19,156,1,0,8,60,782,1026
2,19/08/2022,0215-Anna Nagar Tower,57885,70608,0,1224,21908,0,0,81017,3930,4945,8875,0,250,250,1856,771,2627,1811,751,2562,1903,16,174,1,0,4,49,707,951
2,19/08/2022,0217-Thirumangalam,165052,227027,1000,6136,80704,0,0,252892,98875,13915,112790,0,1500,1500,5324,2773,8097,5338,2458,7796,5469,48,480,9,0,7,231,2474,3249
2,19/08/2022,0219-Koyambedu,111749,165141,700,3640,73776,0,0,189865,9730,6135,15865,0,5500,5500,3608,2458,6066,3242,1990,5232,3401,41,532,2,0,23,140,2351,3089
2,19/08/2022,0221-Puratchi Thalaivi Dr. J. Jayalalithaa CMBT,44220,139277,200,1664,68614,0,0,114698,0,0,0,0,0,0,1679,2230,3909,3088,3915,7003,2752,29,323,10,0,4,69,2138,2573
2,19/08/2022,0223-Arumbakkam,35631,45749,0,1064,20028,0,0,56723,420,200,620,0,5250,5250,1123,744,1867,1129,577,1706,1068,40,1,0,0,8,31,696,776
2,19/08/2022,0225-Vadapalani,89581,202589,30,6264,88692,0,0,184567,26890,5470,32360,0,4500,4500,3965,3141,7106,4020,2959,6979,4302,34,588,5,0,16,237,2832,3712
2,19/08/2022,0227-Ashok Nagar,72091,96556,1000,3256,33514,0,0,109861,4420,3895,8315,0,7500,7500,2381,1229,3610,2243,1223,3466,2446,22,344,7,0,2,114,1083,1572
2,19/08/2022,0229-Ekkattuthangal,57222,92520,200,2456,29306,0,0,89184,0,0,0,0,1000,1000,2468,1042,3510,2380,815,3195,2528,14,231,0,0,1,98,925,1269
2,19/08/2022,0231-Arignar Anna Alandur,106408,155083,100,3696,60764,0,0,170968,6825,5385,12210,0,3250,3250,3594,1897,5491,3288,1625,4913,3580,42,489,7,0,8,142,1795,2483
2,19/08/2022,0233-St. Thomas Mount,61592,85375,0,3472,34066,0,0,99130,1120,1600,2720,0,1625,1625,1927,1161,3088,1784,899,2683,1926,19,213,2,0,4,125,1003,1366
1,20/08/2022,01ED-Wimco Nagar Depot Metro,62690,67621,0,2152,27544,0,0,92386,90,140,230,0,250,250,1570,712,2282,1299,418,1717,1300,18,0,0,0,13,60,657,748
1,20/08/2022,01EF-Wimco Nagar Metro,100631,123798,34,2464,40518,0,0,143647,10990,5365,16355,0,0,0,2716,1041,3757,2558,1039,3597,2588,86,105,2,0,18,72,947,1230
1,20/08/2022,01F1-Thiruvotriyur Metro,90565,88856,0,1776,28920,0,0,121261,820,980,1800,0,0,0,2201,782,2983,2037,694,2731,1979,63,0,0,0,4,48,715,830
1,20/08/2022,01F3-Thiruvotriyur Theradi Metro,85034,116357,100,2360,38998,0,0,126492,1165,1875,3040,0,0,0,2496,1084,3580,2512,1100,3612,2606,29,189,4,0,13,64,1000,1299
1,20/08/2022,01F5-Kaladipet Metro,68178,84019,0,1832,28910,0,0,98920,740,1500,2240,0,0,0,2176,885,3061,2076,734,2810,2019,17,0,1,0,11,57,826,912
1,20/08/2022,01F7-Tollgate Metro,51299,52704,200,784,18688,0,0,70971,535,875,1410,0,0,0,1305,572,1877,1317,437,1754,1261,26,0,0,0,13,33,538,610
1,20/08/2022,01F9-New Washermenpet Metro,68873,85468,0,1256,31878,0,0,102007,1145,1420,2565,0,250,250,2211,1013,3224,2147,801,2948,2113,16,70,4,0,3,45,967,1105
1,20/08/2022,01FB-Tondiarpet Metro,63052,85524,320,1456,30462,0,0,95290,1945,2230,4175,0,250,250,2021,958,2979,2168,952,3120,2103,18,0,0,0,10,52,904,984
1,20/08/2022,01FD-Thiagaraya College Metro,82009,110374,350,2680,39110,0,0,124149,2865,3420,6285,0,500,500,2976,1283,4259,2806,1095,3901,2836,76,54,0,0,7,93,1168,1398
1,20/08/2022,0101-Washermanpet,78435,111060,1766,2208,47650,0,0,130059,11850,4050,15900,0,14250,14250,2705,1558,4263,2499,1389,3888,2503,19,160,0,0,24,88,1449,1740
1,20/08/2022,0103-Mannadi,67846,96437,100,1848,34730,0,0,104524,11030,6515,17545,0,0,0,2337,1236,3573,2546,1223,3769,2594,19,154,1,0,4,77,1142,1397
1,20/08/2022,0105-High Court,88030,173381,450,3632,68992,0,0,161104,2360,1540,3900,0,0,0,4006,2255,6261,4017,1893,5910,4181,26,286,1,0,11,137,2192,2653
1,20/08/2022,0109-Government Estate,72085,140801,1338,3040,52476,0,0,128939,7045,2475,9520,0,5500,5500,3334,1861,5195,3438,1742,5180,3701,25,448,2,0,6,121,1698,2300
1,20/08/2022,0111-LIC,56227,118054,500,2184,32160,0,0,91071,1770,450,2220,0,2000,2000,2858,1142,4000,3513,914,4427,3433,20,12,0,0,6,92,1009,1139
1,20/08/2022,0113-Thousand Lights,90540,171789,224,3984,50714,0,0,145462,475,185,660,0,0,0,4260,1742,6002,5008,1435,6443,4846,18,0,0,0,6,154,1539,1717
1,20/08/2022,0115-AG-DMS,47205,78075,200,1880,20636,0,0,69921,0,0,0,0,250,250,2039,718,2757,2090,613,2703,2204,19,161,2,0,1,73,630,886
1,20/08/2022,0117-Teynampet,49178,105416,360,1320,31340,0,0,82198,0,0,0,0,0,0,2645,1129,3774,3132,996,4128,3011,8,0,1,0,2,60,1042,1113
1,20/08/2022,0119-Nandanam,50971,83303,100,1256,33220,0,0,85547,890,2955,3845,0,0,0,1973,1167,3140,2171,848,3019,2068,20,0,6,0,9,49,1096,1180
1,20/08/2022,0121-Saidapet,28104,56045,0,1488,24138,0,0,53730,2605,1130,3735,0,6500,6500,1074,836,1910,1311,720,2031,1248,13,0,6,0,3,59,771,852
1,20/08/2022,0123-Little Mount,48455,64999,450,1624,23294,0,0,73823,2780,2925,5705,0,250,250,1772,826,2598,1537,632,2169,1618,19,150,1,0,10,56,730,966
1,20/08/2022,0125-Guindy,82869,206536,50,6152,90578,0,0,179649,4635,3095,7730,0,1500,1500,4403,3080,7483,4276,2638,6914,4398,31,446,2,0,13,210,2567,3269
1,20/08/2022,0129-Nanganallur Road,33725,39887,0,968,15168,0,0,49861,9235,4295,13530,0,0,0,828,482,1310,978,432,1410,893,11,0,4,0,1,31,436,483
1,20/08/2022,0131-Meenambakkam,95820,117903,1200,3232,46892,0,0,147144,6170,11930,18100,0,0,0,2693,1331,4024,2182,1061,3243,2335,29,274,1,0,5,98,1261,1668
1,20/08/2022,0133-Chennai International Airport,130038,336111,1915,11136,182804,0,0,325893,16190,7890,24080,0,3750,3750,4460,5136,9596,4936,4525,9461,4865,58,829,18,0,26,340,4361,5632
2,20/08/2022,0201-Puratchi Thalaivar Dr. M.G. Ramachandran Central,247116,425218,400,11064,129636,0,0,388216,13710,1510,15220,0,3350,3350,10812,4652,15464,7475,7855,15330,11202,84,4428,13,0,24,423,4007,8979
2,20/08/2022,0203-Egmore,62436,122819,850,2864,56010,0,0,122160,9185,1375,10560,0,5250,5250,2076,1952,4028,2426,2676,5102,2639,17,661,13,0,17,118,1803,2629
2,20/08/2022,0205-Nehru Park,27279,41984,0,1304,16562,0,0,45145,1445,605,2050,0,2000,2000,1010,613,1623,997,563,1560,1044,8,141,3,0,1,52,560,765
2,20/08/2022,0207-Kilpauk,25052,47927,0,1128,17514,0,0,43694,450,90,540,0,0,0,1179,630,1809,1212,532,1744,1218,16,71,0,0,5,44,577,713
2,20/08/2022,0209-Pachaiyappas College,33578,43917,100,1104,15550,0,0,50332,1250,1410,2660,0,6000,6000,1237,570,1807,1164,474,1638,1195,12,71,1,0,3,40,523,650
2,20/08/2022,0211-Shenoy Nagar,24419,36976,650,936,14064,0,0,40069,1620,650,2270,0,0,0,903,516,1419,950,405,1355,954,11,53,4,0,0,39,481,588
2,20/08/2022,0213-Anna Nagar East,60874,105462,400,3000,37470,0,0,101744,890,1925,2815,0,1500,1500,2618,1368,3986,2634,1020,3654,2664,19,219,3,0,2,109,1244,1596
2,20/08/2022,0215-Anna Nagar Tower,57887,84320,200,2032,30998,0,0,91117,3095,3940,7035,0,250,250,1945,1095,3040,2014,948,2962,2034,18,219,2,0,4,77,998,1318
2,20/08/2022,0217-Thirumangalam,177146,269147,650,8024,106784,0,0,292604,109335,11735,121070,0,1500,1500,5877,3592,9469,5851,3087,8938,6025,64,733,4,0,13,289,3225,4328
2,20/08/2022,0219-Koyambedu,119197,201128,200,4256,91820,0,0,215473,7315,4775,12090,0,6000,6000,4090,3097,7187,3799,2414,6213,4016,54,723,7,0,30,177,2836,3827
2,20/08/2022,0221-Puratchi Thalaivi Dr. J. Jayalalithaa CMBT,55310,167489,300,2024,83094,0,0,140728,0,0,0,0,0,0,2056,2712,4768,3701,4368,8069,3205,34,530,6,0,12,82,2593,3257
2,20/08/2022,0223-Arumbakkam,34804,54531,200,1440,26606,0,0,63050,7790,240,8030,0,4000,4000,1176,992,2168,1270,830,2100,1160,39,4,0,0,9,63,900,1015
2,20/08/2022,0225-Vadapalani,102900,235979,500,8648,107462,0,0,219510,32590,6110,38700,0,3500,3500,4303,3851,8154,4514,3691,8205,4880,33,937,4,0,21,321,3350,4666
2,20/08/2022,0227-Ashok Nagar,77095,123620,530,2864,44442,0,0,124931,6870,3205,10075,0,0,0,2886,1608,4494,2718,1552,4270,3052,21,621,3,0,6,122,1408,2181
2,20/08/2022,0229-Ekkattuthangal,52500,76420,650,1608,26840,0,0,81598,0,0,0,0,0,0,1961,935,2896,1880,828,2708,1991,15,313,1,0,0,67,847,1243
2,20/08/2022,0231-Arignar Anna Alandur,117118,188050,800,4720,84414,0,0,207052,8310,5100,13410,0,3750,3750,3811,2741,6552,3707,2322,6029,3898,55,552,7,0,16,160,2461,3251
2,20/08/2022,0233-St. Thomas Mount,69380,102390,0,4176,42570,0,0,116126,1570,1695,3265,0,6000,6000,2120,1433,3553,2013,1193,3206,2216,28,385,2,0,2,151,1261,1829
1,21/08/2022,01ED-Wimco Nagar Depot Metro,42378,64614,100,848,32262,0,0,75588,180,45,225,0,250,250,981,782,1763,1109,517,1626,970,13,0,3,0,20,25,760,821
1,21/08/2022,01EF-Wimco Nagar Metro,54396,90510,0,2360,42540,0,0,99296,10875,4715,15590,0,0,0,1360,1087,2447,1520,1060,2580,1435,67,93,4,0,23,58,1022,1267
1,21/08/2022,01F1-Thiruvotriyur Metro,70857,83946,0,2800,38044,0,0,111701,975,1035,2010,0,0,0,1428,1034,2462,1533,885,2418,1457,71,4,5,0,18,70,949,1117
1,21/08/2022,01F3-Thiruvotriyur Theradi Metro,72328,110942,0,2808,51234,0,0,126370,1130,1780,2910,0,0,0,1698,1398,3096,1942,1343,3285,1914,34,188,3,0,23,79,1289,1616
1,21/08/2022,01F5-Kaladipet Metro,44206,75729,500,1696,38442,0,0,84844,785,1130,1915,0,0,0,1248,1072,2320,1471,995,2466,1307,6,0,0,0,10,55,1016,1087
1,21/08/2022,01F7-Tollgate Metro,27439,46723,0,1024,23120,0,0,51583,320,255,575,0,0,0,752,698,1450,887,591,1478,807,31,0,0,0,23,31,646,731
1,21/08/2022,01F9-New Washermenpet Metro,50634,75804,700,784,35886,0,0,88004,1175,1060,2235,0,0,0,1388,1054,2442,1517,857,2374,1444,16,104,0,0,23,34,1014,1191
1,21/08/2022,01FB-Tondiarpet Metro,41412,73324,100,2256,35902,0,0,79670,2485,1430,3915,0,0,0,1216,1079,2295,1473,1092,2565,1345,25,1,1,0,21,61,1008,1117
1,21/08/2022,01FD-Thiagaraya College Metro,64165,93015,220,2760,47038,0,0,114183,4160,1615,5775,0,250,250,1665,1486,3151,1728,1250,2978,1696,80,81,1,0,11,92,1360,1625
1,21/08/2022,0101-Washermanpet,70416,87635,0,2712,46818,0,0,119946,10975,5655,16630,0,18500,18500,1523,1522,3045,1457,1355,2812,1500,16,186,0,0,25,80,1437,1744
1,21/08/2022,0103-Mannadi,40983,69858,0,1368,39678,0,0,82029,13975,4060,18035,0,0,0,1095,1304,2399,1197,1217,2414,1191,17,145,0,0,7,57,1241,1467
1,21/08/2022,0105-High Court,35225,69393,150,1432,37018,0,0,73825,725,785,1510,0,0,0,1286,1257,2543,1191,1054,2245,1277,15,186,1,0,8,59,1224,1493
1,21/08/2022,0109-Government Estate,47170,99652,100,2816,47140,0,0,97226,4060,1195,5255,0,0,0,1852,1688,3540,1802,1522,3324,2017,22,461,5,0,17,93,1540,2138
1,21/08/2022,0111-LIC,14608,55088,600,2128,32064,0,0,49400,820,155,975,0,0,0,755,1068,1823,966,859,1825,898,9,0,1,0,2,82,968,1062
1,21/08/2022,0113-Thousand Lights,28552,71569,0,2624,35842,0,0,67018,360,180,540,0,0,0,1174,1228,2402,1646,1125,2771,1402,20,0,4,0,10,86,1123,1243
1,21/08/2022,0115-AG-DMS,26306,46149,0,960,18960,0,0,46226,0,0,0,0,0,0,967,629,1596,865,596,1461,993,14,260,0,0,5,36,568,883
1,21/08/2022,0117-Teynampet,21026,51646,0,1720,27912,0,0,50658,0,0,0,0,0,0,727,959,1686,1070,829,1899,925,13,1,3,0,6,64,887,974
1,21/08/2022,0119-Nandanam,25620,65376,0,1432,37846,0,0,64898,1190,555,1745,0,2000,2000,970,1335,2305,1268,952,2220,1068,24,0,4,0,17,45,1268,1358
1,21/08/2022,0121-Saidapet,18808,48795,0,1600,29214,0,0,49622,2350,655,3005,0,2000,2000,612,972,1584,880,923,1803,733,6,0,3,0,7,55,924,995
1,21/08/2022,0123-Little Mount,26625,58407,0,2184,30596,0,0,59405,8380,1765,10145,0,0,0,1024,1092,2116,1065,786,1851,1051,11,123,3,0,16,77,970,1200
1,21/08/2022,0125-Guindy,80065,170372,100,5520,80510,0,0,166195,7890,2505,10395,0,3000,3000,2817,2617,5434,2527,2877,5404,3059,28,1011,6,0,20,193,2295,3553
1,21/08/2022,0129-Nanganallur Road,10097,29079,500,944,16836,0,0,28377,6860,1550,8410,0,0,0,329,500,829,548,424,972,434,5,1,2,0,1,31,471,511
1,21/08/2022,0131-Meenambakkam,56459,96751,100,3272,47280,0,0,107111,7955,5605,13560,0,0,0,1578,1273,2851,1265,1161,2426,1539,18,424,2,0,15,93,1221,1773
1,21/08/2022,0133-Chennai International Airport,120077,328914,100,10360,196534,0,0,327071,14455,4015,18470,0,0,0,3580,5334,8914,3937,4912,8849,4027,66,1193,14,0,28,317,4865,6483
2,21/08/2022,0201-Puratchi Thalaivar Dr. M.G. Ramachandran Central,225082,406752,201,13728,169078,0,0,408089,18025,845,18870,0,2100,2100,8211,5891,14102,4783,7755,12538,8312,77,4607,5,0,31,487,5158,10365
2,21/08/2022,0203-Egmore,59748,127577,750,4272,71184,0,0,135954,13265,2625,15890,0,6500,6500,2040,2517,4557,2166,2837,5003,2252,20,655,7,0,20,156,2318,3176
2,21/08/2022,0205-Nehru Park,25004,39995,0,864,19820,0,0,45688,1930,890,2820,0,4000,4000,782,740,1522,694,578,1272,768,16,165,3,0,6,34,689,913
2,21/08/2022,0207-Kilpauk,16771,29977,0,480,13978,0,0,31229,100,10,110,0,0,0,579,490,1069,613,438,1051,614,12,105,0,0,3,20,458,598
2,21/08/2022,0209-Pachaiyappas College,18647,30802,0,336,13908,0,0,32891,2330,520,2850,0,3000,3000,615,472,1087,626,485,1111,656,9,99,1,0,5,13,452,579
2,21/08/2022,0211-Shenoy Nagar,19525,22903,300,888,10552,0,0,31265,1490,540,2030,0,2000,2000,465,370,835,488,420,908,487,7,74,2,0,2,22,335,442
2,21/08/2022,0213-Anna Nagar East,35263,68453,700,1248,31670,0,0,68881,1085,1085,2170,0,0,0,1418,1102,2520,1434,1042,2476,1450,13,242,6,0,9,54,1029,1353
2,21/08/2022,0215-Anna Nagar Tower,31903,65502,100,1776,29624,0,0,63403,4430,2925,7355,0,250,250,1233,1022,2255,1261,911,2172,1325,14,220,0,0,4,70,947,1255
2,21/08/2022,0217-Thirumangalam,107349,219086,250,6816,115564,0,0,229979,101885,7965,109850,0,0,0,3533,3783,7316,3843,3237,7080,3745,32,761,8,0,12,257,3485,4555
2,21/08/2022,0219-Koyambedu,94853,179890,250,6024,101502,0,0,202629,8045,2430,10475,0,3750,3750,2918,3393,6311,2734,2468,5202,2899,38,785,10,0,46,246,3148,4273
2,21/08/2022,0221-Puratchi Thalaivi Dr. J. Jayalalithaa CMBT,79369,190631,50,3528,95406,0,0,178353,0,0,0,0,0,0,2841,3056,5897,2901,4312,7213,3314,25,1567,5,0,13,162,2835,4607
2,21/08/2022,0223-Arumbakkam,27636,50568,100,1816,29664,0,0,59216,1280,80,1360,0,2000,2000,761,1107,1868,1025,814,1839,829,40,3,1,0,26,65,1024,1159
2,21/08/2022,0225-Vadapalani,100512,217890,0,6976,102214,0,0,209702,36770,6390,43160,0,1000,1000,3869,3543,7412,3454,3460,6914,4225,47,1620,6,0,31,265,3211,5180
2,21/08/2022,0227-Ashok Nagar,56268,103659,200,2888,45002,0,0,104358,7360,3435,10795,0,0,0,2045,1549,3594,1789,1707,3496,2156,16,810,1,0,10,100,1418,2355
2,21/08/2022,0229-Ekkattuthangal,29237,52439,150,1640,23140,0,0,54167,0,0,0,0,0,0,1059,836,1895,1198,807,2005,1178,14,310,1,0,3,67,759,1154
2,21/08/2022,0231-Arignar Anna Alandur,77572,170353,300,5888,92212,0,0,175972,8055,3770,11825,0,250,250,2494,2977,5471,2624,2404,5028,2778,39,719,11,0,24,207,2680,3680
2,21/08/2022,0233-St. Thomas Mount,47873,89975,200,3688,49164,0,0,100925,3395,1560,4955,0,6750,6750,1358,1603,2961,1448,1413,2861,1467,21,363,5,0,13,131,1446,1979
1,22/08/2022,01ED-Wimco Nagar Depot Metro,93966,75833,0,1072,25442,0,0,120480,250,550,800,0,2250,2250,1851,640,2491,1651,458,2109,1573,24,0,2,0,11,30,617,684
1,22/08/2022,01EF-Wimco Nagar Metro,146522,138459,2100,2952,36370,0,0,187944,22150,8690,30840,0,3000,3000,3356,980,4336,3230,1000,4230,3182,96,72,5,0,12,82,893,1160
1,22/08/2022,01F1-Thiruvotriyur Metro,136491,107538,0,1504,23240,0,0,161235,970,1175,2145,0,0,0,2804,656,3460,2873,581,3454,2775,59,0,1,0,4,41,605,710
1,22/08/2022,01F3-Thiruvotriyur Theradi Metro,113093,121083,2500,1752,31042,0,0,148387,1240,3530,4770,0,0,0,2730,910,3640,3068,901,3969,3048,28,96,4,0,6,59,830,1023
1,22/08/2022,01F5-Kaladipet Metro,120936,105270,0,1448,26812,0,0,149196,1275,2515,3790,0,0,0,2931,838,3769,3007,784,3791,2940,32,0,1,0,6,47,791,877
1,22/08/2022,01F7-Tollgate Metro,66710,59188,106,960,16456,0,0,84232,250,190,440,0,0,0,1603,511,2114,1581,499,2080,1541,33,1,1,0,6,30,476,547
1,22/08/2022,01F9-New Washermenpet Metro,114877,100905,700,896,26738,0,0,143211,1375,2495,3870,0,250,250,2871,874,3745,2925,849,3774,2915,17,64,1,0,6,32,834,954
1,22/08/2022,01FB-Tondiarpet Metro,105957,103447,44,1296,29818,0,0,137115,4470,4000,8470,0,500,500,2700,961,3661,2980,877,3857,2876,31,2,2,0,3,43,917,998
1,22/08/2022,01FD-Thiagaraya College Metro,133062,123318,200,2000,32734,0,0,167996,4165,4740,8905,0,1250,1250,3644,1135,4779,3701,974,4675,3685,62,38,1,0,3,69,1065,1238
1,22/08/2022,0101-Washermanpet,118020,122506,1040,1752,41478,0,0,162290,7170,4580,11750,0,10750,10750,3486,1398,4884,3260,1296,4556,3294,27,117,2,0,4,76,1311,1537
1,22/08/2022,0103-Mannadi,107036,115463,200,1440,33154,0,0,141830,9275,7110,16385,0,0,0,3048,1164,4212,3462,1231,4693,3449,21,97,2,0,8,58,1096,1282
1,22/08/2022,0105-High Court,179931,232248,3230,2192,61442,0,0,246795,845,1710,2555,0,0,0,6799,1979,8778,6748,1909,8657,6945,48,364,1,0,3,95,2036,2547
1,22/08/2022,0109-Government Estate,103136,147974,400,2184,44936,0,0,150656,4335,3295,7630,0,4250,4250,3885,1602,5487,4234,1439,5673,4469,29,371,0,0,7,90,1496,1993
1,22/08/2022,0111-LIC,99517,168424,650,2080,35196,0,0,137443,2085,650,2735,0,0,0,4709,1233,5942,5466,1139,6605,5376,30,0,0,0,5,83,1136,1254
1,22/08/2022,0113-Thousand Lights,148629,242373,2100,4016,48738,0,0,203483,880,240,1120,0,250,250,6870,1815,8685,7965,1578,9543,7796,45,0,2,0,5,172,1593,1817
1,22/08/2022,0115-AG-DMS,110458,148333,0,2240,28028,0,0,140726,0,0,0,0,2750,2750,4665,950,5615,4700,845,5545,4742,28,155,8,0,3,73,847,1114
1,22/08/2022,0117-Teynampet,98740,150911,1605,2168,34506,0,0,137019,0,0,0,0,0,0,4382,1276,5658,4992,1105,6097,4839,29,1,1,0,4,84,1164,1283
1,22/08/2022,0119-Nandanam,91697,121020,510,2560,31180,0,0,125947,2530,3295,5825,0,0,0,3338,1158,4496,4016,953,4969,3881,42,0,1,0,4,84,1061,1192
1,22/08/2022,0121-Saidapet,59683,81935,354,1352,24610,0,0,85999,2720,1325,4045,0,2250,2250,1890,878,2768,2443,835,3278,2326,16,0,1,0,2,56,821,896
1,22/08/2022,0123-Little Mount,87787,91771,100,1640,23292,0,0,112819,5480,8170,13650,0,250,250,3008,873,3881,2733,667,3400,2787,18,136,1,0,2,67,778,1002
1,22/08/2022,0125-Guindy,132553,252845,650,5248,80578,0,0,219029,10405,6235,16640,0,0,0,7019,2820,9839,6959,2501,9460,6841,39,255,2,0,5,204,2482,2987
1,22/08/2022,0129-Nanganallur Road,49235,47786,0,552,11952,0,0,61739,2100,6185,8285,0,0,0,1301,365,1666,1422,336,1758,1356,6,3,1,0,1,12,339,362
1,22/08/2022,0131-Meenambakkam,134328,140172,700,2888,40674,0,0,178590,12305,16095,28400,0,0,0,3791,1175,4966,3190,904,4094,3357,21,247,0,0,4,96,1076,1444
1,22/08/2022,0133-Chennai International Airport,206593,344334,3210,8744,138872,0,0,357419,11300,11215,22515,0,12250,12250,6115,3844,9959,6146,3780,9926,6487,68,1049,18,1,29,253,3533,4951
2,22/08/2022,0201-Puratchi Thalaivar Dr. M.G. Ramachandran Central,359618,480906,1269,13608,124716,0,0,499211,39890,4765,44655,0,8300,8300,15430,4665,20095,10004,7572,17576,14164,181,4728,9,0,23,522,3937,9400
2,22/08/2022,0203-Egmore,90435,135144,800,3632,62708,0,0,157575,23255,4520,27775,0,9250,9250,2877,2245,5122,2569,2402,4971,2842,25,650,6,0,9,136,2087,2913
2,22/08/2022,0205-Nehru Park,42403,45509,0,720,16118,0,0,59241,2845,2175,5020,0,0,0,1280,604,1884,1272,528,1800,1267,16,83,1,0,2,34,566,702
2,22/08/2022,0207-Kilpauk,44898,55486,0,1064,17254,0,0,63216,490,265,755,0,0,0,1444,598,2042,1563,520,2083,1563,18,88,0,0,0,40,561,707
2,22/08/2022,0209-Pachaiyappas College,53376,55041,100,744,15936,0,0,70156,1490,770,2260,0,6500,6500,1772,620,2392,1627,490,2117,1648,23,100,1,0,4,26,583,737
2,22/08/2022,0211-Shenoy Nagar,37830,45477,0,416,11670,0,0,49916,1700,1770,3470,0,4000,4000,1246,423,1669,1434,458,1892,1402,12,46,0,0,2,21,390,471
2,22/08/2022,0213-Anna Nagar East,100236,113287,600,1880,31062,0,0,133778,3440,3385,6825,0,3000,3000,3100,1132,4232,3283,915,4198,3285,21,183,0,0,5,77,1056,1342
2,22/08/2022,0215-Anna Nagar Tower,100900,105239,500,1368,29106,0,0,131874,4355,3895,8250,0,0,0,2675,1016,3691,2957,911,3868,2938,35,144,0,0,2,53,947,1181
2,22/08/2022,0217-Thirumangalam,270378,296945,3700,5272,82554,0,0,361904,66975,23340,90315,0,1500,1500,7760,2744,10504,8285,2409,10694,8125,57,401,5,0,3,187,2519,3172
2,22/08/2022,0219-Koyambedu,205505,247538,800,4656,87856,0,0,298817,16205,12470,28675,0,18000,18000,6246,2960,9206,5361,2095,7456,5795,65,879,5,0,19,177,2756,3901
2,22/08/2022,0221-Puratchi Thalaivi Dr. J. Jayalalithaa CMBT,74107,201059,0,4072,111024,0,0,189203,0,0,0,0,0,0,3019,3609,6628,3547,3533,7080,3466,44,654,2,0,5,175,3419,4299
2,22/08/2022,0223-Arumbakkam,61574,59659,0,1768,22450,0,0,85792,1985,685,2670,0,4500,4500,1498,835,2333,1682,624,2306,1542,49,0,0,0,8,41,777,875
2,22/08/2022,0225-Vadapalani,125755,207902,300,4680,76970,0,0,207705,22110,5010,27120,0,4000,4000,4552,2630,7182,5062,2417,7479,4973,45,502,3,0,10,183,2433,3176
2,22/08/2022,0227-Ashok Nagar,90622,142527,250,3064,48448,0,0,142384,11280,6290,17570,0,3000,3000,3382,1617,4999,3570,1516,5086,3619,24,359,0,0,1,116,1478,1978
2,22/08/2022,0229-Ekkattuthangal,95852,122729,1110,1936,27516,0,0,126414,0,0,0,0,0,0,3326,981,4307,3843,1080,4923,3822,22,211,0,0,6,85,870,1194
2,22/08/2022,0231-Arignar Anna Alandur,187116,197793,800,3296,57574,0,0,248786,11595,8975,20570,0,8500,8500,5515,1924,7439,5013,1707,6720,5364,41,666,6,0,3,133,1743,2592
2,22/08/2022,0233-St. Thomas Mount,98932,101899,1500,4584,24322,0,0,129338,2620,3310,5930,0,4875,4875,2783,866,3649,2734,949,3683,2946,29,365,1,0,4,108,736,1243
1,23/08/2022,01ED-Wimco Nagar Depot Metro,81031,66805,0,848,20676,0,0,102555,60,410,470,0,750,750,1810,538,2348,1523,346,1869,1464,15,1,3,0,2,25,511,557
1,23/08/2022,01EF-Wimco Nagar Metro,115622,129593,410,2808,27710,0,0,146550,12335,6720,19055,0,0,0,3337,773,4110,3221,754,3975,3191,87,54,3,0,5,82,686,917
1,23/08/2022,01F1-Thiruvotriyur Metro,115472,99278,0,1320,17328,0,0,134120,970,1330,2300,0,0,0,2826,507,3333,2758,460,3218,2720,51,0,0,0,4,39,463,557
1,23/08/2022,01F3-Thiruvotriyur Theradi Metro,102191,112915,0,1464,24850,0,0,128505,1125,2695,3820,0,0,0,2729,706,3435,3031,773,3804,3001,37,92,5,0,4,48,642,828
1,23/08/2022,01F5-Kaladipet Metro,103493,98444,0,2160,23676,0,0,129329,730,3010,3740,0,0,0,2917,732,3649,2950,567,3517,2796,28,0,0,0,4,34,701,767
1,23/08/2022,01F7-Tollgate Metro,63209,56531,100,672,13956,0,0,77937,445,205,650,0,0,0,1594,444,2038,1614,357,1971,1566,27,0,0,0,3,26,413,469
1,23/08/2022,01F9-New Washermenpet Metro,101522,89949,1000,872,20960,0,0,124354,1405,1660,3065,0,1000,1000,2809,712,3521,2785,630,3415,2737,18,46,2,0,1,30,684,781
1,23/08/2022,01FB-Tondiarpet Metro,89145,99962,600,760,27136,0,0,117641,2690,3400,6090,0,1250,1250,2673,879,3552,2963,749,3712,2859,33,2,4,0,3,32,841,915
1,23/08/2022,01FD-Thiagaraya College Metro,107920,114162,100,2968,24484,0,0,135472,6955,2955,9910,0,250,250,3621,913,4534,3618,849,4467,3629,81,44,0,0,6,68,797,996
1,23/08/2022,0101-Washermanpet,103652,116622,1900,1496,35194,0,0,142242,6530,4470,11000,0,9250,9250,3566,1204,4770,3276,1126,4402,3330,31,138,1,0,2,57,1134,1363
1,23/08/2022,0103-Mannadi,84163,109532,800,2128,29396,0,0,116487,6455,6755,13210,0,3000,3000,3138,1017,4155,3350,1078,4428,3364,25,118,2,0,0,61,950,1156
1,23/08/2022,0105-High Court,134150,246270,1600,2360,71756,0,0,209866,845,2055,2900,0,0,0,6925,2414,9339,6957,1965,8922,7134,44,320,0,0,1,102,2343,2810
1,23/08/2022,0109-Government Estate,99785,142956,300,2072,40614,0,0,142771,3400,3010,6410,0,1500,1500,3950,1478,5428,4354,1438,5792,4512,28,372,3,0,5,82,1361,1851
1,23/08/2022,0111-LIC,85057,173020,1900,3120,32014,0,0,122091,1620,880,2500,0,0,0,4951,1141,6092,5737,975,6712,5665,28,0,0,0,5,84,1026,1143
1,23/08/2022,0113-Thousand Lights,128719,238820,1100,3800,45250,0,0,178869,625,600,1225,0,0,0,6882,1653,8535,7942,1338,9280,7795,29,2,0,0,3,172,1444,1650
1,23/08/2022,0115-AG-DMS,107982,141764,200,2432,22326,0,0,132940,0,0,0,0,1250,1250,4647,803,5450,4540,758,5298,4715,21,218,0,0,0,87,690,1016
1,23/08/2022,0117-Teynampet,83597,144725,1050,1880,27084,0,0,113611,0,0,0,0,0,0,4522,1012,5534,4982,874,5856,4882,26,0,2,0,4,78,911,1021
1,23/08/2022,0119-Nandanam,86036,116135,1200,2192,25978,0,0,115406,2785,5885,8670,0,0,0,3500,996,4496,3970,810,4780,3885,51,0,3,0,4,81,864,1003
1,23/08/2022,0121-Saidapet,44775,78372,200,984,22386,0,0,68345,1600,1390,2990,0,1500,1500,1922,772,2694,2376,661,3037,2276,18,0,0,0,1,40,725,784
1,23/08/2022,0123-Little Mount,75007,85128,678,2080,19486,0,0,97251,8450,5165,13615,0,2250,2250,3054,729,3783,2569,532,3101,2661,17,149,2,0,2,83,621,874
1,23/08/2022,0125-Guindy,120079,236719,1900,4600,65900,0,0,192479,6250,5135,11385,0,0,0,7053,2311,9364,6771,1974,8745,6756,26,217,1,0,7,179,2040,2470
1,23/08/2022,0129-Nanganallur Road,45032,47270,0,624,9534,0,0,55190,1080,5765,6845,0,0,0,1344,306,1650,1482,302,1784,1436,11,0,1,0,3,18,276,309
1,23/08/2022,0131-Meenambakkam,121439,130815,0,3024,35708,0,0,160171,5285,13495,18780,0,0,0,3707,1032,4739,3143,856,3999,3228,29,209,5,0,2,71,954,1270
1,23/08/2022,0133-Chennai International Airport,197602,314608,2200,6992,105810,0,0,312604,9800,11910,21710,0,11750,11750,5980,2940,8920,5898,3304,9202,6602,56,1362,5,0,11,207,2698,4339
2,23/08/2022,0201-Puratchi Thalaivar Dr. M.G. Ramachandran Central,297132,422150,5120,11024,113140,0,0,426416,18345,2560,20905,0,6350,6350,13243,4167,17410,10250,6083,16333,12719,123,3356,5,0,12,386,3606,7488
2,23/08/2022,0203-Egmore,74744,120588,100,2296,49948,0,0,127088,14175,3210,17385,250,8000,8250,2568,1773,4341,2782,2070,4852,2817,21,627,4,0,3,99,1651,2405
2,23/08/2022,0205-Nehru Park,36797,44394,0,488,14212,0,0,51497,1600,2145,3745,0,0,0,1376,534,1910,1281,429,1710,1288,14,97,0,0,1,20,495,627
2,23/08/2022,0207-Kilpauk,36794,53047,0,600,15310,0,0,52704,350,225,575,0,0,0,1432,543,1975,1545,473,2018,1521,7,77,0,0,1,25,521,631
2,23/08/2022,0209-Pachaiyappas College,37549,51934,50,952,13896,0,0,52447,730,700,1430,0,2000,2000,1655,541,2196,1626,455,2081,1603,8,66,1,0,1,29,506,611
2,23/08/2022,0211-Shenoy Nagar,45225,47094,99,568,11640,0,0,57532,2570,1570,4140,0,2000,2000,1360,404,1764,1425,357,1782,1443,6,75,0,0,1,24,380,486
2,23/08/2022,0213-Anna Nagar East,90702,106492,50,1800,23918,0,0,116470,1495,4090,5585,0,3000,3000,3121,912,4033,3220,823,4043,3280,24,222,4,0,2,74,810,1136
2,23/08/2022,0215-Anna Nagar Tower,88865,101729,200,1400,22960,0,0,113425,3375,3745,7120,1000,1750,2750,2824,826,3650,3006,741,3747,3039,33,185,1,0,4,59,757,1039
2,23/08/2022,0217-Thirumangalam,237514,293205,100,5696,67952,0,0,311262,62965,22200,85165,0,1500,1500,8229,2332,10561,8190,2260,10450,8478,58,744,9,0,4,216,2083,3114
2,23/08/2022,0219-Koyambedu,183664,220157,700,3104,69918,0,0,257386,15830,14100,29930,0,6250,6250,5733,2354,8087,5345,1769,7114,5495,56,640,5,0,11,122,2206,3040
2,23/08/2022,0221-Puratchi Thalaivi Dr. J. Jayalalithaa CMBT,74586,159166,600,2728,65660,0,0,143574,0,0,0,0,0,0,2876,2152,5028,3440,2871,6311,3525,50,885,3,0,2,108,2029,3077
2,23/08/2022,0223-Arumbakkam,51179,57998,500,1352,20098,0,0,73129,2105,445,2550,0,3250,3250,1531,743,2274,1682,589,2271,1553,41,39,1,0,5,52,681,819
2,23/08/2022,0225-Vadapalani,126948,202885,800,6256,62116,0,0,196120,21250,4520,25770,0,3000,3000,5018,2160,7178,5000,2229,7229,5368,42,836,8,0,3,198,1911,2998
2,23/08/2022,0227-Ashok Nagar,113047,127515,2586,2416,32544,0,0,150593,8045,6325,14370,0,9000,9000,3555,1113,4668,3484,1074,4558,3642,42,422,3,0,1,99,984,1551
2,23/08/2022,0229-Ekkattuthangal,85263,128526,670,2536,27336,0,0,115805,0,0,0,0,0,0,3801,990,4791,3903,871,4774,4041,30,321,0,0,3,100,859,1313
2,23/08/2022,0231-Arignar Anna Alandur,168040,191039,598,3464,50288,0,0,222390,8085,8325,16410,0,5500,5500,5479,1691,7170,5112,1526,6638,5427,62,569,3,0,8,134,1498,2274
2,23/08/2022,0233-St. Thomas Mount,78424,98723,0,2880,27746,0,0,109050,1950,3345,5295,0,2750,2750,2742,955,3697,2730,769,3499,2747,33,197,0,0,2,95,838,1165
1,24/08/2022,01ED-Wimco Nagar Depot Metro,72499,72275,0,960,23452,0,0,96911,150,265,415,0,1750,1750,1931,606,2537,1581,421,2002,1545,18,0,2,0,5,29,577,631
1,24/08/2022,01EF-Wimco Nagar Metro,122149,133047,160,2432,28084,0,0,152825,7510,5770,13280,0,3000,3000,3421,762,4183,3270,902,4172,3288,102,55,3,0,14,73,689,936
1,24/08/2022,01F1-Thiruvotriyur Metro,117318,108762,0,1416,24630,0,0,143364,820,1670,2490,0,0,0,2929,686,3615,2820,545,3365,2780,56,0,3,0,7,40,646,752
1,24/08/2022,01F3-Thiruvotriyur Theradi Metro,103582,114396,0,1504,25190,0,0,130276,1240,3095,4335,0,0,0,2806,730,3536,3014,861,3875,3032,32,74,4,0,7,49,683,849
1,24/08/2022,01F5-Kaladipet Metro,106547,101890,0,1224,24970,0,0,132741,1045,2615,3660,0,0,0,2966,806,3772,2921,784,3705,2871,32,0,1,0,12,38,747,830
1,24/08/2022,01F7-Tollgate Metro,51250,53039,0,520,13958,0,0,65728,25,225,250,0,0,0,1481,432,1913,1498,385,1883,1445,27,0,0,0,2,18,394,441
1,24/08/2022,01F9-New Washermenpet Metro,82892,95911,0,720,25098,0,0,108710,1270,2035,3305,0,0,0,2807,832,3639,2874,692,3566,2827,22,50,2,0,4,27,802,907
1,24/08/2022,01FB-Tondiarpet Metro,83215,99079,1500,1104,26388,0,0,112207,1900,4495,6395,0,1000,1000,2761,862,3623,2894,737,3631,2850,22,7,1,0,2,38,819,889
1,24/08/2022,01FD-Thiagaraya College Metro,120171,119573,150,1648,31788,0,0,153757,3035,3020,6055,0,2000,2000,3622,1061,4683,3548,929,4477,3560,79,39,0,0,3,55,1002,1178
1,24/08/2022,0101-Washermanpet,98392,117538,800,2008,38336,0,0,139536,7090,4010,11100,0,3000,3000,3487,1300,4787,3157,1156,4313,3201,25,112,1,0,7,64,1233,1442
1,24/08/2022,0103-Mannadi,90298,110417,3500,1056,16872,0,0,111726,14525,12205,26730,0,0,0,3510,589,4099,3225,1109,4334,3793,33,614,4,0,6,41,532,1230
1,24/08/2022,0105-High Court,149922,232217,1000,2624,67614,0,0,221160,1650,1590,3240,0,0,0,6714,2368,9082,6559,1832,8391,6729,38,234,0,0,2,107,2247,2628
1,24/08/2022,0109-Government Estate,88205,141206,1000,1872,43164,0,0,134241,3110,2650,5760,0,2250,2250,3763,1538,5301,4177,1477,5654,4321,22,227,1,0,4,85,1426,1765
1,24/08/2022,0111-LIC,80075,175143,2150,2744,34450,0,0,119419,790,1280,2070,0,2250,2250,4866,1239,6105,5645,1031,6676,5651,26,1,0,0,4,88,1104,1223
1,24/08/2022,0113-Thousand Lights,122631,228679,2450,3440,42242,0,0,170763,800,535,1335,0,0,0,6675,1537,8212,7588,1438,9026,7483,37,0,2,0,8,149,1331,1527
1,24/08/2022,0115-AG-DMS,113560,149666,1850,1840,27970,0,0,145220,0,0,0,0,1500,1500,4683,973,5656,4647,776,5423,4770,25,170,0,1,1,75,869,1141
1,24/08/2022,0117-Teynampet,82627,149004,2700,2072,30960,0,0,118359,0,0,0,0,0,0,4442,1150,5592,4921,1034,5955,4884,29,3,1,0,3,84,1045,1165
1,24/08/2022,0119-Nandanam,81273,119874,310,2416,28390,0,0,112389,1650,5080,6730,0,3000,3000,3490,1072,4562,3971,950,4921,3928,37,0,0,0,4,82,960,1083
1,24/08/2022,0121-Saidapet,53781,83748,410,960,25090,0,0,80241,1655,3145,4800,0,5000,5000,2017,851,2868,2432,769,3201,2375,16,9,0,0,4,43,801,873
1,24/08/2022,0123-Little Mount,83200,94011,670,1720,24144,0,0,109734,4530,7110,11640,0,0,0,3150,882,4032,2723,695,3418,2797,21,129,1,0,7,70,781,1009
1,24/08/2022,0125-Guindy,127955,252314,500,7040,72506,0,0,208001,5055,5300,10355,0,0,0,7336,2569,9905,6942,2212,9154,7097,41,260,3,0,9,228,2243,2784
1,24/08/2022,0129-Nanganallur Road,55810,48355,300,368,10124,0,0,66602,1000,5970,6970,0,0,0,1369,323,1692,1511,316,1827,1459,17,0,1,0,1,15,301,335
1,24/08/2022,0131-Meenambakkam,125413,128052,1400,1920,37108,0,0,165841,6770,16310,23080,0,0,0,3678,1079,4757,2934,926,3860,3092,27,207,3,0,3,66,999,1305
1,24/08/2022,0133-Chennai International Airport,165592,314322,668,7800,132406,0,0,306466,10310,12520,22830,0,6000,6000,5302,3733,9035,5791,3550,9341,5898,49,596,7,1,18,236,3350,4257
2,24/08/2022,0201-Puratchi Thalaivar Dr. M.G. Ramachandran Central,267942,429919,721,8656,142404,0,0,419723,15415,2065,17480,0,10250,10250,12374,5098,17472,9854,6753,16607,11928,147,2543,3,0,29,362,4618,7702
2,24/08/2022,0203-Egmore,76070,128627,340,2064,66590,0,0,145064,8025,3480,11505,0,17250,17250,2261,2355,4616,2641,2329,4970,2537,14,258,13,0,16,90,2249,2640
2,24/08/2022,0205-Nehru Park,35239,45647,150,848,15298,0,0,51535,2085,2105,4190,0,250,250,1314,574,1888,1282,420,1702,1282,11,48,0,0,1,36,526,622
2,24/08/2022,0207-Kilpauk,37240,56948,200,880,16722,0,0,55042,310,275,585,0,0,0,1498,601,2099,1551,567,2118,1597,11,98,2,0,2,27,567,707
2,24/08/2022,0209-Pachaiyappas College,42905,54404,0,808,16632,0,0,60345,610,1260,1870,0,4500,4500,1636,633,2269,1575,530,2105,1609,12,106,3,0,1,35,596,753
2,24/08/2022,0211-Shenoy Nagar,37835,45058,1500,640,11420,0,0,51395,1320,1400,2720,0,0,0,1272,406,1678,1369,401,1770,1373,8,47,0,0,2,27,378,462
2,24/08/2022,0213-Anna Nagar East,95302,109098,314,1976,28664,0,0,126256,900,3775,4675,0,6000,6000,3051,1040,4091,3123,880,4003,3159,19,148,0,0,6,70,960,1203
2,24/08/2022,0215-Anna Nagar Tower,81713,104299,400,1760,24784,0,0,108657,1975,3155,5130,0,500,500,2888,885,3773,2980,835,3815,3067,30,186,0,0,2,63,805,1086
2,24/08/2022,0217-Thirumangalam,232970,303900,3100,6384,83700,0,0,326154,61270,19385,80655,0,1500,1500,8016,2832,10848,8058,2544,10602,8256,58,459,2,0,2,216,2574,3311
2,24/08/2022,0219-Koyambedu,182139,222000,2748,3120,75490,0,0,263497,9420,15660,25080,0,7000,7000,5590,2549,8139,5162,2094,7256,5371,61,532,2,0,9,123,2410,3137
2,24/08/2022,0221-Puratchi Thalaivi Dr. J. Jayalalithaa CMBT,67418,150725,0,1856,72914,0,0,142188,0,0,0,0,0,0,2266,2384,4650,3217,3308,6525,3049,26,326,8,0,7,79,2290,2736
2,24/08/2022,0223-Arumbakkam,56082,57641,0,800,19530,0,0,76412,780,400,1180,0,6500,6500,1578,716,2294,1658,679,2337,1596,46,47,2,0,9,36,675,815
2,24/08/2022,0225-Vadapalani,128459,204651,2350,4568,72990,0,0,208367,21600,5100,26700,0,3500,3500,4771,2551,7322,4891,2399,7290,5075,46,588,5,0,10,182,2285,3116
2,24/08/2022,0227-Ashok Nagar,86590,132540,1600,2360,43638,0,0,134188,6600,6740,13340,0,12000,12000,3446,1461,4907,3380,1332,4712,3453,27,293,0,0,0,71,1348,1739
2,24/08/2022,0229-Ekkattuthangal,84762,131581,1204,2272,29232,0,0,117470,0,0,0,0,0,0,3825,1067,4892,3935,935,4870,4094,17,254,2,0,4,92,947,1316
2,24/08/2022,0231-Arignar Anna Alandur,144298,189993,50,3416,58906,0,0,206670,8175,6085,14260,0,4750,4750,5234,1920,7154,4892,1724,6616,5119,39,346,4,0,1,125,1749,2264
2,24/08/2022,0233-St. Thomas Mount,84218,97875,0,3648,26814,0,0,114680,4035,3455,7490,0,9750,9750,2709,928,3637,2604,934,3538,2713,23,199,1,0,0,87,811,1121
1,25/08/2022,01ED-Wimco Nagar Depot Metro,78268,69095,0,1184,21016,0,0,100468,170,335,505,0,1000,1000,1921,556,2477,1527,356,1883,1518,20,0,3,0,11,30,514,578
1,25/08/2022,01EF-Wimco Nagar Metro,122228,133206,1250,2400,30048,0,0,155926,10930,7165,18095,0,2250,2250,3410,817,4227,3263,849,4112,3250,77,46,4,0,5,69,741,942
1,25/08/2022,01F1-Thiruvotriyur Metro,112309,100175,100,1152,18910,0,0,132471,700,1395,2095,0,0,0,2839,544,3383,2737,474,3211,2718,44,0,0,0,5,34,510,593
1,25/08/2022,01F3-Thiruvotriyur Theradi Metro,103010,114693,1300,1584,23830,0,0,129724,1355,2860,4215,0,0,0,2846,686,3532,3037,752,3789,3070,39,82,1,0,3,48,634,807
1,25/08/2022,01F5-Kaladipet Metro,99677,99750,0,1152,24028,0,0,124857,780,2420,3200,0,0,0,2945,763,3708,2839,645,3484,2836,34,0,1,0,9,40,710,794
1,25/08/2022,01F7-Tollgate Metro,56184,53819,0,632,11450,0,0,68266,25,170,195,0,0,0,1581,378,1959,1561,328,1889,1534,28,0,0,0,2,22,348,400
1,25/08/2022,01F9-New Washermenpet Metro,91912,90438,150,688,17600,0,0,110350,1245,1960,3205,0,250,250,2863,607,3470,2818,565,3383,2891,21,112,3,0,0,28,580,744
1,25/08/2022,01FB-Tondiarpet Metro,87494,94013,200,1296,23280,0,0,112270,3975,3450,7425,0,500,500,2692,775,3467,2832,760,3592,2789,26,0,1,1,2,45,723,798
1,25/08/2022,01FD-Thiagaraya College Metro,109260,111305,0,1864,24282,0,0,135406,6645,3420,10065,0,2250,2250,3624,887,4511,3581,793,4374,3577,65,15,1,0,1,64,820,966
1,25/08/2022,0101-Washermanpet,102049,118212,550,1968,36222,0,0,140789,5985,8010,13995,0,16000,16000,3583,1254,4837,3290,1137,4427,3381,11,107,1,0,8,77,1167,1371
1,25/08/2022,0103-Mannadi,82899,115751,850,1392,34170,0,0,119311,9145,8710,17855,0,500,500,3116,1153,4269,3399,1098,4497,3412,20,72,2,0,6,48,1102,1250
1,25/08/2022,0105-High Court,131095,230616,100,1864,65288,0,0,198347,765,1980,2745,0,0,0,6532,2269,8801,6720,1760,8480,6790,22,146,2,0,5,84,2148,2407
1,25/08/2022,0109-Government Estate,82118,140098,600,2008,43222,0,0,127948,3975,2790,6765,0,750,750,3795,1557,5352,4108,1439,5547,4279,20,235,0,0,3,81,1447,1786
1,25/08/2022,0111-LIC,84050,174243,900,2136,32208,0,0,119294,1210,500,1710,0,0,0,4972,1164,6136,5691,983,6674,5691,26,53,0,0,3,90,1039,1211
1,25/08/2022,0113-Thousand Lights,127530,235837,2750,5464,40836,0,0,176580,470,430,900,0,250,250,7026,1531,8557,7861,1324,9185,7851,50,0,1,0,6,201,1343,1601
1,25/08/2022,0115-AG-DMS,95066,145143,200,1744,25382,0,0,122392,0,0,0,0,1500,1500,4700,891,5591,4632,741,5373,4732,15,134,0,0,1,70,802,1022
1,25/08/2022,0117-Teynampet,84606,149597,1200,1624,31884,0,0,119314,0,0,0,0,500,500,4532,1177,5709,4970,961,5931,4902,20,0,3,0,8,67,1082,1180
1,25/08/2022,0119-Nandanam,89461,119576,1770,2456,28442,0,0,122129,2330,4785,7115,0,2250,2250,3526,1091,4617,3951,923,4874,3901,31,0,0,0,1,86,964,1082
1,25/08/2022,0121-Saidapet,50086,77688,620,1320,21634,0,0,73660,1575,2190,3765,0,3250,3250,1941,782,2723,2299,679,2978,2262,14,0,0,0,1,55,724,794
1,25/08/2022,0123-Little Mount,79430,87758,1100,1768,22826,0,0,105124,4185,6465,10650,0,750,750,3076,861,3937,2554,618,3172,2621,9,86,0,0,0,70,755,920
1,25/08/2022,0125-Guindy,113794,243409,600,5368,67784,0,0,187546,5645,5695,11340,0,0,0,7203,2398,9601,6775,2063,8838,6967,32,313,3,0,6,199,2109,2662
1,25/08/2022,0129-Nanganallur Road,49010,48548,500,1000,11756,0,0,62266,915,6120,7035,0,0,0,1354,360,1714,1453,304,1757,1413,6,2,0,0,0,14,339,361
1,25/08/2022,0131-Meenambakkam,116541,118326,1300,1928,28318,0,0,148087,4000,13115,17115,0,0,0,3635,865,4500,2973,689,3662,3085,25,155,2,0,1,63,773,1019
1,25/08/2022,0133-Chennai International Airport,162624,318089,900,8696,132344,0,0,304564,8165,10630,18795,0,10000,10000,5456,3688,9144,5870,3480,9350,6032,50,597,13,0,25,251,3362,4298
2,25/08/2022,0201-Puratchi Thalaivar Dr. M.G. Ramachandran Central,265457,424833,2492,9952,118658,0,0,396559,15480,2215,17695,0,3800,3800,12859,4286,17145,9995,6789,16784,12609,122,3037,6,0,12,365,3809,7351
2,25/08/2022,0203-Egmore,63327,112508,556,2224,54642,0,0,120749,11435,3870,15305,0,14750,14750,2056,1896,3952,2482,2416,4898,2409,22,229,6,0,5,88,1792,2142
2,25/08/2022,0205-Nehru Park,41885,45688,100,1008,15488,0,0,58481,2985,1995,4980,0,0,0,1363,549,1912,1284,418,1702,1308,9,75,0,0,3,29,540,656
2,25/08/2022,0207-Kilpauk,34059,54950,600,824,16432,0,0,51915,460,300,760,0,250,250,1481,616,2097,1529,528,2057,1552,16,78,0,0,1,36,570,701
2,25/08/2022,0209-Pachaiyappas College,45877,52131,0,408,14768,0,0,61053,1260,830,2090,0,2000,2000,1720,546,2266,1588,525,2113,1588,14,59,1,0,3,18,518,613
2,25/08/2022,0211-Shenoy Nagar,40713,43712,500,696,10818,0,0,52727,1300,1650,2950,0,2000,2000,1259,391,1650,1366,393,1759,1354,14,42,0,0,0,24,360,440
2,25/08/2022,0213-Anna Nagar East,78076,105114,1500,1744,25832,0,0,107152,750,3470,4220,0,0,0,3019,948,3967,3099,838,3937,3162,18,129,6,0,3,55,866,1077
2,25/08/2022,0215-Anna Nagar Tower,81349,101327,500,1648,24270,0,0,107767,4145,8555,12700,0,0,0,2829,886,3715,2921,791,3712,2961,14,171,0,0,4,60,814,1063
2,25/08/2022,0217-Thirumangalam,251289,298403,1500,5888,80504,0,0,339181,54310,21000,75310,0,0,0,7948,2702,10650,8019,2357,10376,8191,65,441,3,0,5,201,2464,3179
2,25/08/2022,0219-Koyambedu,176753,221311,700,4312,77356,0,0,259121,8935,10005,18940,0,10500,10500,5598,2632,8230,5204,1999,7203,5313,44,393,8,0,8,149,2466,3068
2,25/08/2022,0221-Puratchi Thalaivi Dr. J. Jayalalithaa CMBT,55533,143925,249,1744,69862,0,0,127388,0,0,0,0,0,0,2155,2321,4476,3153,3323,6476,2932,48,255,10,0,5,74,2243,2635
2,25/08/2022,0223-Arumbakkam,53706,58761,0,1760,20702,0,0,76168,895,800,1695,0,6250,6250,1532,734,2266,1628,604,2232,1565,37,1,1,0,4,61,667,771
2,25/08/2022,0225-Vadapalani,123462,199499,1580,4400,71148,0,0,200590,20830,4630,25460,0,5000,5000,4608,2452,7060,4812,2280,7092,4952,39,453,1,0,12,173,2214,2892
2,25/08/2022,0227-Ashok Nagar,95293,131171,1750,2480,38900,0,0,138423,5785,6785,12570,0,6000,6000,3502,1361,4863,3344,1319,4663,3547,22,348,1,0,0,95,1218,1684
2,25/08/2022,0229-Ekkattuthangal,81916,126789,350,3152,30306,0,0,115724,0,0,0,0,0,0,3658,1132,4790,3775,913,4688,3905,22,221,0,0,1,114,969,1327
2,25/08/2022,0231-Arignar Anna Alandur,140929,188294,400,3248,53516,0,0,198093,8535,10835,19370,0,2750,2750,5249,1775,7024,5011,1617,6628,5232,42,370,3,0,5,116,1598,2134
2,25/08/2022,0233-St. Thomas Mount,80495,99198,520,2984,28940,0,0,112939,1470,2645,4115,0,5000,5000,2727,976,3703,2636,845,3481,2710,22,135,1,0,4,97,855,1114
1,26/08/2022,01ED-Wimco Nagar Depot Metro,70756,69922,0,1312,21946,0,0,94014,75,320,395,0,1000,1000,1897,580,2477,1543,331,1874,1531,29,0,9,0,3,38,535,614
1,26/08/2022,01EF-Wimco Nagar Metro,110001,135638,100,2936,33116,0,0,146153,8640,5440,14080,0,1250,1250,3427,868,4295,3194,901,4095,3205,40,58,4,0,11,73,789,975
1,26/08/2022,01F1-Thiruvotriyur Metro,105431,99673,0,1872,19410,0,0,126713,1030,1360,2390,0,0,0,2869,567,3436,2695,437,3132,2667,59,0,1,0,2,50,518,630
1,26/08/2022,01F3-Thiruvotriyur Theradi Metro,85824,113285,500,1392,25770,0,0,113486,610,2680,3290,0,0,0,2847,747,3594,2971,839,3810,2990,20,92,2,0,8,47,678,847
1,26/08/2022,01F5-Kaladipet Metro,90136,96123,0,872,22868,0,0,113876,880,2250,3130,0,0,0,2928,717,3645,2826,621,3447,2752,25,0,1,0,4,31,681,742
1,26/08/2022,01F7-Tollgate Metro,52325,54274,0,560,13592,0,0,66477,115,1640,1755,0,0,0,1545,416,1961,1533,350,1883,1485,23,0,1,0,3,19,395,441
1,26/08/2022,01F9-New Washermenpet Metro,91948,92389,200,712,23778,0,0,116638,1100,2340,3440,0,1250,1250,2826,795,3621,2790,642,3432,2747,21,32,0,0,1,27,762,843
1,26/08/2022,01FB-Tondiarpet Metro,81331,94260,700,1032,24394,0,0,107457,2865,3540,6405,0,500,500,2666,813,3479,2787,595,3382,2750,13,1,0,0,5,41,761,821
1,26/08/2022,01FD-Thiagaraya College Metro,98874,114736,750,1608,26404,0,0,127636,4065,5610,9675,0,0,0,3662,941,4603,3617,799,4416,3606,37,37,1,0,2,57,883,1017
1,26/08/2022,0101-Washermanpet,93668,115299,700,2304,39508,0,0,136180,5720,3555,9275,0,4500,4500,3386,1389,4775,3112,1146,4258,3121,19,84,1,0,6,66,1311,1487
1,26/08/2022,0103-Mannadi,78870,113285,200,1360,31724,0,0,112154,8070,9150,17220,0,1500,1500,3160,1114,4274,3479,995,4474,3434,12,102,1,0,6,52,1052,1225
1,26/08/2022,0105-High Court,115781,227052,500,2416,62260,0,0,180957,1635,1350,2985,0,0,0,6417,2273,8690,6650,1743,8393,6749,42,174,0,0,4,97,2134,2451
1,26/08/2022,0109-Government Estate,80773,144080,1910,1496,44610,0,0,128789,3610,3080,6690,0,5250,5250,3953,1593,5546,4195,1452,5647,4429,18,404,0,0,16,72,1477,1987
1,26/08/2022,0111-LIC,72886,171386,2114,2280,32664,0,0,109944,875,910,1785,0,0,0,4935,1181,6116,5629,962,6591,5575,24,1,0,0,2,96,1051,1174
1,26/08/2022,0113-Thousand Lights,118956,240981,920,4640,47960,0,0,172476,530,370,900,0,0,0,7036,1734,8770,7843,1504,9347,7768,32,0,1,0,7,196,1538,1774
1,26/08/2022,0115-AG-DMS,90286,146348,0,1808,26076,0,0,118170,0,0,0,0,1250,1250,4621,915,5536,4604,757,5361,4722,21,159,0,0,3,76,812,1071
1,26/08/2022,0117-Teynampet,85482,145375,668,1832,29778,0,0,117760,0,0,0,0,2000,2000,4421,1119,5540,4861,896,5757,4804,22,0,0,0,4,83,1004,1113
1,26/08/2022,0119-Nandanam,83212,131728,1120,2848,36772,0,0,123952,2070,4585,6655,0,2000,2000,3641,1372,5013,4094,1006,5100,4053,38,0,0,0,13,120,1212,1383
1,26/08/2022,0121-Saidapet,41127,77500,525,1248,22732,0,0,65632,2810,1280,4090,0,2500,2500,1966,817,2783,2246,679,2925,2206,13,0,3,0,2,47,761,826
1,26/08/2022,0123-Little Mount,62698,92398,250,2232,25378,0,0,90558,2580,5150,7730,0,0,0,3202,945,4147,2599,639,3238,2702,14,165,1,0,3,83,820,1086
1,26/08/2022,0125-Guindy,118963,255052,1250,6880,80228,0,0,207321,5555,5240,10795,0,0,0,7295,2878,10173,6630,2064,8694,6939,31,357,3,0,7,253,2494,3145
1,26/08/2022,0129-Nanganallur Road,31201,47462,1100,640,11414,0,0,44355,965,5485,6450,0,0,0,1334,355,1689,1461,307,1768,1390,8,0,0,0,0,16,327,351
1,26/08/2022,0131-Meenambakkam,121285,121500,228,1792,32550,0,0,155855,4865,12875,17740,0,0,0,3573,957,4530,2827,777,3604,3003,21,227,2,0,3,58,880,1191
1,26/08/2022,0133-Chennai International Airport,188649,317136,3950,11104,117026,0,0,320729,7350,14070,21420,0,6750,6750,5937,3300,9237,5764,3459,9223,6331,46,1090,11,0,14,240,2968,4369
2,26/08/2022,0201-Puratchi Thalaivar Dr. M.G. Ramachandran Central,278781,456213,2300,9392,115186,0,0,405659,15640,2170,17810,0,5600,5600,13206,4234,17440,11405,7590,18995,13930,93,3538,5,0,19,383,3721,7759
2,26/08/2022,0203-Egmore,67638,125370,530,2640,53496,0,0,124304,8225,5595,13820,0,12750,12750,2325,1913,4238,2958,2596,5554,2944,24,423,9,0,15,108,1769,2348
2,26/08/2022,0205-Nehru Park,36067,46333,100,744,15286,0,0,52197,2945,3225,6170,2000,2750,4750,1352,557,1909,1255,467,1722,1321,7,104,0,0,2,33,519,665
2,26/08/2022,0207-Kilpauk,36619,55777,200,440,16510,0,0,53769,435,160,595,0,250,250,1591,576,2167,1576,488,2064,1588,12,116,0,0,3,19,551,701
2,26/08/2022,0209-Pachaiyappas College,39607,55466,0,816,16000,0,0,56423,980,720,1700,0,2500,2500,1815,639,2454,1663,528,2191,1679,15,77,1,0,9,40,589,731
2,26/08/2022,0211-Shenoy Nagar,35416,44800,0,408,12340,0,0,48164,1760,1480,3240,0,2000,2000,1259,431,1690,1332,418,1750,1319,10,62,0,0,1,18,403,494
2,26/08/2022,0213-Anna Nagar East,74863,110068,200,2120,28428,0,0,105611,655,3370,4025,0,3000,3000,3121,1052,4173,3150,817,3967,3211,23,153,2,0,1,83,947,1209
2,26/08/2022,0215-Anna Nagar Tower,85148,103565,230,1536,25674,0,0,112588,1595,2745,4340,0,4000,4000,2886,924,3810,2935,782,3717,2971,29,225,0,0,4,62,841,1161
2,26/08/2022,0217-Thirumangalam,241097,305951,1560,7088,83814,0,0,333559,69175,18080,87255,0,0,0,8200,2907,11107,7974,2386,10360,8310,47,685,4,0,5,255,2601,3597
2,26/08/2022,0219-Koyambedu,155954,224796,770,3824,78740,0,0,239288,8800,14125,22925,0,10500,10500,5643,2704,8347,5404,1997,7401,5397,44,453,3,0,16,140,2519,3175
2,26/08/2022,0221-Puratchi Thalaivi Dr. J. Jayalalithaa CMBT,61638,173749,50,1832,70650,0,0,134170,0,0,0,0,0,0,2378,2291,4669,4758,4650,9408,3989,36,436,3,0,7,77,2180,2739
2,26/08/2022,0223-Arumbakkam,58160,58590,300,1160,22036,0,0,81656,1035,345,1380,0,6000,6000,1546,805,2351,1593,642,2235,1511,52,0,2,0,4,44,753,855
2,26/08/2022,0225-Vadapalani,114054,201696,0,4776,70732,0,0,189562,23460,5220,28680,0,4500,4500,4849,2514,7363,4755,2377,7132,5055,37,667,6,0,5,188,2265,3168
2,26/08/2022,0227-Ashok Nagar,91559,146241,1194,3472,43198,0,0,139423,7110,6305,13415,0,0,0,3996,1554,5550,3530,1247,4777,3961,32,636,1,0,1,124,1377,2171
2,26/08/2022,0229-Ekkattuthangal,74992,133955,890,2440,37552,0,0,115874,0,0,0,0,500,500,3799,1309,5108,3650,858,4508,3857,19,328,0,0,9,100,1164,1620
2,26/08/2022,0231-Arignar Anna Alandur,137825,197344,970,4176,62748,0,0,205719,5570,8845,14415,0,2250,2250,5314,2111,7425,4924,1592,6516,5175,49,468,6,0,10,158,1886,2577
2,26/08/2022,0233-St. Thomas Mount,74143,105348,200,3088,31284,0,0,108715,1220,3105,4325,0,10625,10625,2850,1095,3945,2682,819,3501,2828,17,280,0,0,1,109,961,1368
1,27/08/2022,01ED-Wimco Nagar Depot Metro,69701,66274,700,1432,25810,0,0,97643,180,175,355,0,2000,2000,1576,672,2248,1325,462,1787,1287,12,0,1,0,6,41,625,685
1,27/08/2022,01EF-Wimco Nagar Metro,98126,125396,440,1992,39842,0,0,140400,7290,5590,12880,0,500,500,2805,1024,3829,2677,972,3649,2665,83,78,0,0,10,60,955,1186
1,27/08/2022,01F1-Thiruvotriyur Metro,91465,92500,0,2448,25614,0,0,119527,895,1385,2280,0,0,0,2391,731,3122,2282,629,2911,2223,57,0,0,0,7,70,662,796
1,27/08/2022,01F3-Thiruvotriyur Theradi Metro,91070,112963,30,2008,32956,0,0,126064,710,1850,2560,0,0,0,2543,937,3480,2691,968,3659,2710,30,110,2,0,16,58,853,1069
1,27/08/2022,01F5-Kaladipet Metro,81575,90379,0,1512,27338,0,0,110425,895,1730,2625,0,0,0,2500,821,3321,2407,687,3094,2347,29,0,0,0,6,51,771,857
1,27/08/2022,01F7-Tollgate Metro,44472,50657,100,664,15676,0,0,60912,190,315,505,0,0,0,1351,494,1845,1316,443,1759,1282,20,0,0,0,6,23,461,510
1,27/08/2022,01F9-New Washermenpet Metro,80413,87465,50,1536,26388,0,0,108387,970,1490,2460,0,1750,1750,2329,868,3197,2419,700,3119,2402,14,63,1,1,6,62,812,959
1,27/08/2022,01FB-Tondiarpet Metro,67579,89451,0,1376,30982,0,0,99937,12975,2020,14995,0,0,0,2355,986,3341,2384,828,3212,2308,29,0,2,0,9,51,919,1010
1,27/08/2022,01FD-Thiagaraya College Metro,94547,108872,100,2112,32142,0,0,128901,3840,2540,6380,0,0,0,3136,1095,4231,3093,1039,4132,3105,96,77,0,0,5,81,1001,1260
1,27/08/2022,0101-Washermanpet,89506,114797,100,2408,41892,0,0,133906,8345,4195,12540,0,9500,9500,3038,1421,4459,2686,1328,4014,2900,26,316,0,0,13,87,1312,1754
1,27/08/2022,0103-Mannadi,70805,103614,335,1968,33922,0,0,107030,20275,11435,31710,0,1500,1500,2687,1183,3870,2770,1290,4060,2896,18,231,2,0,7,72,1100,1430
1,27/08/2022,0105-High Court,85397,174534,100,4208,67724,0,0,157429,1275,2450,3725,0,0,0,4150,2370,6520,4125,1940,6065,4308,34,292,0,0,2,166,2154,2648
1,27/08/2022,0109-Government Estate,82532,147023,170,2472,54916,0,0,140090,2825,2410,5235,0,3500,3500,3538,1902,5440,3705,1774,5479,3938,29,431,1,0,12,101,1746,2320
1,27/08/2022,0111-LIC,45995,130556,320,1928,36120,0,0,84363,1655,1175,2830,0,0,0,3162,1246,4408,3847,916,4763,3763,16,2,1,0,4,70,1155,1248
1,27/08/2022,0113-Thousand Lights,78061,169851,200,4224,49922,0,0,132407,3190,575,3765,0,0,0,4217,1772,5989,4986,1460,6446,4840,32,0,1,0,7,165,1570,1775
1,27/08/2022,0115-AG-DMS,71876,105410,1200,2280,23462,0,0,98818,0,0,0,0,0,0,3122,817,3939,2967,684,3651,3175,14,252,1,0,2,91,703,1063
1,27/08/2022,0117-Teynampet,48797,103967,200,1312,31660,0,0,81969,0,0,0,0,0,0,2768,1105,3873,3024,893,3917,2915,22,1,2,0,9,52,1038,1124
1,27/08/2022,0119-Nandanam,53709,89232,700,2224,34358,0,0,90991,1360,2280,3640,0,0,0,2159,1220,3379,2413,923,3336,2295,30,0,0,0,6,87,1106,1229
1,27/08/2022,0121-Saidapet,34248,66438,190,2008,26346,0,0,62792,3245,850,4095,0,4000,4000,1374,894,2268,1660,689,2349,1570,12,0,2,0,1,51,836,902
1,27/08/2022,0123-Little Mount,48650,69548,400,2816,26462,0,0,78328,3460,3185,6645,0,0,0,1872,962,2834,1625,658,2283,1677,8,138,2,0,7,85,842,1082
1,27/08/2022,0125-Guindy,95468,214927,200,5544,87638,0,0,188850,5255,4075,9330,0,0,0,4892,2965,7857,4555,2590,7145,4846,37,555,3,0,15,213,2573,3396
1,27/08/2022,0129-Nanganallur Road,34746,40582,500,936,17074,0,0,53256,1380,2590,3970,0,0,0,795,528,1323,983,385,1368,866,10,0,0,0,1,29,493,533
1,27/08/2022,0131-Meenambakkam,97274,117614,360,3680,47618,0,0,148932,7810,10555,18365,0,0,0,2642,1371,4013,2171,1147,3318,2332,17,258,4,0,4,110,1265,1658
1,27/08/2022,0133-Chennai International Airport,153517,333321,2624,11776,163178,0,0,331095,12875,9695,22570,0,3750,3750,4809,4587,9396,4916,4216,9132,5329,71,1132,21,0,18,365,3945,5552
2,27/08/2022,0201-Puratchi Thalaivar Dr. M.G. Ramachandran Central,249154,445051,500,11064,155870,0,0,416588,19670,1485,21155,0,5850,5850,10955,5589,16544,8703,7855,16558,11296,92,3680,9,0,21,443,4930,9175
2,27/08/2022,0203-Egmore,56987,132651,300,2792,67588,0,0,127667,8315,2260,10575,0,4500,4500,2007,2386,4393,2858,2897,5755,2647,21,404,6,0,20,115,2231,2797
2,27/08/2022,0205-Nehru Park,26197,47371,0,1032,20012,0,0,47241,3825,750,4575,0,0,0,1179,750,1929,1120,607,1727,1144,11,131,0,0,3,45,700,890
2,27/08/2022,0207-Kilpauk,31199,47124,0,936,16626,0,0,48761,270,115,385,0,0,0,1219,598,1817,1204,553,1757,1225,21,78,1,0,0,42,546,688
2,27/08/2022,0209-Pachaiyappas College,45841,55897,0,824,20986,0,0,67651,1360,420,1780,0,4000,4000,1579,761,2340,1460,654,2114,1466,6,75,0,0,13,32,721,847
2,27/08/2022,0211-Shenoy Nagar,31606,42067,200,1064,12816,0,0,45686,800,850,1650,0,5000,5000,1077,480,1557,1160,470,1630,1186,7,91,0,0,1,39,435,573
2,27/08/2022,0213-Anna Nagar East,64439,105507,200,2736,36722,0,0,104097,1090,1585,2675,0,3000,3000,2630,1343,3973,2671,1120,3791,2713,16,175,3,0,5,104,1220,1523
2,27/08/2022,0215-Anna Nagar Tower,70372,96662,200,2256,35216,0,0,108044,3215,5010,8225,0,1250,1250,2224,1262,3486,2284,1063,3347,2368,16,266,0,0,3,87,1160,1532
2,27/08/2022,0217-Thirumangalam,181545,270279,250,7856,98726,0,0,288377,85740,11565,97305,0,3000,3000,6310,3408,9718,6079,2988,9067,6398,54,835,4,0,5,308,3053,4259
2,27/08/2022,0219-Koyambedu,143134,215057,400,5176,87330,0,0,236040,12310,5370,17680,2000,3750,5750,4805,3061,7866,4155,2520,6675,4732,35,1037,9,0,10,202,2808,4101
2,27/08/2022,0221-Puratchi Thalaivi Dr. J. Jayalalithaa CMBT,69277,172818,200,2808,75014,0,0,147299,0,0,0,0,0,0,2396,2507,4903,3979,5035,9014,3727,32,774,3,0,4,120,2355,3288
2,27/08/2022,0223-Arumbakkam,41610,48886,0,1176,21890,0,0,64676,900,270,1170,0,7500,7500,1218,851,2069,1261,663,1924,1119,61,3,0,0,5,51,780,900
2,27/08/2022,0225-Vadapalani,112920,239088,0,8560,100920,0,0,222400,32740,7590,40330,0,0,0,4813,3666,8479,4626,3461,8087,5247,46,1195,2,0,17,355,3123,4738
2,27/08/2022,0227-Ashok Nagar,72559,123906,700,3384,48464,0,0,125107,11350,4560,15910,0,3000,3000,2711,1717,4428,2845,1461,4306,2913,37,361,3,0,5,134,1529,2069
2,27/08/2022,0229-Ekkattuthangal,56071,86778,400,2712,33374,0,0,92557,0,0,0,0,1250,1250,2053,1204,3257,2037,882,2919,2162,14,264,0,0,1,116,1060,1455
2,27/08/2022,0231-Arignar Anna Alandur,120658,190814,0,5496,81184,0,0,207338,6660,10185,16845,0,1000,1000,4037,2688,6725,3940,2162,6102,4155,56,632,2,0,6,196,2367,3259
2,27/08/2022,0233-St. Thomas Mount,74815,104341,200,3424,38470,0,0,116909,1700,2745,4445,0,2500,2500,2406,1265,3671,2188,1221,3409,2421,38,476,5,0,0,110,1152,1781
1,28/08/2022,01ED-Wimco Nagar Depot Metro,41686,58258,0,1368,31192,0,0,74246,340,245,585,0,2250,2250,848,770,1618,900,440,1340,821,17,0,0,0,8,37,737,799
1,28/08/2022,01EF-Wimco Nagar Metro,57690,81399,0,1880,37972,0,0,97542,9265,2810,12075,0,0,0,1356,967,2323,1317,875,2192,1303,77,90,0,0,20,55,894,1136
1,28/08/2022,01F1-Thiruvotriyur Metro,61681,70396,0,2600,30712,0,0,94993,1480,880,2360,0,0,0,1360,837,2197,1331,750,2081,1283,100,0,0,0,15,74,756,945
1,28/08/2022,01F3-Thiruvotriyur Theradi Metro,59002,105127,0,2128,48344,0,0,109474,1140,1300,2440,0,0,0,1678,1292,2970,1806,1312,3118,1827,24,199,0,0,20,75,1219,1537
1,28/08/2022,01F5-Kaladipet Metro,49007,62154,0,1880,31226,0,0,82113,745,1240,1985,0,0,0,1121,944,2065,1214,793,2007,1117,19,0,0,0,3,56,881,959
1,28/08/2022,01F7-Tollgate Metro,29498,45285,0,544,23350,0,0,53392,205,75,280,0,0,0,759,657,1416,863,457,1320,764,45,3,0,0,14,19,629,710
1,28/08/2022,01F9-New Washermenpet Metro,46248,64240,0,1208,28802,0,0,76258,1350,970,2320,0,500,500,1351,886,2237,1282,819,2101,1324,14,114,0,0,9,42,821,1000
1,28/08/2022,01FB-Tondiarpet Metro,39704,67196,0,2056,32866,0,0,74626,3390,1695,5085,0,0,0,1218,997,2215,1327,914,2241,1254,17,0,1,0,23,69,928,1038
1,28/08/2022,01FD-Thiagaraya College Metro,71791,93602,0,2360,45974,0,0,120125,6595,3605,10200,0,0,0,1760,1408,3168,1788,1030,2818,1774,87,93,0,0,11,71,1309,1571
1,28/08/2022,0101-Washermanpet,63504,83327,0,1960,46240,0,0,111704,8025,3010,11035,0,16000,16000,1411,1491,2902,1401,1256,2657,1393,14,167,0,0,15,68,1411,1675
1,28/08/2022,0103-Mannadi,37827,64434,0,1272,38650,0,0,77749,23065,8490,31555,0,0,0,990,1279,2269,1123,1075,2198,1052,11,76,0,0,11,48,1223,1369
1,28/08/2022,0105-High Court,34359,73054,0,1488,36852,0,0,72699,3415,260,3675,0,0,0,1332,1285,2617,1353,1036,2389,1414,15,217,0,0,6,64,1214,1516
1,28/08/2022,0109-Government Estate,44441,84298,0,1424,39924,0,0,85789,2080,950,3030,0,0,0,1607,1358,2965,1561,1233,2794,1748,18,391,9,0,13,55,1273,1759
1,28/08/2022,0111-LIC,20733,49468,0,936,25176,0,0,46845,1210,250,1460,0,2000,2000,796,833,1629,1035,668,1703,935,14,2,0,0,7,39,778,840
1,28/08/2022,0113-Thousand Lights,33417,75264,0,1880,33956,0,0,69253,465,210,675,2000,0,2000,1342,1141,2483,1859,976,2835,1625,18,0,0,0,14,74,1031,1137
1,28/08/2022,0115-AG-DMS,18858,38804,0,608,18486,0,0,37952,0,0,0,0,250,250,768,595,1363,718,534,1252,762,12,147,0,0,1,28,550,738
1,28/08/2022,0117-Teynampet,20746,45920,0,1536,22944,0,0,45226,0,0,0,0,0,0,723,842,1565,1046,736,1782,902,9,0,0,0,10,64,758,841
1,28/08/2022,0119-Nandanam,22973,49873,0,824,29888,0,0,53685,2715,965,3680,0,0,0,759,1013,1772,926,758,1684,789,15,0,0,0,5,40,959,1019
1,28/08/2022,0121-Saidapet,19614,44989,0,864,25422,0,0,45900,1905,335,2240,0,4000,4000,691,818,1509,863,755,1618,738,12,2,3,0,6,34,780,837
1,28/08/2022,0123-Little Mount,30914,54675,0,1480,25722,0,0,58116,7495,2270,9765,0,0,0,1060,890,1950,1049,707,1756,1083,14,153,2,0,8,60,787,1024
1,28/08/2022,0125-Guindy,55425,148029,0,5856,81640,0,0,142921,5020,2255,7275,0,1500,1500,2157,2658,4815,2157,2282,4439,2374,23,546,1,0,8,202,2333,3113
1,28/08/2022,0129-Nanganallur Road,9462,24444,0,856,13648,0,0,23966,1685,1215,2900,0,0,0,330,429,759,470,367,837,393,11,0,2,0,1,31,392,437
1,28/08/2022,0131-Meenambakkam,51337,87150,0,2232,46386,0,0,99955,7790,5105,12895,0,0,0,1354,1221,2575,1130,1042,2172,1270,13,318,3,0,8,69,1185,1596
1,28/08/2022,0133-Chennai International Airport,111028,302392,0,10208,186482,0,0,307718,14470,5405,19875,0,750,750,3168,5074,8242,3516,4254,7770,3563,44,918,26,0,31,319,4590,5928
2,28/08/2022,0201-Puratchi Thalaivar Dr. M.G. Ramachandran Central,218600,373203,0,11544,135298,0,0,365442,18085,1915,20000,0,950,950,7934,4792,12726,4632,7287,11919,8447,78,4655,6,0,28,452,4158,9377
2,28/08/2022,0203-Egmore,44613,114875,0,3080,67426,0,0,115119,6010,2830,8840,0,3000,3000,1424,2300,3724,1957,2694,4651,1812,22,424,5,0,10,118,2150,2729
2,28/08/2022,0205-Nehru Park,43865,30556,0,456,15366,0,0,59687,2400,1425,3825,0,26000,26000,565,520,1085,569,496,1065,612,6,139,7,0,3,18,498,671
2,28/08/2022,0207-Kilpauk,14440,27700,0,736,13936,0,0,29112,320,20,340,0,0,0,471,490,961,554,412,966,535,7,86,0,0,0,34,455,582
2,28/08/2022,0209-Pachaiyappas College,22233,30248,0,336,13736,0,0,36305,490,520,1010,0,6000,6000,707,470,1177,615,479,1094,652,7,96,2,0,6,13,455,579
2,28/08/2022,0211-Shenoy Nagar,15362,26885,0,536,12646,0,0,28544,2210,450,2660,0,0,0,524,446,970,561,392,953,559,8,87,0,0,4,22,419,540
2,28/08/2022,0213-Anna Nagar East,42363,61738,0,2136,27144,0,0,71643,950,985,1935,0,3000,3000,1326,992,2318,1321,772,2093,1346,7,186,3,0,8,82,891,1177
2,28/08/2022,0215-Anna Nagar Tower,39718,59150,0,1880,23574,0,0,65172,4095,2045,6140,0,12000,12000,1237,853,2090,1223,801,2024,1329,13,300,0,0,4,55,762,1134
2,28/08/2022,0217-Thirumangalam,115260,203734,0,6544,99794,0,0,221598,117830,8975,126805,0,0,0,3650,3315,6965,3474,2963,6437,3749,35,864,11,0,10,244,3005,4169
2,28/08/2022,0219-Koyambedu,80594,151579,0,3056,81396,0,0,165046,7570,3375,10945,0,500,500,2589,2759,5348,2301,2203,4504,2541,38,728,17,0,23,136,2525,3467
2,28/08/2022,0221-Puratchi Thalaivi Dr. J. Jayalalithaa CMBT,50437,156146,0,3200,84848,0,0,138485,0,0,0,0,0,0,1875,2699,4574,2723,4671,7394,2559,23,823,4,0,8,115,2536,3509
2,28/08/2022,0223-Arumbakkam,31813,49573,0,560,30792,0,0,63165,2140,330,2470,0,8000,8000,798,1045,1843,919,974,1893,760,39,0,0,0,20,21,1019,1099
2,28/08/2022,0225-Vadapalani,84882,188708,0,7096,95980,0,0,187958,34460,4930,39390,0,1500,1500,3127,3431,6558,3175,3221,6396,3444,31,958,1,0,18,253,3031,4292
2,28/08/2022,0227-Ashok Nagar,54629,91196,0,3072,45352,0,0,103053,6735,3155,9890,0,0,0,1592,1567,3159,1559,1373,2932,1704,17,489,7,0,3,106,1388,2010
2,28/08/2022,0229-Ekkattuthangal,28248,53328,0,1864,24544,0,0,54656,0,0,0,0,0,0,1038,873,1911,1128,736,1864,1140,7,232,1,0,9,71,789,1109
2,28/08/2022,0231-Arignar Anna Alandur,78673,140589,0,3504,72006,0,0,154183,7985,2845,10830,0,250,250,2412,2324,4736,2262,2069,4331,2438,37,659,11,0,20,117,2110,2954
2,28/08/2022,0233-St. Thomas Mount,48647,90180,0,5192,46138,0,0,99977,2965,1245,4210,0,2250,2250,1404,1508,2912,1396,1215,2611,1513,27,416,3,0,13,127,1376,1962
1,29/08/2022,01ED-Wimco Nagar Depot Metro,88107,80200,0,1120,29836,0,0,119063,310,325,635,0,2000,2000,1906,760,2666,1649,494,2143,1588,13,0,2,0,10,32,724,781
1,29/08/2022,01EF-Wimco Nagar Metro,134235,149342,0,3504,41550,0,0,179289,13545,8080,21625,0,1750,1750,3458,1106,4564,3342,1137,4479,3380,56,79,1,0,10,97,1005,1248
1,29/08/2022,01F1-Thiruvotriyur Metro,139736,113397,0,1840,28292,0,0,169868,1780,1305,3085,0,0,0,2901,803,3704,2897,774,3671,2826,76,1,0,0,7,52,749,885
1,29/08/2022,01F3-Thiruvotriyur Theradi Metro,119125,140134,0,2240,38042,0,0,159407,2265,2770,5035,0,0,0,3120,1091,4211,3248,1223,4471,3403,37,248,5,0,19,66,994,1369
1,29/08/2022,01F5-Kaladipet Metro,110974,110848,0,1408,32788,0,0,145170,1200,2825,4025,0,0,0,2977,954,3931,2969,940,3909,2909,37,0,1,0,11,46,917,1012
1,29/08/2022,01F7-Tollgate Metro,76298,62874,0,856,19054,0,0,96208,230,145,375,0,0,0,1632,560,2192,1643,592,2235,1593,33,0,0,0,9,23,532,597
1,29/08/2022,01F9-New Washermenpet Metro,112486,116549,0,1264,36812,0,0,150562,1135,1900,3035,0,1000,1000,3019,1136,4155,3024,1082,4106,3053,33,109,0,0,14,39,1092,1287
1,29/08/2022,01FB-Tondiarpet Metro,103888,111776,0,1792,33448,0,0,139128,6055,3745,9800,0,1000,1000,2794,1074,3868,3107,1168,4275,3030,32,1,0,0,14,63,996,1106
1,29/08/2022,01FD-Thiagaraya College Metro,131719,135516,0,2568,41250,0,0,175537,7320,3845,11165,0,250,250,3785,1419,5204,3764,1284,5048,3780,89,62,0,0,9,64,1323,1547
1,29/08/2022,0101-Washermanpet,99577,123311,0,2392,44552,0,0,146521,6745,4015,10760,0,6500,6500,3412,1569,4981,3158,1380,4538,3210,18,117,1,0,5,68,1480,1689
1,29/08/2022,0103-Mannadi,89975,114114,0,1424,34438,0,0,125837,5365,6655,12020,0,0,0,2965,1167,4132,3300,1236,4536,3320,24,96,3,0,1,59,1100,1283
1,29/08/2022,0105-High Court,168291,249744,0,2728,82058,0,0,253077,1770,1465,3235,0,0,0,6746,2868,9614,6790,2180,8970,6875,48,194,1,0,15,118,2721,3097
1,29/08/2022,0109-Government Estate,94372,151549,0,2080,51718,0,0,148170,2655,3020,5675,0,500,500,3831,1785,5616,4117,1605,5722,4339,37,320,2,0,13,82,1668,2122
1,29/08/2022,0111-LIC,89133,169982,0,2376,34424,0,0,125933,1165,705,1870,0,0,0,4712,1225,5937,5471,1050,6521,5457,22,0,1,0,5,102,1099,1229
1,29/08/2022,0113-Thousand Lights,157266,238819,0,5104,47284,0,0,209654,900,335,1235,0,0,0,6671,1757,8428,7747,1691,9438,7691,30,0,0,0,6,197,1525,1758
1,29/08/2022,0115-AG-DMS,116215,147012,0,1800,29650,0,0,147665,0,0,0,0,1000,1000,4489,1007,5496,4550,847,5397,4613,25,142,2,0,3,64,918,1154
1,29/08/2022,0117-Teynampet,88290,147252,0,1688,32256,0,0,122234,0,0,0,0,0,0,4204,1168,5372,4815,1212,6027,4746,24,0,1,0,3,71,1071,1170
1,29/08/2022,0119-Nandanam,85839,120116,0,2344,31658,0,0,119841,2490,3820,6310,0,750,750,3288,1177,4465,3827,1080,4907,3769,40,0,0,0,5,95,1044,1184
1,29/08/2022,0121-Saidapet,50054,84671,0,1256,27864,0,0,79174,2120,1355,3475,0,2000,2000,1895,942,2837,2360,845,3205,2275,11,0,0,0,4,56,889,960
1,29/08/2022,0123-Little Mount,88156,102797,0,3432,31232,0,0,122820,4525,5380,9905,0,1500,1500,3163,1075,4238,2788,736,3524,2864,26,145,0,0,15,64,997,1247
1,29/08/2022,0125-Guindy,144640,268153,0,6048,92340,0,0,243028,8345,6565,14910,0,3000,3000,7045,3161,10206,6717,2731,9448,6882,46,358,0,0,5,230,2796,3435
1,29/08/2022,0129-Nanganallur Road,58514,50889,0,712,14994,0,0,74220,1000,5490,6490,0,0,0,1273,462,1735,1392,368,1760,1348,14,0,1,0,0,23,427,465
1,29/08/2022,0131-Meenambakkam,136493,136878,0,2392,48090,0,0,186975,7760,15900,23660,0,0,0,3501,1345,4846,2875,1004,3879,2994,32,204,2,0,4,72,1270,1584
1,29/08/2022,0133-Chennai International Airport,208329,340746,0,8008,154874,0,0,371211,10975,11980,22955,0,11750,11750,5570,4228,9798,5712,3870,9582,5929,37,688,9,0,20,244,3879,4877
2,29/08/2022,0201-Puratchi Thalaivar Dr. M.G. Ramachandran Central,307494,487848,0,14288,174016,0,0,495798,32295,3870,36165,0,6800,6800,13801,6347,20148,9812,8088,17900,12769,131,3312,11,0,23,527,5563,9567
2,29/08/2022,0203-Egmore,76872,132252,0,2816,67198,0,0,146886,11910,4270,16180,0,11500,11500,2457,2345,4802,2646,2967,5613,2646,18,357,10,0,14,106,2183,2688
2,29/08/2022,0205-Nehru Park,41879,47681,0,808,16842,0,0,59529,2935,2165,5100,0,2000,2000,1309,618,1927,1265,541,1806,1294,13,98,0,0,2,36,572,721
2,29/08/2022,0207-Kilpauk,36588,61453,0,1128,19218,0,0,56934,515,220,735,0,0,0,1518,711,2229,1684,649,2333,1692,16,88,0,0,2,50,644,800
2,29/08/2022,0209-Pachaiyappas College,45420,55460,0,656,17224,0,0,63300,790,860,1650,0,4750,4750,1669,650,2319,1649,575,2224,1603,18,70,1,0,1,25,614,729
2,29/08/2022,0211-Shenoy Nagar,41058,48464,0,448,13820,0,0,55326,2190,1740,3930,0,0,0,1280,475,1755,1434,554,1988,1420,11,57,0,0,1,17,450,536
2,29/08/2022,0213-Anna Nagar East,79030,107382,0,1824,29810,0,0,110664,1005,3205,4210,0,0,0,2826,1098,3924,3087,997,4084,3100,16,108,0,0,3,74,989,1190
2,29/08/2022,0215-Anna Nagar Tower,86798,105400,0,2368,27198,0,0,116364,9775,6960,16735,0,1000,1000,2776,980,3756,2912,905,3817,3006,24,202,0,0,0,67,895,1188
2,29/08/2022,0217-Thirumangalam,267743,302864,0,5936,89814,0,0,363493,56325,17525,73850,0,0,0,7697,3019,10716,7980,3012,10992,8062,61,453,8,0,6,212,2745,3485
2,29/08/2022,0219-Koyambedu,199430,263722,0,5944,109488,0,0,314862,18795,11665,30460,12000,13250,25250,6122,3687,9809,5075,2538,7613,5605,51,799,5,0,9,180,3432,4476
2,29/08/2022,0221-Puratchi Thalaivi Dr. J. Jayalalithaa CMBT,78525,206789,0,4328,107956,0,0,190809,0,0,0,0,0,0,3076,3540,6616,3731,4679,8410,3731,46,681,11,0,8,171,3358,4275
2,29/08/2022,0223-Arumbakkam,64448,69497,0,952,28150,0,0,93550,1205,655,1860,0,4250,4250,1621,972,2593,1774,821,2595,1636,50,1,2,0,17,39,929,1038
2,29/08/2022,0225-Vadapalani,118096,216477,0,4136,85536,0,0,207768,16920,5590,22510,0,5000,5000,4603,2871,7474,4798,2683,7481,4994,25,619,0,0,16,159,2641,3460
2,29/08/2022,0227-Ashok Nagar,87840,152961,0,3848,57598,0,0,149286,8060,6665,14725,0,7500,7500,3476,1917,5393,3561,1725,5286,3658,23,306,0,0,2,117,1758,2206
2,29/08/2022,0229-Ekkattuthangal,89246,129714,0,1736,32842,0,0,123824,0,0,0,0,0,0,3523,1128,4651,3790,1111,4901,3881,17,234,0,0,8,78,1022,1359
2,29/08/2022,0231-Arignar Anna Alandur,163487,207223,0,4952,76988,0,0,245427,11250,8270,19520,0,4250,4250,5199,2530,7729,4816,2030,6846,5036,55,421,4,0,11,176,2271,2938
2,29/08/2022,0233-St. Thomas Mount,94955,106784,0,2488,34836,0,0,132279,1910,3335,5245,0,17500,17500,2753,1142,3895,2624,1058,3682,2734,38,220,1,0,5,78,1027,1369
1,30/08/2022,01ED-Wimco Nagar Depot Metro,82550,74641,0,1272,25352,0,0,109174,120,370,490,0,5500,5500,1945,647,2592,1581,394,1975,1563,17,0,4,0,8,40,614,683
1,30/08/2022,01EF-Wimco Nagar Metro,117608,139077,0,2888,34324,0,0,154820,18475,6005,24480,0,1250,1250,3389,939,4328,3264,1015,4279,3289,63,93,1,0,3,84,847,1091
1,30/08/2022,01F1-Thiruvotriyur Metro,122578,99548,0,1512,18660,0,0,142750,1940,1450,3390,0,0,0,2840,535,3375,2743,569,3312,2691,73,0,0,0,3,34,497,607
1,30/08/2022,01F3-Thiruvotriyur Theradi Metro,106691,115435,900,1384,26962,0,0,135937,1980,2305,4285,0,0,0,2799,759,3558,2991,851,3842,3028,24,120,2,0,3,47,714,910
1,30/08/2022,01F5-Kaladipet Metro,104188,102248,0,968,25580,0,0,130736,1375,2515,3890,0,0,0,2959,767,3726,2970,653,3623,2892,23,0,1,0,6,33,737,800
1,30/08/2022,01F7-Tollgate Metro,51663,59262,0,816,14942,0,0,67421,10,125,135,0,0,0,1647,463,2110,1637,466,2103,1619,18,38,2,0,5,28,430,521
1,30/08/2022,01F9-New Washermenpet Metro,101324,99272,300,1136,27280,0,0,130040,1630,2015,3645,0,500,500,2874,890,3764,2878,722,3600,2845,20,49,1,0,5,43,848,966
1,30/08/2022,01FB-Tondiarpet Metro,97902,101791,0,1296,26776,0,0,125974,10510,3165,13675,0,1500,1500,2820,886,3706,2997,880,3877,2940,25,6,1,0,7,42,836,917
1,30/08/2022,01FD-Thiagaraya College Metro,127720,120670,0,1576,27188,0,0,156484,4980,3995,8975,0,1250,1250,3742,978,4720,3812,973,4785,3800,83,48,2,0,9,55,919,1116
1,30/08/2022,0101-Washermanpet,104066,116470,195,1504,36556,0,0,142321,10100,4720,14820,0,12750,12750,3511,1306,4817,3248,1179,4427,3285,36,124,5,0,6,57,1247,1475
1,30/08/2022,0103-Mannadi,91702,114390,100,1416,35048,0,0,128266,10725,5540,16265,0,2000,2000,2989,1201,4190,3364,1112,4476,3322,21,46,2,0,4,38,1158,1269
1,30/08/2022,0105-High Court,159637,262820,0,2672,85540,0,0,247849,1135,1895,3030,0,0,0,7289,2955,10244,7067,2180,9247,7215,50,339,1,0,3,117,2848,3358
1,30/08/2022,0109-Government Estate,90649,137675,100,1912,36210,0,0,128871,2220,3235,5455,0,3250,3250,3983,1344,5327,4090,1408,5498,4387,19,423,4,0,12,82,1237,1777
1,30/08/2022,0111-LIC,86311,165378,2750,2128,31866,0,0,123055,980,1050,2030,0,0,0,4772,1127,5899,5399,977,6376,5393,34,0,0,0,2,81,1033,1150
1,30/08/2022,0113-Thousand Lights,152376,240792,3110,4600,47554,0,0,207640,560,310,870,0,2000,2000,6998,1713,8711,7853,1361,9214,7808,39,0,0,0,4,176,1539,1758
1,30/08/2022,0115-AG-DMS,95143,148030,10,1800,29084,0,0,126037,0,550,550,0,1250,1250,4643,1012,5655,4616,757,5373,4708,25,126,1,0,1,76,925,1154
1,30/08/2022,0117-Teynampet,110573,148194,750,2656,32540,0,0,146519,0,0,0,0,3000,3000,4418,1205,5623,4900,915,5815,4829,20,1,2,1,1,87,1107,1219
1,30/08/2022,0119-Nandanam,86743,123135,680,2320,32600,0,0,122343,2085,2925,5010,0,1250,1250,3561,1219,4780,3963,887,4850,3888,38,0,0,0,6,95,1116,1255
1,30/08/2022,0121-Saidapet,50743,74625,0,1376,21812,0,0,73931,1240,1595,2835,0,10000,10000,1909,796,2705,2149,644,2793,2124,19,0,0,0,3,57,738,817
1,30/08/2022,0123-Little Mount,98961,93050,750,1792,24640,0,0,126143,3130,5590,8720,0,1000,1000,3211,906,4117,2634,583,3217,2766,29,168,7,0,2,76,824,1106
1,30/08/2022,0125-Guindy,143097,267479,20,9664,89378,0,0,242159,5560,5250,10810,0,500,500,7295,3074,10369,6646,2267,8913,7040,38,401,0,0,4,310,2771,3524
1,30/08/2022,0129-Nanganallur Road,61418,47898,100,688,10676,0,0,72882,1040,6160,7200,0,0,0,1333,352,1685,1454,294,1748,1417,11,4,1,0,1,20,325,362
1,30/08/2022,0131-Meenambakkam,134979,129892,1000,2016,38904,0,0,176899,9020,14650,23670,0,0,0,3669,1090,4759,2974,938,3912,3083,18,210,5,0,7,59,1039,1338
1,30/08/2022,0133-Chennai International Airport,190345,326737,0,7784,140940,0,0,339069,7700,11890,19590,0,6000,6000,5533,3862,9395,5815,3410,9225,6026,50,648,10,0,18,222,3635,4583
2,30/08/2022,0201-Puratchi Thalaivar Dr. M.G. Ramachandran Central,282182,449650,708,9136,144810,0,0,436836,25700,2055,27755,0,9150,9150,12380,5128,17508,11018,7494,18512,12758,112,2610,13,2,17,354,4747,7855
2,30/08/2022,0203-Egmore,87198,134663,0,2520,58944,0,0,148662,8705,3460,12165,0,16250,16250,2464,2119,4583,3055,2825,5880,3043,25,435,9,0,13,106,1969,2557
2,30/08/2022,0205-Nehru Park,37610,51968,450,824,21132,0,0,60016,2130,2735,4865,0,2500,2500,1326,773,2099,1249,520,1769,1301,8,98,0,0,0,36,734,876
2,30/08/2022,0207-Kilpauk,36319,54680,0,712,15364,0,0,52395,400,220,620,0,0,0,1592,554,2146,1548,478,2026,1587,12,109,1,0,1,35,515,673
2,30/08/2022,0209-Pachaiyappas College,40064,55084,50,664,16070,0,0,56848,580,570,1150,0,2000,2000,1774,624,2398,1631,501,2132,1635,9,60,1,0,4,29,592,695
2,30/08/2022,0211-Shenoy Nagar,34377,48902,550,808,14940,0,0,50675,1390,1870,3260,0,3000,3000,1314,543,1857,1381,408,1789,1406,10,72,1,0,0,33,507,623
2,30/08/2022,0213-Anna Nagar East,84167,109775,1000,1864,29766,0,0,116797,975,3795,4770,0,0,0,3126,1092,4218,3141,826,3967,3195,10,151,0,0,2,71,1014,1248
2,30/08/2022,0215-Anna Nagar Tower,86600,104828,850,1848,27322,0,0,116620,3450,9625,13075,0,0,0,2909,990,3899,2924,830,3754,3008,13,194,6,0,0,66,916,1195
2,30/08/2022,0217-Thirumangalam,264419,310277,2400,6672,86796,0,0,360287,53250,23455,76705,0,0,0,8234,2957,11191,8046,2674,10720,8381,50,649,2,0,3,202,2732,3638
2,30/08/2022,0219-Koyambedu,171933,244443,1700,4168,90662,0,0,268463,11145,8830,19975,0,13000,13000,5926,3050,8976,5357,2329,7686,5681,42,667,8,0,17,174,2902,3810
2,30/08/2022,0221-Puratchi Thalaivi Dr. J. Jayalalithaa CMBT,71686,200973,0,3176,87838,0,0,162700,0,0,0,0,0,0,2793,2861,5654,4677,5048,9725,4332,40,647,3,0,4,116,2729,3539
2,30/08/2022,0223-Arumbakkam,53474,59668,0,1152,21628,0,0,76254,1610,425,2035,0,250,250,1579,792,2371,1606,666,2272,1540,37,6,3,0,11,47,738,842
2,30/08/2022,0225-Vadapalani,122877,200523,800,4976,67108,0,0,195761,17180,4690,21870,0,3500,3500,4781,2221,7002,4798,2240,7038,5112,43,670,3,0,11,206,2114,3047
2,30/08/2022,0227-Ashok Nagar,102511,138832,700,3152,41076,0,0,147439,7310,6045,13355,0,9000,9000,3770,1450,5220,3434,1311,4745,3757,36,492,2,0,2,123,1321,1976
2,30/08/2022,0229-Ekkattuthangal,94878,143077,1408,3296,37464,0,0,137046,0,0,0,0,0,0,4068,1364,5432,3879,879,4758,4161,23,366,3,0,8,128,1224,1752
2,30/08/2022,0231-Arignar Anna Alandur,156297,201292,640,4304,67900,0,0,229141,9640,10195,19835,0,3750,3750,5411,2229,7640,4834,1674,6508,5171,56,462,1,0,6,163,2042,2730
2,30/08/2022,0233-St. Thomas Mount,89142,104760,0,2016,33472,0,0,124630,1945,3315,5260,0,5750,5750,2792,1099,3891,2611,884,3495,2735,26,229,0,0,2,75,1014,1346
1,31/08/2022,01ED-Wimco Nagar Depot Metro,45760,47336,0,1792,21074,0,0,68626,80,90,170,0,1000,1000,859,553,1412,823,358,1181,793,25,0,3,0,8,46,509,591
1,31/08/2022,01EF-Wimco Nagar Metro,58602,65548,0,1800,28512,0,0,88914,9040,4295,13335,0,0,0,1282,739,2021,1175,747,1922,1141,56,61,1,0,14,56,681,869
1,31/08/2022,01F1-Thiruvotriyur Metro,63912,62789,0,1912,25746,0,0,91570,1500,755,2255,0,0,0,1213,708,1921,1270,571,1841,1194,38,0,0,0,14,57,645,754
1,31/08/2022,01F3-Thiruvotriyur Theradi Metro,55489,79716,550,1840,32028,0,0,89907,870,1185,2055,0,0,0,1428,911,2339,1462,969,2431,1521,17,189,0,0,14,60,839,1119
1,31/08/2022,01F5-Kaladipet Metro,58041,53516,0,1152,23966,0,0,83159,575,750,1325,0,0,0,1102,719,1821,1192,627,1819,1079,31,0,1,0,10,41,657,740
1,31/08/2022,01F7-Tollgate Metro,29056,37041,0,752,15484,0,0,45292,100,140,240,0,0,0,740,476,1216,861,409,1270,777,17,6,0,0,18,28,441,510
1,31/08/2022,01F9-New Washermenpet Metro,44613,52490,0,688,23464,0,0,68765,885,790,1675,0,1000,1000,1175,730,1905,1133,556,1689,1100,12,54,0,0,9,26,703,804
1,31/08/2022,01FB-Tondiarpet Metro,45663,59712,1000,1096,29538,0,0,77297,13250,2290,15540,0,0,0,1146,897,2043,1244,782,2026,1158,19,2,0,0,7,42,857,927
1,31/08/2022,01FD-Thiagaraya College Metro,66143,72578,100,2432,32362,0,0,101037,8525,1495,10020,0,1250,1250,1624,1038,2662,1506,833,2339,1514,54,73,0,0,11,72,959,1169
1,31/08/2022,0101-Washermanpet,69263,72885,300,2264,37020,0,0,108847,10015,2575,12590,0,19000,19000,1417,1257,2674,1296,975,2271,1374,11,153,4,0,10,86,1161,1425
1,31/08/2022,0103-Mannadi,38282,57260,100,1304,32092,0,0,71778,9685,6625,16310,0,0,0,995,1056,2051,1145,957,2102,1049,8,34,0,0,4,38,1024,1108
1,31/08/2022,0105-High Court,36675,68715,0,1144,34032,0,0,71851,1365,885,2250,0,0,0,1376,1155,2531,1385,916,2301,1413,18,148,1,0,2,43,1107,1319
1,31/08/2022,0109-Government Estate,47508,83601,640,2240,30392,0,0,80780,2185,1255,3440,0,2500,2500,1987,1120,3107,1869,1218,3087,2136,21,481,0,0,9,82,1009,1602
1,31/08/2022,0111-LIC,23462,46872,200,1752,21696,0,0,47110,2065,170,2235,0,2000,2000,836,746,1582,1043,610,1653,1009,10,0,0,0,4,62,663,739
1,31/08/2022,0113-Thousand Lights,53191,79281,300,2816,32132,0,0,88439,155,80,235,0,0,0,1546,1135,2681,2047,1007,3054,1916,15,0,3,0,10,107,1014,1149
1,31/08/2022,0115-AG-DMS,22622,35968,0,904,13316,0,0,36842,0,0,0,0,0,0,837,434,1271,738,415,1153,851,9,181,0,0,0,31,386,607
1,31/08/2022,0117-Teynampet,22817,38747,0,1336,16440,0,0,40593,0,0,0,0,0,0,750,616,1366,967,557,1524,902,11,0,0,0,2,54,559,626
1,31/08/2022,0119-Nandanam,26475,41819,0,1632,18324,0,0,46431,1780,270,2050,0,0,0,838,672,1510,1034,534,1568,985,8,0,6,0,9,52,615,690
1,31/08/2022,0121-Saidapet,31568,35288,50,1392,17780,0,0,50790,3020,1010,4030,0,8250,8250,599,605,1204,721,535,1256,671,12,0,3,1,6,54,541,617
1,31/08/2022,0123-Little Mount,31956,43398,0,1760,17000,0,0,50716,3605,2520,6125,0,0,0,959,621,1580,946,476,1422,1027,13,135,2,0,10,66,528,754
1,31/08/2022,0125-Guindy,60974,122379,100,4688,62418,0,0,128180,4925,1610,6535,0,0,0,2038,2097,4135,2223,1909,4132,2200,34,283,3,0,10,191,1787,2308
1,31/08/2022,0129-Nanganallur Road,12857,20233,0,184,9914,0,0,22955,680,1705,2385,0,0,0,318,300,618,449,228,677,366,4,2,2,0,2,8,288,306
1,31/08/2022,0131-Meenambakkam,53172,71482,0,1912,36078,0,0,91162,5490,4820,10310,0,0,0,1210,988,2198,1026,843,1869,1121,20,209,1,0,7,55,936,1228
1,31/08/2022,0133-Chennai International Airport,119220,271196,100,9456,154416,0,0,283192,9815,3395,13210,0,1500,1500,3186,4232,7418,3624,3597,7221,3606,58,861,19,0,38,256,3882,5114
2,31/08/2022,0201-Puratchi Thalaivar Dr. M.G. Ramachandran Central,188377,307913,1035,10496,104618,0,0,304526,10130,915,11045,0,2100,2100,6779,3692,10471,4405,6097,10502,7325,62,3628,24,0,23,397,3266,7400
2,31/08/2022,0203-Egmore,63099,97266,100,3168,41836,0,0,108203,6200,2380,8580,0,12250,12250,1690,1536,3226,1713,2251,3964,2091,19,726,12,0,9,133,1416,2315
2,31/08/2022,0205-Nehru Park,16513,35075,0,1376,16630,0,0,34519,1755,380,2135,0,0,0,664,642,1306,679,531,1210,729,6,123,0,0,1,62,564,756
2,31/08/2022,0207-Kilpauk,16480,27396,0,1176,10912,0,0,28568,305,90,395,0,0,0,556,410,966,612,402,1014,631,9,63,1,0,2,43,356,474
2,31/08/2022,0209-Pachaiyappas College,21832,23427,0,312,10272,0,0,32416,690,90,780,0,11000,11000,508,367,875,508,333,841,520,3,83,0,0,3,12,351,452
2,31/08/2022,0211-Shenoy Nagar,15096,21028,0,488,8746,0,0,24330,710,710,1420,0,0,0,488,316,804,496,325,821,498,6,53,0,0,2,14,300,375
2,31/08/2022,0213-Anna Nagar East,41843,54184,600,1480,21708,0,0,65631,700,855,1555,0,3000,3000,1226,771,1997,1228,665,1893,1272,15,172,0,0,8,57,703,955
2,31/08/2022,0215-Anna Nagar Tower,44983,50876,50,1704,18206,0,0,64943,2795,1175,3970,0,1250,1250,1208,642,1850,1183,623,1806,1244,14,233,0,1,7,65,570,890
2,31/08/2022,0217-Thirumangalam,115835,183075,1100,7904,81902,0,0,206741,112850,7285,120135,0,0,0,3386,2828,6214,3475,2393,5868,3691,32,682,7,0,23,279,2466,3489
2,31/08/2022,0219-Koyambedu,86846,152451,100,5040,79962,0,0,171948,8865,3900,12765,0,3250,3250,2571,2760,5331,2490,1987,4477,2634,25,686,1,0,30,201,2456,3399
2,31/08/2022,0221-Puratchi Thalaivi Dr. J. Jayalalithaa CMBT,39443,126635,100,2248,77174,0,0,118965,0,0,0,0,0,0,1398,2484,3882,2104,3074,5178,1843,35,421,4,0,7,84,2384,2935
2,31/08/2022,0223-Arumbakkam,39765,37824,0,728,22868,0,0,63361,1090,230,1320,0,12250,12250,650,840,1490,769,606,1375,638,26,7,1,0,6,32,806,878
2,31/08/2022,0225-Vadapalani,104545,178435,100,7920,76332,0,0,188897,43890,7370,51260,0,3000,3000,3486,2933,6419,3206,3030,6236,3871,56,1208,0,0,18,309,2463,4054
2,31/08/2022,0227-Ashok Nagar,57143,82028,100,2904,43388,0,0,103535,6375,3520,9895,0,12500,12500,1436,1572,3008,1417,1308,2725,1492,16,326,4,0,3,109,1433,1891
2,31/08/2022,0229-Ekkattuthangal,37654,52928,280,2120,20312,0,0,60366,0,0,0,0,0,0,1211,756,1967,1198,677,1875,1323,8,285,0,0,3,91,633,1020
2,31/08/2022,0231-Arignar Anna Alandur,66810,115649,400,3088,57842,0,0,128140,6825,4175,11000,0,500,500,2070,1850,3920,1957,1584,3541,2115,27,518,3,0,8,106,1669,2331
2,31/08/2022,0233-St. Thomas Mount,51117,68860,0,4336,35440,0,0,90893,970,785,1755,0,2250,2250,1113,1238,2351,1136,1061,2197,1226,16,250,2,0,4,131,1061,1464
1,01/09/2022,01ED-Wimco Nagar Depot Metro,103895,74537,0,2440,25040,0,0,131375,150,290,440,0,14750,14750,1823,677,2500,1590,393,1983,1563,13,0,2,0,4,57,610,686
1,01/09/2022,01EF-Wimco Nagar Metro,155976,138326,500,2304,34896,0,0,193676,15360,8665,24025,0,1750,1750,3226,927,4153,3264,968,4232,3249,56,108,2,0,9,69,858,1102
1,01/09/2022,01F1-Thiruvotriyur Metro,163695,109548,0,2032,25634,0,0,191361,1315,1475,2790,0,0,0,2833,707,3540,2862,655,3517,2780,67,0,5,0,12,52,655,791
1,01/09/2022,01F3-Thiruvotriyur Theradi Metro,168549,131720,100,2184,38976,0,0,209809,945,2635,3580,0,0,0,2925,1104,4029,3159,1097,4256,3118,36,95,6,0,17,67,1012,1233
1,01/09/2022,01F5-Kaladipet Metro,149582,105357,300,1400,27764,0,0,179046,1235,2740,3975,0,0,0,2941,874,3815,2932,764,3696,2882,46,0,0,0,6,46,819,917
1,01/09/2022,01F7-Tollgate Metro,89505,62415,200,808,12806,0,0,103319,105,115,220,0,0,0,1825,398,2223,1680,487,2167,1789,35,148,2,0,13,27,369,594
1,01/09/2022,01F9-New Washermenpet Metro,136973,102619,100,2368,28670,0,0,168111,1205,1820,3025,0,500,500,2886,915,3801,2958,816,3774,2927,27,55,1,0,4,31,895,1013
1,01/09/2022,01FB-Tondiarpet Metro,132699,108090,550,1480,33744,0,0,168473,6950,3775,10725,0,250,250,2770,1082,3852,3031,1014,4045,2926,32,7,2,0,8,48,1030,1127
1,01/09/2022,01FD-Thiagaraya College Metro,146182,127829,0,2376,35578,0,0,184136,6445,4565,11010,0,2000,2000,3730,1230,4960,3744,1142,4886,3742,76,71,0,0,11,68,1146,1372
1,01/09/2022,0101-Washermanpet,125360,128584,350,2064,45424,0,0,173198,8465,3860,12325,0,21000,21000,3461,1483,4944,3370,1457,4827,3421,25,135,0,0,5,80,1469,1714
1,01/09/2022,0103-Mannadi,87624,108360,0,1856,30304,0,0,119784,7740,7750,15490,0,1500,1500,2949,1059,4008,3282,1008,4290,3267,23,58,1,0,8,46,1005,1141
1,01/09/2022,0105-High Court,182348,218558,100,2888,62680,0,0,248016,1045,1745,2790,0,0,0,6299,2263,8562,6320,1796,8116,6383,49,167,1,0,4,111,2128,2460
1,01/09/2022,0109-Government Estate,117112,131298,300,1936,32008,0,0,151356,7935,2310,10245,0,1000,1000,3778,1162,4940,3954,1355,5309,4293,18,474,0,0,1,82,1050,1625
1,01/09/2022,0111-LIC,129437,165510,1000,2336,30134,0,0,162907,1770,1015,2785,0,250,250,4832,1100,5932,5490,970,6460,5434,26,18,0,0,6,94,975,1119
1,01/09/2022,0113-Thousand Lights,214112,237725,1300,5072,44626,0,0,265110,795,390,1185,0,1000,1000,6837,1693,8530,7918,1447,9365,7775,48,1,0,0,4,211,1461,1725
1,01/09/2022,0115-AG-DMS,152186,147377,100,2480,31212,0,0,185978,0,0,0,0,1250,1250,4478,1079,5557,4475,771,5246,4566,33,157,0,0,2,91,959,1242
1,01/09/2022,0117-Teynampet,120310,144181,1500,2072,30902,0,0,154784,0,0,0,0,0,0,4313,1145,5458,4785,950,5735,4694,40,0,2,0,6,81,1046,1175
1,01/09/2022,0119-Nandanam,125004,118586,1350,2224,29106,0,0,157684,1245,2930,4175,0,500,500,3484,1102,4586,3935,950,4885,3859,40,0,0,0,1,90,977,1108
1,01/09/2022,0121-Saidapet,66619,78369,0,1384,23742,0,0,91745,3590,1360,4950,0,4500,4500,1828,833,2661,2306,803,3109,2221,17,0,0,0,4,54,771,846
1,01/09/2022,0123-Little Mount,104828,100852,1020,1976,30934,0,0,138758,4195,6735,10930,0,250,250,3141,1076,4217,2753,755,3508,2784,21,144,2,0,5,82,966,1220
1,01/09/2022,0125-Guindy,203656,257792,700,6280,69953,0,0,280589,7930,5435,13365,0,500,500,7586,2416,10002,6691,2332,9023,7298,46,774,1,1,8,241,2158,3229
1,01/09/2022,0129-Nanganallur Road,81308,50463,1200,432,13432,0,0,96372,1105,5910,7015,0,0,0,1281,415,1696,1490,320,1810,1416,7,0,1,0,0,14,389,411
1,01/09/2022,0131-Meenambakkam,176785,136848,1100,2888,41186,0,0,221959,7570,12840,20410,0,0,0,3746,1167,4913,3112,981,4093,3236,30,241,2,0,4,85,1110,1472
1,01/09/2022,0133-Chennai International Airport,226666,333000,500,8464,145838,0,0,381468,9455,11535,20990,0,6750,6750,5471,3986,9457,5830,3701,9531,6009,71,704,6,0,17,223,3665,4686
2,01/09/2022,0201-Puratchi Thalaivar Dr. M.G. Ramachandran Central,335445,447570,3700,13208,130602,0,0,482955,26570,2210,28780,0,4250,4250,13513,4805,18318,10083,6958,17041,12882,122,3407,1,0,19,487,4179,8215
2,01/09/2022,0203-Egmore,84912,132301,500,3432,62826,0,0,151670,13670,4025,17695,0,10000,10000,2673,2213,4886,2534,2705,5239,2742,18,587,9,0,9,119,2047,2789
2,01/09/2022,0205-Nehru Park,61016,46208,400,976,16344,0,0,78736,1615,2245,3860,0,2500,2500,1266,606,1872,1278,518,1796,1282,8,79,0,0,2,39,567,695
2,01/09/2022,0207-Kilpauk,47955,54053,0,848,16196,0,0,64999,380,240,620,0,0,0,1445,596,2041,1522,570,2092,1528,15,87,0,0,0,33,552,687
2,01/09/2022,0209-Pachaiyappas College,49749,55601,100,528,18790,0,0,69167,770,1530,2300,0,2500,2500,1658,726,2384,1547,595,2142,1564,16,89,1,0,3,23,693,825
2,01/09/2022,0211-Shenoy Nagar,46733,49350,0,520,14020,0,0,61273,2230,1810,4040,0,250,250,1286,484,1770,1412,513,1925,1431,10,81,0,1,2,22,449,565
2,01/09/2022,0213-Anna Nagar East,101697,108497,274,2272,31102,0,0,135345,970,3240,4210,0,0,0,2954,1127,4081,3015,1027,4042,3049,23,140,1,0,1,68,1042,1275
2,01/09/2022,0215-Anna Nagar Tower,114158,100952,1236,1008,25718,0,0,142120,1615,2930,4545,0,2000,2000,2735,906,3641,2930,840,3770,2899,16,162,0,0,1,46,849,1074
2,01/09/2022,0217-Thirumangalam,335512,306538,950,7224,88758,0,0,432444,56085,19260,75345,0,0,0,7808,3007,10815,8020,2806,10826,8178,85,493,3,0,7,246,2706,3540
2,01/09/2022,0219-Koyambedu,248726,230403,210,4504,88906,0,0,342346,14205,16130,30335,250,22250,22500,5592,3004,8596,5069,2119,7188,5213,49,571,7,1,16,176,2816,3636
2,01/09/2022,0221-Puratchi Thalaivi Dr. J. Jayalalithaa CMBT,82374,186737,200,4000,95342,0,0,181916,0,0,0,0,0,0,2833,3133,5966,3561,3671,7232,3512,40,612,4,0,5,154,2996,3811
2,01/09/2022,0223-Arumbakkam,69380,59837,0,1200,22538,0,0,93118,1300,530,1830,0,1000,1000,1534,787,2321,1632,631,2263,1520,44,8,1,0,5,35,747,840
2,01/09/2022,0225-Vadapalani,183642,211723,1035,4456,81616,0,0,270749,29010,4450,33460,0,9500,9500,4601,2753,7354,4669,2638,7307,4931,44,668,2,0,5,173,2529,3421
2,01/09/2022,0227-Ashok Nagar,124406,142301,1442,4680,43218,0,0,173746,5995,6470,12465,0,3000,3000,3631,1469,5100,3590,1413,5003,3756,50,470,2,0,2,114,1336,1974
2,01/09/2022,0229-Ekkattuthangal,122232,127762,1400,2776,30084,0,0,156492,0,0,0,0,500,500,3472,1090,4562,3764,1025,4789,3902,34,234,0,0,3,114,953,1338
2,01/09/2022,0231-Arignar Anna Alandur,199770,199689,1463,4424,66898,0,0,272555,8850,9755,18605,0,3000,3000,5158,2175,7333,4924,1778,6702,5135,58,422,3,0,10,149,2018,2660
2,01/09/2022,0233-St. Thomas Mount,118547,103336,100,2024,32738,0,0,153409,2235,3285,5520,0,8500,8500,2709,1092,3801,2627,1006,3633,2723,23,222,0,0,1,71,996,1313
1,02/09/2022,01ED-Wimco Nagar Depot Metro,95945,72532,50,1256,23310,0,0,120561,485,425,910,0,8250,8250,1937,600,2537,1625,313,1938,1568,14,0,5,0,8,33,567,627
1,02/09/2022,01EF-Wimco Nagar Metro,152464,130226,700,2960,29132,0,0,185256,13485,7590,21075,0,5000,5000,3195,801,3996,3147,806,3953,3158,37,67,2,0,6,83,705,900
1,02/09/2022,01F1-Thiruvotriyur Metro,154549,102199,0,1568,19994,0,0,176111,1980,1450,3430,0,0,0,2947,596,3543,2812,529,3341,2759,45,0,0,0,10,47,554,656
1,02/09/2022,01F3-Thiruvotriyur Theradi Metro,133968,126095,0,1592,27702,0,0,163262,1390,3385,4775,0,0,0,3052,760,3812,3253,852,4105,3344,23,190,2,0,11,54,717,997
1,02/09/2022,01F5-Kaladipet Metro,132128,98236,240,1200,21296,0,0,154864,1105,2550,3655,0,0,0,2999,678,3677,2959,616,3575,2865,25,0,1,0,5,40,638,709
1,02/09/2022,01F7-Tollgate Metro,69828,58209,0,776,15846,0,0,86450,475,105,580,0,250,250,1676,495,2171,1594,390,1984,1554,37,0,0,0,9,23,463,532
1,02/09/2022,01F9-New Washermenpet Metro,116015,101124,600,1128,26110,0,0,143853,1135,1955,3090,0,1750,1750,2944,886,3830,3003,753,3756,2967,17,70,2,0,9,43,842,983
1,02/09/2022,01FB-Tondiarpet Metro,101126,101126,900,1664,27786,0,0,131476,11810,3325,15135,0,0,0,2795,937,3732,2998,824,3822,2891,22,3,0,0,7,56,862,950
1,02/09/2022,01FD-Thiagaraya College Metro,127485,120529,0,1480,29506,0,0,158471,7760,2810,10570,0,3000,3000,3712,1015,4727,3728,1003,4731,3725,52,87,3,0,1,53,957,1153
1,02/09/2022,0101-Washermanpet,120235,122097,550,2328,41624,0,0,164737,14180,5595,19775,0,12750,12750,3515,1477,4992,3266,1166,4432,3296,35,113,2,0,6,88,1373,1617
1,02/09/2022,0103-Mannadi,103525,114848,1500,1128,26970,0,0,133123,9500,8460,17960,0,3000,3000,3281,926,4207,3400,1024,4424,3626,20,317,3,0,2,44,879,1265
1,02/09/2022,0105-High Court,164090,231288,0,3008,66048,0,0,233146,855,1900,2755,0,0,0,6682,2321,9003,6648,1746,8394,6743,27,267,3,0,3,116,2167,2583
1,02/09/2022,0109-Government Estate,120684,141031,1530,1424,34282,0,0,157920,3040,2900,5940,0,3250,3250,4154,1238,5392,4208,1370,5578,4623,26,590,0,1,5,73,1145,1840
1,02/09/2022,0111-LIC,122723,177014,700,2264,33712,0,0,159399,1560,645,2205,0,1000,1000,5006,1230,6236,5851,893,6744,5763,37,0,4,0,5,96,1083,1225
1,02/09/2022,0113-Thousand Lights,185349,240400,2800,4496,46486,0,0,239131,870,405,1275,0,1250,1250,7010,1736,8746,7950,1305,9255,7811,44,0,1,0,4,192,1475,1716
1,02/09/2022,0115-AG-DMS,128049,144805,50,2016,27562,0,0,157677,0,0,0,0,0,0,4558,990,5548,4555,762,5317,4630,23,150,2,0,0,81,874,1130
1,02/09/2022,0117-Teynampet,127437,145256,1610,1760,30624,0,0,161431,0,0,0,0,0,0,4468,1137,5605,4922,861,5783,4764,26,0,1,0,3,66,1034,1130
1,02/09/2022,0119-Nandanam,112813,119980,1400,2688,31202,0,0,148103,1540,925,2465,0,250,250,3444,1199,4643,3916,771,4687,3841,41,0,0,0,6,106,1055,1208
1,02/09/2022,0121-Saidapet,65402,79516,1300,1184,24660,0,0,92546,2015,2080,4095,0,2000,2000,1934,866,2800,2307,640,2947,2216,16,0,2,0,0,53,816,887
1,02/09/2022,0123-Little Mount,103807,92349,720,1632,26048,0,0,132207,5270,6100,11370,0,1250,1250,3184,992,4176,2561,622,3183,2652,15,181,1,0,1,62,907,1167
1,02/09/2022,0125-Guindy,179476,263491,700,5888,66884,0,0,252948,7745,6080,13825,0,0,0,8005,2041,10046,6718,2197,8915,7618,45,1057,2,1,7,232,2050,3394
1,02/09/2022,0129-Nanganallur Road,53275,48076,700,840,11228,0,0,66043,2420,6630,9050,0,0,0,1288,373,1661,1457,346,1803,1410,10,0,0,0,0,30,335,375
1,02/09/2022,0131-Meenambakkam,148050,137923,1400,2584,42036,0,0,194070,6080,16575,22655,0,0,0,3833,1201,5034,3105,902,4007,3247,27,241,2,1,2,76,1117,1466
1,02/09/2022,0133-Chennai International Airport,192250,329309,372,7880,145328,0,0,345830,8790,12215,21005,0,9750,9750,5473,4004,9477,6091,3291,9382,5968,55,630,5,1,17,242,3647,4597
2,02/09/2022,0201-Puratchi Thalaivar Dr. M.G. Ramachandran Central,354382,455833,2560,11248,97536,0,0,465726,21430,3380,24810,0,6850,6850,14183,3476,17659,11143,7434,18577,14474,100,4278,12,0,18,402,3173,7983
2,02/09/2022,0203-Egmore,91000,139100,100,2824,61794,0,0,155718,11225,3265,14490,0,16000,16000,2584,2026,4610,3142,2720,5862,3070,21,572,7,0,7,113,2049,2769
2,02/09/2022,0205-Nehru Park,52247,58318,100,936,22406,0,0,75689,2380,1850,4230,0,2500,2500,1571,760,2331,1392,595,1987,1494,9,192,0,0,12,27,739,979
2,02/09/2022,0207-Kilpauk,40559,54914,150,784,16796,0,0,58289,480,165,645,0,1000,1000,1494,604,2098,1511,505,2016,1527,15,68,1,0,2,32,558,676
2,02/09/2022,0209-Pachaiyappas College,49780,54317,0,944,14802,0,0,65526,960,640,1600,0,4000,4000,1725,586,2311,1660,441,2101,1643,15,76,3,0,6,32,553,685
2,02/09/2022,0211-Shenoy Nagar,47953,44617,1700,536,10226,0,0,60415,1800,1590,3390,0,1250,1250,1297,381,1678,1417,382,1799,1424,12,76,0,0,0,24,346,458
2,02/09/2022,0213-Anna Nagar East,103226,112776,0,2656,30918,0,0,136800,1120,3865,4985,0,0,0,3200,1166,4366,3189,969,4158,3248,34,183,1,0,4,72,1058,1352
2,02/09/2022,0215-Anna Nagar Tower,93600,105151,1850,1640,27088,0,0,124178,2955,8830,11785,0,1500,1500,2828,984,3812,2936,818,3754,2965,22,208,0,0,0,58,903,1191
2,02/09/2022,0217-Thirumangalam,297253,300828,4150,8160,80650,0,0,390213,61510,20430,81940,0,0,0,8157,2790,10947,8203,2504,10707,8305,74,526,5,0,6,236,2505,3352
2,02/09/2022,0219-Koyambedu,190835,231102,2350,4432,86800,0,0,284417,12090,9575,21665,10000,11500,21500,5607,2987,8594,5433,2140,7573,5352,51,482,4,0,10,159,2790,3496
2,02/09/2022,0221-Puratchi Thalaivi Dr. J. Jayalalithaa CMBT,75156,186959,500,2728,88664,0,0,167048,0,0,0,0,0,0,2470,2943,5413,4610,4527,9137,3844,35,429,5,0,4,107,2774,3354
2,02/09/2022,0223-Arumbakkam,70874,63236,0,1304,25156,0,0,97334,1205,465,1670,0,15750,15750,1612,917,2529,1736,615,2351,1562,43,4,1,0,7,44,834,933
2,02/09/2022,0225-Vadapalani,163606,204094,1730,5256,72272,0,0,242864,24700,4630,29330,0,59000,59000,4768,2450,7218,4557,2333,6890,4976,53,922,10,0,11,175,2235,3406
2,02/09/2022,0227-Ashok Nagar,124356,150491,1230,3464,46264,0,0,175314,6830,6660,13490,0,9500,9500,3879,1585,5464,3735,1327,5062,3979,35,547,6,0,6,116,1412,2122
2,02/09/2022,0229-Ekkattuthangal,96687,135280,1700,3992,39828,0,0,142207,10,165,175,0,750,750,3591,1400,4991,3593,856,4449,3783,22,292,0,0,2,132,1218,1666
2,02/09/2022,0231-Arignar Anna Alandur,187138,207156,670,4608,69732,0,0,262148,10125,11080,21205,0,4000,4000,5472,2246,7718,5091,1540,6631,5313,54,547,11,0,4,133,2061,2810
2,02/09/2022,0233-St. Thomas Mount,101614,109142,700,2856,38362,0,0,143532,1960,2920,4880,0,10500,10500,2803,1288,4091,2700,860,3560,2740,38,171,0,0,2,102,1140,1453
1,03/09/2022,01ED-Wimco Nagar Depot Metro,61844,68740,0,1784,28916,0,0,92544,140,270,410,0,750,750,1591,731,2322,1300,391,1691,1272,21,0,4,0,4,50,682,761
1,03/09/2022,01EF-Wimco Nagar Metro,124160,125112,200,2760,39388,0,0,166508,9710,5210,14920,0,2000,2000,2744,1015,3759,2706,921,3627,2674,60,99,1,0,11,73,930,1174
1,03/09/2022,01F1-Thiruvotriyur Metro,114327,94950,0,2336,27430,0,0,144093,1025,1160,2185,0,0,0,2400,772,3172,2340,605,2945,2267,59,0,0,0,4,64,706,833
1,03/09/2022,01F3-Thiruvotriyur Theradi Metro,100350,123075,1250,2776,36052,0,0,140428,1335,1825,3160,0,0,0,2657,1061,3718,2904,1029,3933,2925,36,157,2,0,13,97,952,1257
1,03/09/2022,01F5-Kaladipet Metro,99064,94094,0,2480,27520,0,0,129064,835,1925,2760,0,0,0,2464,888,3352,2517,730,3247,2435,39,0,1,0,7,76,813,936
1,03/09/2022,01F7-Tollgate Metro,62324,52227,0,856,17176,0,0,80356,265,1015,1280,0,0,0,1401,542,1943,1367,400,1767,1297,31,1,0,0,5,32,505,574
1,03/09/2022,01F9-New Washermenpet Metro,94641,82536,1100,1760,23356,0,0,120857,2210,1835,4045,0,0,0,2368,824,3192,2365,721,3086,2345,19,73,0,0,3,66,742,903
1,03/09/2022,01FB-Tondiarpet Metro,86052,91204,100,1504,31358,0,0,119014,7530,2305,9835,0,250,250,2289,1000,3289,2448,914,3362,2344,23,0,0,0,7,53,933,1016
1,03/09/2022,01FD-Thiagaraya College Metro,119002,116683,0,2536,36422,0,0,157960,3370,2710,6080,0,1500,1500,3164,1260,4424,3237,1118,4355,3225,91,79,0,0,10,103,1140,1423
1,03/09/2022,0101-Washermanpet,96607,114455,500,2480,47976,0,0,147563,6475,3205,9680,0,21750,21750,2834,1636,4470,2672,1355,4027,2679,20,171,0,0,4,87,1514,1796
1,03/09/2022,0103-Mannadi,77712,104851,0,2088,28830,0,0,108630,11840,9300,21140,0,1500,1500,2789,1024,3813,2784,1194,3978,3110,19,452,1,0,3,77,947,1499
1,03/09/2022,0105-High Court,114645,210985,0,4424,82542,0,0,201611,1110,2185,3295,0,0,0,5071,2888,7959,5079,2206,7285,5163,30,378,0,0,2,177,2641,3228
1,03/09/2022,0109-Government Estate,93909,148108,610,2896,51544,0,0,148959,8340,3315,11655,0,3500,3500,3640,1881,5521,3795,1642,5437,4058,16,593,1,0,6,127,1662,2405
1,03/09/2022,0111-LIC,67586,128926,3950,2872,35126,0,0,109534,875,675,1550,0,2000,2000,3167,1291,4458,3853,915,4768,3751,26,0,0,0,2,114,1131,1273
1,03/09/2022,0113-Thousand Lights,107935,191172,700,5112,56026,0,0,169773,385,135,520,0,1000,1000,4725,1820,6545,5637,1526,7163,5405,21,0,3,0,9,199,1761,1993
1,03/09/2022,0115-AG-DMS,77838,101870,0,2128,25578,0,0,105544,0,0,0,0,1250,1250,2908,919,3827,2838,646,3484,2945,17,191,0,0,0,85,792,1085
1,03/09/2022,0117-Teynampet,64834,110445,100,1584,33626,0,0,100144,0,0,0,0,0,0,2780,1220,4000,3321,932,4253,3147,24,0,3,0,3,64,1140,1234
1,03/09/2022,0119-Nandanam,73873,81380,595,1936,31294,0,0,107698,355,90,445,0,250,250,2000,1144,3144,2208,729,2937,2077,30,0,0,0,5,78,1037,1150
1,03/09/2022,0121-Saidapet,40442,67744,550,1288,29666,0,0,71946,4505,1110,5615,0,6000,6000,1284,1006,2290,1627,798,2425,1472,17,0,4,0,1,52,946,1020
1,03/09/2022,0123-Little Mount,73771,73661,400,1800,25954,0,0,101925,9435,4260,13695,0,7500,7500,2060,940,3000,1769,718,2487,1853,26,218,1,0,6,72,849,1172
1,03/09/2022,0125-Guindy,140084,233002,200,7128,85518,0,0,232930,5400,3645,9045,0,0,0,5394,2941,8335,4796,2762,7558,5463,40,1059,2,0,11,271,2484,3867
1,03/09/2022,0129-Nanganallur Road,46520,42582,300,648,15950,0,0,63418,1190,3700,4890,0,0,0,907,500,1407,1144,388,1532,1011,11,0,0,0,0,24,454,489
1,03/09/2022,0131-Meenambakkam,130325,121985,50,3752,46230,0,0,180357,8485,14825,23310,0,0,0,2882,1326,4208,2395,969,3364,2507,27,319,2,0,3,105,1193,1649
1,03/09/2022,0133-Chennai International Airport,171490,339488,1150,11912,176240,0,0,360792,12365,9195,21560,0,8500,8500,4692,4910,9602,5384,4068,9452,5196,70,909,18,0,22,318,4391,5728
2,03/09/2022,0201-Puratchi Thalaivar Dr. M.G. Ramachandran Central,321757,455049,1790,10088,116276,0,0,449911,14895,1495,16390,0,6350,6350,12612,4138,16750,8918,7859,16777,12947,92,5240,10,0,26,411,3586,9365
2,03/09/2022,0203-Egmore,83377,135031,400,2184,61778,0,0,147739,9630,3050,12680,0,18500,18500,2377,2032,4409,2656,2789,5445,2868,30,809,5,0,10,94,2021,2969
2,03/09/2022,0205-Nehru Park,29520,48250,0,1296,18494,0,0,49310,2350,780,3130,0,2500,2500,1219,666,1885,1184,533,1717,1230,8,148,0,0,3,47,628,834
2,03/09/2022,0207-Kilpauk,26837,47831,0,2160,16560,0,0,45557,445,210,655,0,0,0,1214,623,1837,1232,561,1793,1247,7,101,1,0,3,58,551,721
2,03/09/2022,0209-Pachaiyappas College,43449,48607,100,592,15212,0,0,59353,870,1000,1870,0,6250,6250,1507,567,2074,1386,443,1829,1372,8,75,3,0,4,24,537,651
2,03/09/2022,0211-Shenoy Nagar,35795,41253,100,768,12944,0,0,49607,970,1250,2220,0,0,0,1055,468,1523,1127,451,1578,1140,19,94,1,0,2,30,427,573
2,03/09/2022,0213-Anna Nagar East,73383,109023,100,2168,33224,0,0,108875,3820,2290,6110,0,0,0,2831,1115,3946,2851,1095,3946,2959,18,370,2,0,4,88,1096,1578
2,03/09/2022,0215-Anna Nagar Tower,76710,99510,100,2512,34634,0,0,113956,5430,4715,10145,0,750,750,2369,1249,3618,2487,1037,3524,2483,29,252,0,0,2,94,1109,1486
2,03/09/2022,0217-Thirumangalam,219501,277265,2730,7848,101912,0,0,331991,93090,12610,105700,0,1500,1500,6303,3478,9781,6479,2996,9475,6514,75,769,13,0,9,299,3116,4281
2,03/09/2022,0219-Koyambedu,163730,217750,500,4792,88370,0,0,257392,14660,5810,20470,0,10000,10000,4896,3099,7995,4511,2283,6794,4710,54,885,10,0,14,192,2825,3980
2,03/09/2022,0221-Puratchi Thalaivi Dr. J. Jayalalithaa CMBT,48309,183915,2090,3528,96360,0,0,150287,0,0,0,0,0,0,2170,3217,5387,4065,4790,8855,3361,25,546,1,0,1,148,3007,3728
2,03/09/2022,0223-Arumbakkam,52962,56063,50,864,26000,0,0,79876,3020,440,3460,0,13000,13000,1326,963,2289,1455,630,2085,1238,37,13,5,0,12,39,904,1010
2,03/09/2022,0225-Vadapalani,153361,229619,1300,7480,79864,0,0,242005,35370,7130,42500,0,5000,5000,5106,2885,7991,4712,3359,8071,5582,52,1652,13,0,20,276,2443,4456
2,03/09/2022,0227-Ashok Nagar,108533,136220,700,3880,42564,0,0,155677,6160,4620,10780,0,12000,12000,3407,1517,4924,3130,1484,4614,3525,36,805,4,0,5,154,1317,2321
2,03/09/2022,0229-Ekkattuthangal,66068,84654,250,1904,30570,0,0,98792,0,0,0,0,0,0,2129,1096,3225,2073,827,2900,2136,15,324,0,0,1,82,964,1386
2,03/09/2022,0231-Arignar Anna Alandur,154349,193329,200,4792,80526,0,0,239867,8825,7290,16115,0,2250,2250,4198,2605,6803,4095,1997,6092,4237,59,660,4,0,10,176,2327,3236
2,03/09/2022,0233-St. Thomas Mount,80628,112121,180,4264,42468,0,0,127540,2210,1750,3960,0,4000,4000,2498,1439,3937,2288,1272,3560,2533,26,478,8,0,3,151,1260,1926
1,04/09/2022,01ED-Wimco Nagar Depot Metro,41466,65545,0,1432,35072,0,0,77970,750,340,1090,0,4250,4250,931,862,1793,1034,393,1427,910,15,5,0,0,14,36,820,890
1,04/09/2022,01EF-Wimco Nagar Metro,44942,81773,350,2320,35990,0,0,83602,9835,3750,13585,0,0,0,1366,539,1905,1378,732,2110,1374,30,175,2,0,14,51,847,1119
1,04/09/2022,01F1-Thiruvotriyur Metro,80012,83274,0,1736,34580,0,0,116328,1295,1145,2440,0,0,0,1590,914,2504,1533,731,2264,1505,45,151,7,0,13,45,856,1117
1,04/09/2022,01F3-Thiruvotriyur Theradi Metro,83420,111890,0,2304,40334,0,0,126058,1535,1260,2795,0,0,0,2022,1094,3116,2049,1161,3210,2218,34,488,4,0,28,64,1005,1623
1,04/09/2022,01F5-Kaladipet Metro,62446,80969,200,2600,38500,0,0,103746,1375,1180,2555,0,0,0,1408,1114,2522,1656,963,2619,1454,26,69,0,0,14,80,1031,1220
1,04/09/2022,01F7-Tollgate Metro,40871,43516,0,992,19214,0,0,61077,460,310,770,0,0,0,830,556,1386,872,412,1284,807,35,48,0,0,16,24,525,648
1,04/09/2022,01F9-New Washermenpet Metro,54468,71318,500,1448,32488,0,0,88904,4745,1115,5860,0,0,0,1435,1011,2446,1475,771,2246,1428,10,141,4,0,14,47,957,1173
1,04/09/2022,01FB-Tondiarpet Metro,56195,71185,150,1744,25624,0,0,83713,17475,1450,18925,0,1250,1250,1554,798,2352,1464,932,2396,1550,22,335,0,0,12,51,729,1149
1,04/09/2022,01FD-Thiagaraya College Metro,75864,97593,500,2648,44878,0,0,123890,4450,3480,7930,0,1000,1000,1934,1428,3362,1963,1061,3024,1973,56,211,1,0,10,83,1323,1684
1,04/09/2022,0101-Washermanpet,74059,97637,200,2720,48042,0,0,125021,9000,3970,12970,0,16250,16250,1705,1562,3267,1669,1293,2962,1809,24,377,2,0,24,105,1454,1986
1,04/09/2022,0103-Mannadi,56368,70766,100,888,26920,0,0,84276,9945,3410,13355,0,3000,3000,1557,907,2464,1342,1072,2414,1634,22,555,2,0,14,38,869,1500
1,04/09/2022,0105-High Court,51463,74756,200,1952,32540,0,0,86155,1225,445,1670,0,0,0,1623,1187,2810,1515,1097,2612,1675,20,406,2,0,3,74,1086,1591
1,04/09/2022,0109-Government Estate,50126,89152,120,2208,35638,0,0,88092,1560,3315,4875,0,0,0,1896,1304,3200,1700,1222,2922,2039,11,615,2,0,12,90,1146,1876
1,04/09/2022,0111-LIC,22983,54040,200,2120,27372,0,0,52675,1580,710,2290,0,0,0,934,975,1909,1110,676,1786,1022,13,67,8,0,7,87,854,1036
1,04/09/2022,0113-Thousand Lights,34231,73864,0,2160,35772,0,0,72163,185,80,265,0,0,0,1224,1038,2262,1657,945,2602,1465,12,60,0,0,7,87,1082,1248
1,04/09/2022,0115-AG-DMS,31635,46590,0,1456,19938,0,0,53029,0,0,0,0,1000,1000,873,677,1550,852,545,1397,960,13,211,0,0,1,56,587,868
1,04/09/2022,0117-Teynampet,20960,45668,0,1416,23394,0,0,45770,0,0,0,0,0,0,715,838,1553,1031,701,1732,889,17,22,3,0,7,56,752,857
1,04/09/2022,0119-Nandanam,24625,46437,0,1512,24216,0,0,50353,20,5,25,0,0,0,824,867,1691,1053,565,1618,911,19,31,5,0,12,63,787,917
1,04/09/2022,0121-Saidapet,21928,48803,0,1008,27150,0,0,50086,2680,855,3535,0,4000,4000,680,881,1561,964,780,1744,786,7,49,2,0,2,38,837,935
1,04/09/2022,0123-Little Mount,38073,59424,0,1600,24632,0,0,64305,8600,1620,10220,0,2250,2250,1273,863,2136,1207,673,1880,1288,10,251,1,0,16,60,765,1103
1,04/09/2022,0125-Guindy,76967,167030,760,7336,82504,0,0,167567,5230,2095,7325,0,500,500,2742,2589,5331,2732,2359,5091,2887,22,870,5,0,18,218,2368,3501
1,04/09/2022,0129-Nanganallur Road,12338,26384,100,496,13954,0,0,26888,1755,895,2650,0,0,0,350,427,777,567,363,930,432,7,21,3,0,3,17,403,454
1,04/09/2022,0131-Meenambakkam,61926,98843,100,2328,52796,0,0,117150,9485,5325,14810,0,0,0,1571,1408,2979,1420,1067,2487,1431,24,355,4,0,15,76,1333,1807
1,04/09/2022,0133-Chennai International Airport,123812,333404,850,10080,204538,0,0,339280,16545,3915,20460,0,0,0,3363,5528,8891,4611,4166,8777,3913,62,913,18,0,33,297,5011,6334
2,04/09/2022,0201-Puratchi Thalaivar Dr. M.G. Ramachandran Central,258444,403752,400,11856,135894,0,0,406594,15715,1365,17080,0,3950,3950,8919,4788,13707,5597,7325,12922,9399,89,5421,15,0,31,473,4110,10139
2,04/09/2022,0203-Egmore,66648,127003,470,3608,65204,0,0,135930,10225,3120,13345,0,3250,3250,2019,2142,4161,2309,2565,4874,2351,20,821,8,0,18,150,2074,3091
2,04/09/2022,0205-Nehru Park,19592,34736,0,840,15396,0,0,35828,2185,455,2640,0,0,0,737,528,1265,660,473,1133,741,3,229,0,0,5,35,514,786
2,04/09/2022,0207-Kilpauk,15196,27737,200,880,11752,0,0,28028,135,100,235,0,0,0,586,420,1006,602,389,991,612,6,107,0,0,6,40,373,532
2,04/09/2022,0209-Pachaiyappas College,19195,28916,0,416,11808,0,0,31419,630,540,1170,0,2000,2000,665,416,1081,650,342,992,656,6,134,0,0,1,16,394,551
2,04/09/2022,0211-Shenoy Nagar,24129,29957,450,1392,13914,0,0,39885,1010,330,1340,0,3000,3000,597,516,1113,610,424,1034,630,16,110,0,0,2,55,447,630
2,04/09/2022,0213-Anna Nagar East,54845,81759,20,2392,33888,0,0,91145,595,875,1470,0,0,0,1831,1121,2952,1844,973,2817,1848,24,313,1,0,23,90,1080,1531
2,04/09/2022,0215-Anna Nagar Tower,43982,66821,100,1544,27734,0,0,73360,2595,1750,4345,0,0,0,1404,952,2356,1419,839,2258,1479,12,355,0,0,4,62,858,1291
2,04/09/2022,0217-Thirumangalam,145679,215519,100,9384,95608,0,0,250771,93570,5885,99455,0,0,0,4036,3223,7259,3901,2726,6627,4283,72,1130,5,0,16,331,2834,4388
2,04/09/2022,0219-Koyambedu,104989,176329,0,5496,96678,0,0,207163,15265,3185,18450,2000,5750,7750,2926,3306,6232,2974,2224,5198,2903,32,835,12,0,22,203,2998,4102
2,04/09/2022,0221-Puratchi Thalaivi Dr. J. Jayalalithaa CMBT,78353,171743,400,3528,79566,0,0,161847,0,0,0,0,0,0,2741,2611,5352,3243,4082,7325,3313,30,1456,2,0,12,139,2440,4079
2,04/09/2022,0223-Arumbakkam,35434,49430,0,1448,29066,0,0,65948,930,235,1165,0,6000,6000,793,1035,1828,1009,728,1737,822,30,62,2,0,10,58,970,1132
2,04/09/2022,0225-Vadapalani,122251,198615,270,6000,73904,0,0,202425,39930,5010,44940,0,3000,3000,4177,2535,6712,3639,3134,6773,4518,50,1848,1,0,32,241,2244,4416
2,04/09/2022,0227-Ashok Nagar,68762,101157,0,3288,42668,0,0,114718,8895,2940,11835,0,6000,6000,2016,1472,3488,1971,1494,3465,2215,32,777,7,0,4,126,1315,2261
2,04/09/2022,0229-Ekkattuthangal,32222,52486,620,1880,22838,0,0,57560,0,0,0,0,0,0,1047,831,1878,1213,644,1857,1182,12,278,2,0,9,75,736,1112
2,04/09/2022,0231-Arignar Anna Alandur,103468,162328,400,4744,72526,0,0,181138,6815,2305,9120,0,250,250,2929,2268,5197,2651,1957,4608,3093,48,1099,10,0,24,161,1987,3329
2,04/09/2022,0233-St. Thomas Mount,44098,91316,200,4176,52128,0,0,100602,2600,2690,5290,0,500,500,1252,1711,2963,1677,1170,2847,1395,16,210,3,0,14,142,1520,1905
1,05/09/2022,01ED-Wimco Nagar Depot Metro,108788,83313,0,1488,31120,0,0,141396,310,260,570,0,3000,3000,1947,818,2765,1723,389,2112,1656,35,0,4,0,10,43,781,873
1,05/09/2022,01EF-Wimco Nagar Metro,163055,148235,1150,3784,37722,0,0,205711,19275,8205,27480,0,750,750,3533,1032,4565,3422,1132,4554,3425,39,159,3,0,17,103,899,1220
1,05/09/2022,01F1-Thiruvotriyur Metro,155317,117996,0,1416,29580,0,0,186313,1540,1525,3065,0,0,0,2936,804,3740,3088,766,3854,2947,41,0,0,0,8,44,750,843
1,05/09/2022,01F3-Thiruvotriyur Theradi Metro,140124,142966,500,1560,39988,0,0,182172,1575,3110,4685,0,0,0,3127,1149,4276,3505,1098,4603,3474,22,204,5,0,18,52,1073,1374
1,05/09/2022,01F5-Kaladipet Metro,149190,114080,0,1272,33430,0,0,183892,1130,2610,3740,0,0,0,3039,1027,4066,3124,808,3932,2985,42,0,0,0,9,47,974,1072
1,05/09/2022,01F7-Tollgate Metro,86287,60929,0,536,17322,0,0,104145,740,440,1180,0,0,0,1647,538,2185,1668,489,2157,1598,27,25,1,0,9,19,508,589
1,05/09/2022,01F9-New Washermenpet Metro,129877,107474,0,2056,30146,0,0,162079,1150,2120,3270,0,1000,1000,2901,1006,3907,3078,892,3970,3039,31,81,3,0,8,67,944,1134
1,05/09/2022,01FB-Tondiarpet Metro,136847,113747,2070,1616,33778,0,0,174311,3360,3785,7145,0,500,500,2832,1065,3897,3105,1061,4166,3072,42,87,1,0,12,59,1023,1224
1,05/09/2022,01FD-Thiagaraya College Metro,158271,138137,0,1272,45452,0,0,204995,6890,3375,10265,0,1250,1250,3777,1510,5287,3919,1199,5118,3810,42,86,1,0,3,44,1464,1640
1,05/09/2022,0101-Washermanpet,143631,133712,1756,2080,49858,0,0,197325,11315,5200,16515,0,12750,12750,3711,1716,5427,3451,1456,4907,3403,35,132,0,0,8,68,1642,1885
1,05/09/2022,0103-Mannadi,108347,124216,0,1496,40138,0,0,149981,5765,5825,11590,0,1500,1500,3168,1445,4613,3613,1176,4789,3531,22,87,2,0,5,60,1376,1552
1,05/09/2022,0105-High Court,191232,260548,600,3424,77622,0,0,272878,860,1785,2645,0,0,0,7274,2770,10044,7158,2195,9353,7440,51,525,0,0,7,133,2612,3328
1,05/09/2022,0109-Government Estate,110165,158127,916,1976,55920,0,0,168977,3150,3695,6845,0,2500,2500,3869,1953,5822,4333,1561,5894,4401,27,342,2,0,6,82,1791,2250
1,05/09/2022,0111-LIC,119428,174752,1960,3016,38296,0,0,162700,2105,595,2700,0,250,250,4966,1367,6333,5664,1155,6819,5506,24,2,0,0,2,91,1236,1355
1,05/09/2022,0113-Thousand Lights,224444,246916,1518,4504,29144,0,0,259610,755,375,1130,0,250,250,7792,1115,8907,8140,1566,9706,8624,49,697,0,0,7,184,948,1885
1,05/09/2022,0115-AG-DMS,156746,152955,100,2384,29774,0,0,189004,0,0,0,0,2500,2500,4717,1065,5782,4812,814,5626,4851,27,157,0,0,0,94,931,1209
1,05/09/2022,0117-Teynampet,130998,148055,1250,2176,27160,0,0,161584,0,0,0,0,2500,2500,4498,1015,5513,4952,1027,5979,4987,29,224,0,0,4,90,919,1266
1,05/09/2022,0119-Nandanam,127666,126906,1991,2864,33476,0,0,165997,55,0,55,0,2000,2000,3516,1271,4787,4218,963,5181,4006,54,0,0,0,9,115,1116,1294
1,05/09/2022,0121-Saidapet,49565,85554,1550,1488,29698,0,0,82301,2660,1415,4075,0,500,500,1881,1030,2911,2459,823,3282,2254,23,0,0,0,0,58,973,1054
1,05/09/2022,0123-Little Mount,121944,97146,1656,1408,26798,0,0,151806,5145,6460,11605,0,1250,1250,3265,1000,4265,2917,652,3569,2858,40,130,0,0,7,61,896,1134
1,05/09/2022,0125-Guindy,154025,286499,580,8648,94712,0,0,257965,10385,6915,17300,0,3000,3000,7634,3088,10722,7364,2438,9802,7468,60,570,4,0,14,271,2857,3776
1,05/09/2022,0129-Nanganallur Road,61082,52496,0,920,14404,0,0,76406,1010,5865,6875,0,0,0,1311,468,1779,1531,374,1905,1442,13,0,4,0,2,31,424,474
1,05/09/2022,0131-Meenambakkam,179142,162414,3344,2384,57620,0,0,242490,9625,15555,25180,0,0,0,4006,1589,5595,3570,1186,4756,3541,41,216,2,0,11,72,1508,1850
1,05/09/2022,0133-Chennai International Airport,206721,354111,0,8752,156118,0,0,371591,8545,12250,20795,0,3750,3750,5876,4289,10165,6553,3714,10267,6345,66,856,20,0,21,260,3893,5116
2,05/09/2022,0201-Puratchi Thalaivar Dr. M.G. Ramachandran Central,437703,516725,4950,15824,104698,0,0,563175,33345,4655,38000,0,9650,9650,16865,3621,20486,11001,7421,18422,16106,126,6175,23,0,22,601,3198,10145
2,05/09/2022,0203-Egmore,81005,140248,710,4168,66158,0,0,152041,12140,3565,15705,0,9000,9000,2702,2282,4984,3010,2466,5476,2913,18,545,6,0,12,162,2142,2885
2,05/09/2022,0205-Nehru Park,58898,50074,0,1096,18996,0,0,78990,3645,2420,6065,0,6500,6500,1329,694,2023,1334,494,1828,1307,11,94,0,0,0,44,652,801
2,05/09/2022,0207-Kilpauk,45155,58389,600,992,18412,0,0,65159,350,250,600,0,250,250,1518,678,2196,1671,613,2284,1619,15,110,0,0,2,34,632,793
2,05/09/2022,0209-Pachaiyappas College,64917,54907,750,704,17082,0,0,83453,1420,1370,2790,0,8000,8000,1632,640,2272,1667,523,2190,1618,23,95,2,0,3,30,600,753
2,05/09/2022,0211-Shenoy Nagar,52683,48971,900,840,15484,0,0,69907,1300,1560,2860,0,4000,4000,1295,549,1844,1433,511,1944,1382,15,62,0,0,2,26,520,625
2,05/09/2022,0213-Anna Nagar East,137601,116557,1310,2024,32092,0,0,173027,1365,3760,5125,0,3000,3000,3202,1161,4363,3373,975,4348,3363,32,204,4,1,2,70,1080,1393
2,05/09/2022,0215-Anna Nagar Tower,118720,113176,0,1400,32520,0,0,152640,2915,8880,11795,0,1000,1000,2909,1111,4020,3186,929,4115,3138,23,214,2,0,3,57,1057,1356
2,05/09/2022,0217-Thirumangalam,324178,328160,1400,7352,96748,0,0,429678,76295,24435,100730,0,1500,1500,8367,3241,11608,8911,2804,11715,8718,88,595,1,0,12,210,2960,3866
2,05/09/2022,0219-Koyambedu,231756,261801,0,5720,99294,0,0,336770,18165,9765,27930,500,16250,16750,6317,3375,9692,5840,2276,8116,5946,64,847,1,0,13,218,3098,4241
2,05/09/2022,0221-Puratchi Thalaivi Dr. J. Jayalalithaa CMBT,135329,216903,600,4680,76112,0,0,216721,0,0,0,0,0,0,4458,2596,7054,4219,4355,8574,5078,36,2032,5,0,7,170,2337,4587
2,05/09/2022,0223-Arumbakkam,79680,70388,500,2536,30322,0,0,113038,1655,420,2075,0,5500,5500,1613,1075,2688,1787,741,2528,1636,47,3,2,0,7,45,1013,1117
2,05/09/2022,0225-Vadapalani,196171,233075,200,4744,66496,0,0,267611,22160,4040,26200,0,5500,5500,5774,2258,8032,5326,2696,8022,6169,54,1597,2,0,11,172,2032,3868
2,05/09/2022,0227-Ashok Nagar,118944,152816,1900,2936,52556,0,0,176336,8860,6740,15600,0,9500,9500,3692,1800,5492,3986,1514,5500,3890,34,384,6,0,1,100,1610,2135
2,05/09/2022,0229-Ekkattuthangal,110694,138565,2050,3512,36414,0,0,152670,495,2480,2975,0,1500,1500,3639,1337,4976,4160,1157,5317,4095,37,261,0,0,2,118,1144,1562
2,05/09/2022,0231-Arignar Anna Alandur,187773,215648,0,4656,76920,0,0,269349,12770,10955,23725,0,7250,7250,5365,2572,7937,5272,1788,7060,5342,66,493,1,0,5,178,2302,3045
2,05/09/2022,0233-St. Thomas Mount,118388,114254,20,4032,42418,0,0,164858,2160,3055,5215,1000,7000,8000,2766,1394,4160,2870,954,3824,2750,34,185,1,0,0,94,1256,1570
1,06/09/2022,01ED-Wimco Nagar Depot Metro,89849,82102,200,1400,29622,0,0,121071,775,335,1110,0,4750,4750,2014,773,2787,1724,349,2073,1643,27,1,2,0,12,43,729,814
1,06/09/2022,01EF-Wimco Nagar Metro,140728,142485,4500,2960,32652,0,0,180840,16565,6630,23195,0,750,750,3528,874,4402,3307,972,4279,3390,45,259,1,0,4,77,795,1181
1,06/09/2022,01F1-Thiruvotriyur Metro,144460,107777,200,1672,25780,0,0,172112,1095,1475,2570,0,0,0,2987,727,3714,2816,532,3348,2723,75,0,4,0,8,51,673,811
1,06/09/2022,01F3-Thiruvotriyur Theradi Metro,114938,127188,3966,1664,32304,0,0,152872,1265,2745,4010,0,0,0,3072,934,4006,3308,924,4232,3247,26,194,3,0,14,53,865,1155
1,06/09/2022,01F5-Kaladipet Metro,121427,110051,300,1664,31436,0,0,154827,1115,2220,3335,0,0,0,3012,951,3963,3105,712,3817,2943,21,1,0,0,4,50,902,978
1,06/09/2022,01F7-Tollgate Metro,70309,62747,200,888,13046,0,0,84443,40,150,190,0,0,0,1755,439,2194,1708,400,2108,1768,31,148,0,0,4,30,407,620
1,06/09/2022,01F9-New Washermenpet Metro,112050,108866,970,1456,33278,0,0,147754,1430,2045,3475,0,250,250,3024,1092,4116,3104,697,3801,3000,38,48,2,0,9,47,1044,1188
1,06/09/2022,01FB-Tondiarpet Metro,104394,107532,1294,1608,32096,0,0,139392,10785,3555,14340,0,250,250,2886,1010,3896,3122,830,3952,2961,32,5,1,0,8,55,966,1067
1,06/09/2022,01FD-Thiagaraya College Metro,127501,128519,2048,2256,35626,0,0,167431,4020,4020,8040,0,1500,1500,3800,1229,5029,3840,948,4788,3784,67,74,1,0,3,71,1154,1370
1,06/09/2022,0101-Washermanpet,122599,130321,1100,1800,41030,0,0,166529,7795,4640,12435,0,13500,13500,3861,1396,5257,3579,1219,4798,3636,26,292,1,0,12,68,1319,1718
1,06/09/2022,0103-Mannadi,106028,117860,870,3536,32768,0,0,143202,10770,7970,18740,0,0,0,3316,1102,4418,3533,986,4519,3545,23,146,1,0,2,47,1044,1263
1,06/09/2022,0105-High Court,172395,256795,1300,2848,76790,0,0,253333,1675,1995,3670,0,0,0,7134,2661,9795,7209,2006,9215,7352,47,324,9,0,1,115,2522,3018
1,06/09/2022,0109-Government Estate,101712,146277,950,2080,50546,0,0,155288,4050,3320,7370,0,1000,1000,3741,1814,5555,4273,1322,5595,4228,26,173,1,0,8,93,1665,1966
1,06/09/2022,0111-LIC,107826,173206,900,2392,29840,0,0,140958,2945,620,3565,0,1000,1000,5022,1080,6102,5876,871,6747,5771,24,2,0,0,1,95,958,1080
1,06/09/2022,0113-Thousand Lights,191842,239078,1870,4216,36374,0,0,234302,490,425,915,0,0,0,7305,1387,8692,7995,1213,9208,8115,44,238,0,0,4,183,1157,1626
1,06/09/2022,0115-AG-DMS,144070,153746,700,2784,28144,0,0,175698,0,0,0,0,2250,2250,4845,1005,5850,4805,735,5540,4961,43,217,0,0,0,114,865,1239
1,06/09/2022,0117-Teynampet,116866,147248,4300,1840,25936,0,0,148942,0,0,0,0,2000,2000,4625,961,5586,5053,865,5918,5044,30,137,4,0,3,79,864,1117
1,06/09/2022,0119-Nandanam,111951,127904,4100,2776,31716,0,0,150543,0,0,0,0,2500,2500,3675,1171,4846,4214,891,5105,4109,57,1,0,0,9,102,1053,1222
1,06/09/2022,0121-Saidapet,59486,82134,100,1272,25814,0,0,86672,2565,1465,4030,0,6250,6250,1949,880,2829,2392,740,3132,2270,22,0,0,0,0,52,830,904
1,06/09/2022,0123-Little Mount,112441,94492,1800,1824,23206,0,0,139271,3600,6635,10235,0,500,500,3325,901,4226,2855,607,3462,2892,35,197,1,0,8,76,801,1118
1,06/09/2022,0125-Guindy,151932,266106,5550,7232,72694,0,0,237408,6720,5270,11990,0,1500,1500,7829,2381,10210,7189,2163,9352,7568,33,719,2,0,13,246,2242,3255
1,06/09/2022,0129-Nanganallur Road,62200,50176,600,520,12626,0,0,75946,1250,6305,7555,0,0,0,1336,400,1736,1527,322,1849,1443,5,0,0,0,1,18,368,392
1,06/09/2022,0131-Meenambakkam,155597,153864,358,2832,42298,0,0,201085,9260,18465,27725,0,0,0,4234,1216,5450,3528,1055,4583,3751,38,347,2,0,6,84,1131,1608
1,06/09/2022,0133-Chennai International Airport,194952,335285,3650,7408,138382,0,0,344392,9065,12225,21290,0,3750,3750,5912,3784,9696,6384,3523,9907,6328,74,873,23,0,22,212,3476,4680
2,06/09/2022,0201-Puratchi Thalaivar Dr. M.G. Ramachandran Central,371643,485974,7170,10512,96450,0,0,485775,20165,2650,22815,0,5450,5450,15490,3441,18931,11421,7094,18515,15471,115,5196,12,0,19,436,3049,8827
2,06/09/2022,0203-Egmore,84369,141476,301,3616,62772,0,0,151058,11640,3545,15185,0,6750,6750,2640,2228,4868,3148,2594,5742,3092,27,651,4,0,11,141,2086,2920
2,06/09/2022,0205-Nehru Park,56229,50884,0,824,15572,0,0,72625,1085,2445,3530,0,7000,7000,1483,590,2073,1460,438,1898,1446,14,108,0,0,6,31,548,707
2,06/09/2022,0207-Kilpauk,48630,57888,1650,896,17530,0,0,68706,370,270,640,0,0,0,1543,626,2169,1629,536,2165,1608,10,86,0,0,1,35,583,715
2,06/09/2022,0209-Pachaiyappas College,54845,57278,1100,1008,17772,0,0,74725,900,840,1740,0,7000,7000,1773,678,2451,1682,448,2130,1670,16,71,1,0,1,43,628,760
2,06/09/2022,0211-Shenoy Nagar,37672,47572,24,1024,12568,0,0,51288,2060,3420,5480,0,250,250,1310,466,1776,1446,420,1866,1426,15,66,0,0,2,35,422,540
2,06/09/2022,0213-Anna Nagar East,103932,111713,700,2120,28056,0,0,134808,1395,4305,5700,0,0,0,3172,1039,4211,3278,836,4114,3302,20,202,0,0,2,65,963,1252
2,06/09/2022,0215-Anna Nagar Tower,102511,106276,2208,1496,24064,0,0,130279,2450,10180,12630,0,750,750,3048,861,3909,3074,728,3802,3135,23,269,1,0,2,53,793,1141
2,06/09/2022,0217-Thirumangalam,289920,312012,5750,7120,83148,0,0,385938,58785,20485,79270,0,0,0,8404,2796,11200,8567,2395,10962,8621,61,661,4,0,8,203,2543,3480
2,06/09/2022,0219-Koyambedu,205662,252053,2950,4240,93902,0,0,306754,13955,9385,23340,0,9750,9750,6084,3183,9267,5739,2173,7912,5790,56,678,11,0,5,171,2966,3887
2,06/09/2022,0221-Puratchi Thalaivi Dr. J. Jayalalithaa CMBT,112218,199514,150,3184,55154,0,0,170706,0,0,0,0,0,0,3968,1848,5816,4730,4549,9279,5277,31,1846,4,0,4,132,1680,3697
2,06/09/2022,0223-Arumbakkam,76005,69572,0,1896,28436,0,0,106337,1255,445,1700,0,7750,7750,1727,1032,2759,1901,688,2589,1664,45,3,1,0,9,46,962,1066
2,06/09/2022,0225-Vadapalani,152083,214598,1000,4216,82460,0,0,239759,19790,4890,24680,0,9000,9000,4802,2703,7505,5149,2279,7428,5060,59,580,3,0,8,165,2537,3352
2,06/09/2022,0227-Ashok Nagar,107791,146738,2072,4088,43576,0,0,157527,8195,6260,14455,0,3000,3000,3849,1541,5390,3744,1253,4997,3954,37,509,1,0,2,144,1347,2040
2,06/09/2022,0229-Ekkattuthangal,111688,139136,970,2792,34766,0,0,150216,860,4150,5010,0,2000,2000,3886,1237,5123,4138,969,5107,4173,40,278,0,0,5,115,1072,1510
2,06/09/2022,0231-Arignar Anna Alandur,181927,214108,4700,5416,69172,0,0,261215,7565,6950,14515,0,4500,4500,5700,2295,7995,5353,1672,7025,5581,82,565,3,0,9,165,2053,2877
2,06/09/2022,0233-St. Thomas Mount,108320,109510,2300,2464,30098,0,0,143182,3915,3300,7215,0,11250,11250,3022,993,4015,2965,792,3757,3021,30,348,1,0,2,97,912,1390
1,07/09/2022,01ED-Wimco Nagar Depot Metro,72534,82784,0,1496,29476,0,0,103506,180,220,400,0,2500,2500,2005,748,2753,1796,385,2181,1703,21,0,1,0,14,39,706,781
1,07/09/2022,01EF-Wimco Nagar Metro,130505,152164,400,3232,37230,0,0,171367,15045,6335,21380,0,1000,1000,3609,1001,4610,3524,1049,4573,3561,81,213,2,1,13,101,891,1302
1,07/09/2022,01F1-Thiruvotriyur Metro,147385,120664,1070,2088,33122,0,0,183665,695,1365,2060,0,0,0,3111,909,4020,3009,673,3682,2905,43,0,2,0,16,66,845,972
1,07/09/2022,01F3-Thiruvotriyur Theradi Metro,110485,148729,0,2320,48134,0,0,160939,1105,2855,3960,0,0,0,3130,1372,4502,3563,1133,4696,3418,31,110,1,0,20,75,1276,1513
1,07/09/2022,01F5-Kaladipet Metro,118883,125807,1150,2352,40824,0,0,163209,1390,2455,3845,0,0,0,3189,1191,4380,3301,881,4182,3142,37,0,1,0,10,79,1131,1258
1,07/09/2022,01F7-Tollgate Metro,90400,67904,954,1024,2774,0,0,95152,490,245,735,0,0,0,2310,113,2423,1794,517,2311,2240,44,563,0,0,9,35,75,726
1,07/09/2022,01F9-New Washermenpet Metro,108795,110762,400,1464,34304,0,0,144963,1185,1680,2865,0,0,0,2984,1120,4104,3072,927,3999,3013,17,82,1,0,11,50,1056,1217
1,07/09/2022,01FB-Tondiarpet Metro,100237,111012,500,2280,35404,0,0,138421,3770,3105,6875,0,1000,1000,2705,1129,3834,3073,976,4049,2942,26,0,1,0,12,82,1038,1159
1,07/09/2022,01FD-Thiagaraya College Metro,129820,152249,820,2568,50942,0,0,184150,4380,3855,8235,0,500,500,3983,1662,5645,4158,1235,5393,4056,91,72,1,0,11,88,1588,1851
1,07/09/2022,0101-Washermanpet,113231,134855,650,2368,47006,0,0,163255,6995,4365,11360,0,14500,14500,3783,1612,5395,3567,1342,4909,3543,26,204,0,0,11,95,1509,1845
1,07/09/2022,0103-Mannadi,96357,117515,1150,1624,35810,0,0,134941,9670,8980,18650,0,1500,1500,3136,1214,4350,3506,1078,4584,3430,17,82,1,0,4,57,1155,1316
1,07/09/2022,0105-High Court,139583,232695,600,2240,70624,0,0,213047,885,1760,2645,0,0,0,6571,2486,9057,6661,1819,8480,6677,43,220,0,0,4,93,2365,2725
1,07/09/2022,0109-Government Estate,91954,142598,1500,2328,51762,0,0,147544,3780,2595,6375,0,3250,3250,3657,1767,5424,4291,1288,5579,4050,25,90,1,0,2,98,1701,1917
1,07/09/2022,0111-LIC,100966,173275,1600,1616,35934,0,0,140116,1595,510,2105,0,250,250,4889,1251,6140,5691,848,6539,5527,24,3,0,0,4,69,1146,1246
1,07/09/2022,0113-Thousand Lights,180307,240639,2312,5120,28402,0,0,216141,850,530,1380,0,3000,3000,7828,1149,8977,7853,1295,9148,8413,43,733,3,0,3,211,874,1867
1,07/09/2022,0115-AG-DMS,110881,152542,3500,2624,34784,0,0,151789,0,0,0,0,250,250,4734,1195,5929,4612,844,5456,4668,32,175,0,0,0,102,1056,1365
1,07/09/2022,0117-Teynampet,106495,148902,1865,2032,35684,0,0,146076,0,0,0,0,4000,4000,4399,1302,5701,4909,966,5875,4720,27,0,1,0,3,86,1191,1308
1,07/09/2022,0119-Nandanam,105635,124877,1724,2208,31808,0,0,141375,20,0,20,0,750,750,3725,1177,4902,4162,819,4981,3995,52,1,0,0,8,96,1053,1210
1,07/09/2022,0121-Saidapet,57960,86216,450,1752,30254,0,0,90416,2050,1705,3755,0,6250,6250,1940,1049,2989,2378,775,3153,2246,17,0,0,0,1,73,961,1052
1,07/09/2022,0123-Little Mount,84316,100329,540,2008,29912,0,0,116776,2890,5180,8070,0,1000,1000,3357,1075,4432,2793,645,3438,2839,36,210,2,0,5,83,958,1294
1,07/09/2022,0125-Guindy,184736,279042,3780,6960,55928,0,0,251404,7230,4580,11810,0,5000,5000,8664,2001,10665,7080,2446,9526,8473,44,1785,4,0,9,259,1657,3758
1,07/09/2022,0129-Nanganallur Road,50715,54160,1600,656,16014,0,0,68985,1205,6185,7390,0,0,0,1345,489,1834,1569,321,1890,1456,7,0,0,0,6,24,459,496
1,07/09/2022,0131-Meenambakkam,133629,158226,2100,4408,52918,0,0,193055,8780,17275,26055,0,0,0,4112,1535,5647,3482,1180,4662,3572,33,239,2,0,5,100,1414,1793
1,07/09/2022,0133-Chennai International Airport,162133,360536,2601,10632,169552,0,0,344918,10135,11945,22080,0,1500,1500,5535,4665,10200,6502,3736,10238,6145,57,635,13,0,23,290,4059,5077
2,07/09/2022,0201-Puratchi Thalaivar Dr. M.G. Ramachandran Central,418204,513735,3110,11104,60484,0,0,492902,14325,3230,17555,0,6350,6350,17341,2433,19774,11813,8106,19919,17649,115,7043,9,0,36,455,1828,9486
2,07/09/2022,0203-Egmore,78353,150478,4145,2240,75868,0,0,160606,9770,3335,13105,0,12500,12500,2478,2455,4933,3373,2957,6330,2997,22,407,1,0,17,94,2472,3013
2,07/09/2022,0205-Nehru Park,50316,49724,1400,768,17626,0,0,70110,1720,1965,3685,0,0,0,1406,629,2035,1386,481,1867,1351,12,81,0,0,2,30,601,726
2,07/09/2022,0207-Kilpauk,44041,62325,800,1320,20970,0,0,67131,445,245,690,0,250,250,1683,754,2437,1689,557,2246,1680,15,83,0,0,3,53,689,843
2,07/09/2022,0209-Pachaiyappas College,52825,57480,1720,728,16786,0,0,72059,1360,680,2040,0,8000,8000,1877,631,2508,1725,521,2246,1707,14,110,1,0,4,31,591,751
2,07/09/2022,0211-Shenoy Nagar,53975,50204,200,824,14478,0,0,69477,1130,1470,2600,0,4500,4500,1322,511,1833,1491,476,1967,1451,14,79,0,0,1,23,482,599
2,07/09/2022,0213-Anna Nagar East,88283,111070,3550,2560,29074,0,0,123467,1410,3775,5185,0,0,0,3145,1112,4257,3211,941,4152,3224,19,208,1,0,1,90,1008,1327
2,07/09/2022,0215-Anna Nagar Tower,94530,108386,798,1336,28864,0,0,125528,2595,6845,9440,0,750,750,2958,1019,3977,3129,795,3924,3060,14,235,2,0,2,57,953,1263
2,07/09/2022,0217-Thirumangalam,292493,327315,4604,8208,82968,0,0,388273,57080,21370,78450,0,1500,1500,8837,2871,11708,8638,2769,11407,9074,68,1068,7,0,8,281,2542,3974
2,07/09/2022,0219-Koyambedu,199941,260184,400,5184,94286,0,0,299811,12885,12435,25320,0,15500,15500,6254,3191,9445,5937,2185,8122,6019,41,830,2,1,25,205,2946,4050
2,07/09/2022,0221-Puratchi Thalaivi Dr. J. Jayalalithaa CMBT,71866,217337,1000,2832,106434,0,0,182132,0,0,0,0,0,0,2763,3416,6179,5459,5179,10638,4315,30,522,0,0,6,123,3240,3921
2,07/09/2022,0223-Arumbakkam,63850,77328,0,1192,32922,0,0,97964,1175,445,1620,0,5000,5000,1741,1148,2889,1980,832,2812,1753,47,0,2,0,10,46,1076,1181
2,07/09/2022,0225-Vadapalani,146356,235687,1200,4864,88868,0,0,241288,18330,3980,22310,0,4000,4000,5212,2990,8202,5422,2640,8062,5536,54,752,2,0,8,184,2767,3767
2,07/09/2022,0227-Ashok Nagar,112868,155602,1460,3560,54494,0,0,172382,6680,9870,16550,0,6000,6000,3738,1831,5569,3838,1492,5330,3881,47,465,2,0,6,107,1674,2301
2,07/09/2022,0229-Ekkattuthangal,88297,143184,20,3328,40508,0,0,132153,2185,5355,7540,0,500,500,3937,1454,5391,4026,1006,5032,4123,24,311,0,0,6,135,1259,1735
2,07/09/2022,0231-Arignar Anna Alandur,161500,227412,1702,5088,82392,0,0,250682,7190,5820,13010,0,2750,2750,5566,2732,8298,5431,1942,7373,5575,55,569,1,0,6,191,2447,3269
2,07/09/2022,0233-St. Thomas Mount,94066,119888,1420,3200,41462,0,0,140148,2250,3690,5940,0,8250,8250,2971,1408,4379,2839,1044,3883,2980,21,254,4,0,0,112,1241,1632
1,08/09/2022,01ED-Wimco Nagar Depot Metro,72616,73574,0,1136,29192,0,0,102944,75,215,290,0,3500,3500,1565,729,2294,1513,436,1949,1387,13,2,1,0,13,33,691,753
1,08/09/2022,01EF-Wimco Nagar Metro,115936,120194,1000,3096,36976,0,0,157008,16140,5835,21975,0,0,0,2727,950,3677,2649,866,3515,2569,43,99,1,0,13,90,874,1120
1,08/09/2022,01F1-Thiruvotriyur Metro,105382,105936,800,1152,35450,0,0,142784,1370,1555,2925,0,0,0,2507,938,3445,2460,673,3133,2287,40,1,2,0,21,37,901,1002
1,08/09/2022,01F3-Thiruvotriyur Theradi Metro,111398,129461,500,2536,36310,0,0,150744,1130,2755,3885,0,0,0,2835,1016,3851,2968,1052,4020,3061,37,361,0,0,13,68,933,1412
1,08/09/2022,01F5-Kaladipet Metro,106265,103960,100,1624,36016,0,0,144005,1040,2460,3500,0,0,0,2541,1053,3594,2720,801,3521,2470,31,1,1,0,19,56,996,1104
1,08/09/2022,01F7-Tollgate Metro,74934,57925,600,968,13944,0,0,90446,110,385,495,0,0,0,1535,449,1984,1461,472,1933,1504,38,207,0,1,11,30,415,702
1,08/09/2022,01F9-New Washermenpet Metro,86526,87020,0,1016,30522,0,0,118064,1045,1460,2505,0,1000,1000,2220,924,3144,2350,646,2996,2183,17,42,2,0,9,38,893,1001
1,08/09/2022,01FB-Tondiarpet Metro,87658,96655,200,1600,37598,0,0,127056,2550,2795,5345,0,250,250,2234,1141,3375,2486,930,3416,2242,26,2,0,0,16,58,1089,1191
1,08/09/2022,01FD-Thiagaraya College Metro,102017,122142,600,2336,45778,0,0,150731,7910,3920,11830,0,1250,1250,3029,1455,4484,3153,1047,4200,3010,61,118,2,0,10,85,1360,1636
1,08/09/2022,0101-Washermanpet,88241,106897,1200,1496,45792,0,0,136729,13630,3395,17025,0,10500,10500,2642,1526,4168,2568,1210,3778,2475,19,113,2,0,9,56,1459,1658
1,08/09/2022,0103-Mannadi,72606,96480,214,672,35816,0,0,109308,9400,10860,20260,0,0,0,2353,1176,3529,2645,994,3639,2512,21,100,1,0,6,29,1142,1299
1,08/09/2022,0105-High Court,122254,202022,525,2808,63134,0,0,188721,1080,2490,3570,0,0,0,5345,2182,7527,5659,1598,7257,5637,33,199,0,0,6,106,2043,2387
1,08/09/2022,0109-Government Estate,81011,120892,350,2056,45180,0,0,128597,2675,2750,5425,0,0,0,3076,1593,4669,3566,1165,4731,3383,20,154,11,0,6,72,1470,1733
1,08/09/2022,0111-LIC,69455,122839,100,1640,31882,0,0,103077,2420,450,2870,0,0,0,3124,1089,4213,3842,715,4557,3686,21,0,1,0,10,71,987,1090
1,08/09/2022,0113-Thousand Lights,144539,203911,1735,4648,31144,0,0,182066,645,545,1190,0,500,500,6189,1217,7406,6683,1212,7895,6818,34,376,2,0,4,192,988,1596
1,08/09/2022,0115-AG-DMS,96973,103602,600,2040,25444,0,0,125057,0,0,0,0,1000,1000,2944,868,3812,3063,590,3653,3045,21,143,3,0,4,76,774,1021
1,08/09/2022,0117-Teynampet,83911,107266,2200,1584,28096,0,0,115791,0,0,0,0,0,0,2898,1011,3909,3579,751,4330,3346,19,0,1,0,4,68,916,1008
1,08/09/2022,0119-Nandanam,68632,108886,3076,2200,25560,0,0,99468,95,0,95,0,0,0,3136,958,4094,3483,738,4221,3505,24,197,0,0,10,91,817,1139
1,08/09/2022,0121-Saidapet,47150,62376,1000,1544,24218,0,0,73912,2440,1910,4350,0,2000,2000,1448,813,2261,1693,635,2328,1528,20,0,1,0,6,57,755,839
1,08/09/2022,0123-Little Mount,81091,81621,300,1712,23898,0,0,107001,5185,5300,10485,250,1250,1500,2584,893,3477,2275,586,2861,2306,28,193,0,0,5,71,798,1095
1,08/09/2022,0125-Guindy,150828,241011,5380,6384,55324,0,0,217916,7605,4670,12275,0,0,0,7060,1940,9000,5819,2089,7908,6937,33,1502,2,0,14,213,1626,3390
1,08/09/2022,0129-Nanganallur Road,56723,46730,500,1048,13470,0,0,71741,1480,5420,6900,0,0,0,1121,436,1557,1341,342,1683,1259,15,0,1,0,3,28,392,439
1,08/09/2022,0131-Meenambakkam,114971,130045,1170,3760,47430,0,0,167331,8060,13750,21810,0,0,0,3234,1332,4566,2713,911,3624,2797,22,255,7,0,5,77,1249,1615
1,08/09/2022,0133-Chennai International Airport,234835,343090,3500,9040,103658,0,0,351033,11100,12165,23265,0,750,750,6724,2951,9675,5883,3888,9771,7170,82,2451,15,0,23,271,2520,5362
2,08/09/2022,0201-Puratchi Thalaivar Dr. M.G. Ramachandran Central,356570,427862,4200,10696,52300,0,0,423766,18935,1760,20695,0,8450,8450,14087,2113,16200,9149,6806,15955,14261,73,6629,7,0,29,396,1604,8738
2,08/09/2022,0203-Egmore,70228,130154,1550,3112,61054,0,0,135944,11995,3735,15730,0,6250,6250,2207,2090,4297,2950,2633,5583,2724,22,627,14,0,13,113,2002,2791
2,08/09/2022,0205-Nehru Park,35970,40398,0,800,12902,0,0,49672,1960,2810,4770,0,2000,2000,1146,483,1629,1069,384,1453,1111,12,157,0,0,0,33,450,652
2,08/09/2022,0207-Kilpauk,29728,48863,1400,808,15832,0,0,47768,430,400,830,0,250,250,1239,558,1797,1299,461,1760,1281,16,120,4,0,6,31,520,697
2,08/09/2022,0209-Pachaiyappas College,42325,41352,500,680,14412,0,0,57917,2640,610,3250,0,4000,4000,1161,513,1674,1164,372,1536,1116,11,72,1,0,0,28,479,591
2,08/09/2022,0211-Shenoy Nagar,31959,39676,124,584,13432,0,0,46099,870,1490,2360,0,0,0,1048,478,1526,1122,357,1479,1060,10,66,0,0,1,22,448,547
2,08/09/2022,0213-Anna Nagar East,82236,96904,120,1328,29298,0,0,112982,2040,3175,5215,0,9000,9000,2597,1017,3614,2743,766,3509,2678,21,189,0,0,6,52,933,1201
2,08/09/2022,0215-Anna Nagar Tower,68546,86314,1368,1760,25188,0,0,96862,2175,8545,10720,0,250,250,2195,886,3081,2397,712,3109,2369,13,205,0,0,5,69,803,1095
2,08/09/2022,0217-Thirumangalam,237741,278251,4580,6256,93662,0,0,342239,70550,16875,87425,0,0,0,6805,3072,9877,7141,2347,9488,6884,65,629,3,0,11,220,2797,3725
2,08/09/2022,0219-Koyambedu,174875,206407,2750,5152,74644,0,0,257421,11000,8370,19370,2000,14000,16000,4830,2478,7308,4376,1919,6295,4683,45,1071,6,0,22,164,2297,3605
2,08/09/2022,0221-Puratchi Thalaivi Dr. J. Jayalalithaa CMBT,62847,191654,1310,3112,98538,0,0,165807,0,0,0,0,0,0,2465,3134,5599,4661,3977,8638,3504,34,549,6,0,7,122,2961,3679
2,08/09/2022,0223-Arumbakkam,43208,65432,50,1024,27502,0,0,71784,2235,210,2445,0,2000,2000,1481,966,2447,1750,645,2395,1475,32,0,0,0,19,43,909,1003
2,08/09/2022,0225-Vadapalani,135275,209744,560,4968,76748,0,0,217551,20760,4690,25450,0,6000,6000,4660,2569,7229,4546,2405,6951,4926,45,1205,3,0,23,186,2319,3781
2,08/09/2022,0227-Ashok Nagar,111109,135266,2300,3664,37836,0,0,154909,8850,4970,13820,0,6000,6000,3533,1244,4777,3327,1269,4596,3634,37,802,8,0,6,91,1139,2083
2,08/09/2022,0229-Ekkattuthangal,90261,119700,1500,3680,31592,0,0,127033,1785,5735,7520,0,250,250,3257,1171,4428,3384,827,4211,3494,18,299,0,0,3,138,962,1420
2,08/09/2022,0231-Arignar Anna Alandur,151268,193040,940,4072,74092,0,0,230372,9030,7020,16050,0,3000,3000,4560,2416,6976,4436,1758,6194,4475,54,510,2,0,16,151,2181,2914
2,08/09/2022,0233-St. Thomas Mount,67572,105430,1900,2560,41490,0,0,113522,1990,1925,3915,0,5000,5000,2408,1355,3763,2437,1004,3441,2416,23,236,9,0,7,92,1228,1595
1,09/09/2022,01ED-Wimco Nagar Depot Metro,74265,81420,0,2088,30040,0,0,106393,135,240,375,0,250,250,1864,783,2647,1745,411,2156,1605,13,2,2,0,8,51,732,808
1,09/09/2022,01EF-Wimco Nagar Metro,134062,142331,700,2496,39380,0,0,176638,19475,6835,26310,0,3250,3250,3349,1021,4370,3356,930,4286,3188,63,110,1,0,16,62,946,1198
1,09/09/2022,01F1-Thiruvotriyur Metro,116672,116346,700,1312,30410,0,0,149094,1295,1675,2970,0,0,0,2936,822,3758,2992,664,3656,2836,54,0,1,0,16,37,788,896
1,09/09/2022,01F3-Thiruvotriyur Theradi Metro,108132,150357,700,3160,46154,0,0,158146,1770,2840,4610,0,0,0,3250,1323,4573,3467,1176,4643,3503,24,257,13,0,7,95,1213,1609
1,09/09/2022,01F5-Kaladipet Metro,105410,115875,1225,1368,34202,0,0,142205,1330,2810,4140,0,0,0,3075,1002,4077,3213,776,3989,3015,18,15,0,0,11,43,970,1057
1,09/09/2022,01F7-Tollgate Metro,72065,71175,850,928,12446,0,0,86289,195,145,340,0,0,0,2091,406,2497,1870,499,2369,2050,33,328,0,0,15,31,366,773
1,09/09/2022,01F9-New Washermenpet Metro,103337,114082,300,1144,36314,0,0,141095,1370,2325,3695,0,250,250,3036,1154,4190,3187,891,4078,3040,23,78,2,0,18,44,1108,1273
1,09/09/2022,01FB-Tondiarpet Metro,90769,110632,700,1408,31650,0,0,124527,5865,3265,9130,0,500,500,2964,1015,3979,3124,948,4072,3068,25,171,2,0,6,52,957,1213
1,09/09/2022,01FD-Thiagaraya College Metro,123827,141414,508,2808,43898,0,0,171041,6810,3185,9995,0,500,500,3983,1502,5485,4018,1146,5164,3934,68,104,1,0,6,98,1409,1686
1,09/09/2022,0101-Washermanpet,91396,135000,2200,2368,53364,0,0,149328,8375,4300,12675,0,7000,7000,3516,1821,5337,3434,1331,4765,3357,22,156,0,0,9,94,1712,1993
1,09/09/2022,0103-Mannadi,84728,112482,0,1192,34356,0,0,120276,16805,6215,23020,0,0,0,2966,1158,4124,3377,1050,4427,3291,22,89,1,0,0,51,1105,1268
1,09/09/2022,0105-High Court,141159,233736,600,2688,65554,0,0,210001,1380,1520,2900,0,0,0,6824,2301,9125,6486,1870,8356,6824,31,571,7,0,12,116,2151,2888
1,09/09/2022,0109-Government Estate,99034,144021,400,2104,43362,0,0,144900,3550,3090,6640,0,4000,4000,3813,1564,5377,4186,1401,5587,4330,29,437,1,0,10,73,1434,1984
1,09/09/2022,0111-LIC,91377,174465,3400,2224,27896,0,0,124897,930,610,1540,0,0,0,5201,1033,6234,5458,1074,6532,5778,21,466,4,0,5,90,892,1478
1,09/09/2022,0113-Thousand Lights,139351,236567,1400,5304,43912,0,0,189967,755,430,1185,0,1000,1000,6911,1624,8535,7619,1401,9020,7714,36,304,0,0,6,203,1338,1887
1,09/09/2022,0115-AG-DMS,110456,142678,700,1888,29532,0,0,142576,0,0,0,0,1000,1000,4375,995,5370,4383,765,5148,4441,22,228,0,0,2,74,887,1213
1,09/09/2022,0117-Teynampet,85152,148499,1000,2384,32742,0,0,121278,0,0,0,0,250,250,4449,1195,5644,4790,956,5746,4771,27,130,1,0,4,93,1086,1341
1,09/09/2022,0119-Nandanam,85762,122290,1300,2920,35076,0,0,125058,0,0,0,0,2500,2500,3464,1314,4778,3881,879,4760,3750,28,11,4,0,11,131,1138,1323
1,09/09/2022,0121-Saidapet,42340,79730,180,1584,26252,0,0,70356,3175,1665,4840,0,250,250,1854,928,2782,2230,708,2938,2111,15,0,5,0,6,60,861,947
1,09/09/2022,0123-Little Mount,80290,96853,1100,2440,30874,0,0,114704,4170,6210,10380,0,1250,1250,3127,1150,4277,2578,649,3227,2666,33,215,1,0,3,97,1023,1372
1,09/09/2022,0125-Guindy,189300,290181,3759,7176,68992,0,0,269227,8000,4665,12665,0,500,500,8617,2205,10822,6989,2486,9475,8353,50,1750,2,0,12,286,2050,4150
1,09/09/2022,0129-Nanganallur Road,54010,50626,444,808,14656,0,0,69918,1065,5905,6970,0,0,0,1309,458,1767,1497,372,1869,1368,16,2,0,0,3,23,415,459
1,09/09/2022,0131-Meenambakkam,145562,150579,1739,2856,47096,0,0,197253,7915,13905,21820,0,0,0,4073,1362,5435,3416,1035,4451,3491,38,303,5,0,5,87,1251,1689
1,09/09/2022,0133-Chennai International Airport,186669,374206,1400,8368,160952,0,0,357389,11065,11485,22550,0,7500,7500,6413,4398,10811,6622,3866,10488,6686,60,1250,16,0,34,269,3977,5606
2,09/09/2022,0201-Puratchi Thalaivar Dr. M.G. Ramachandran Central,347525,528970,3170,11432,121978,0,0,484105,22190,2000,24190,0,8950,8950,15278,4378,19656,12439,8123,20562,15923,77,5246,8,0,48,447,3929,9755
2,09/09/2022,0203-Egmore,78740,150207,800,3216,63830,0,0,146586,9930,2285,12215,0,8000,8000,2816,2201,5017,3454,2770,6224,3401,20,713,4,0,19,123,2114,2993
2,09/09/2022,0205-Nehru Park,38275,49713,400,1480,17918,0,0,58073,1560,5580,7140,0,500,500,1298,676,1974,1309,463,1772,1312,6,97,0,0,3,50,616,772
2,09/09/2022,0207-Kilpauk,36933,59397,1936,1048,18090,0,0,58007,680,480,1160,0,250,250,1564,658,2222,1666,560,2226,1646,9,112,0,0,4,42,600,767
2,09/09/2022,0209-Pachaiyappas College,47797,57390,0,680,18608,0,0,67085,2020,1060,3080,0,2000,2000,1704,707,2411,1607,494,2101,1599,20,100,4,0,3,26,672,825
2,09/09/2022,0211-Shenoy Nagar,43428,49459,66,944,13004,0,0,57442,2090,1570,3660,0,0,0,1329,476,1805,1478,504,1982,1475,15,72,0,0,2,37,425,551
2,09/09/2022,0213-Anna Nagar East,90608,114248,1200,1552,35098,0,0,128458,1075,3070,4145,0,3000,3000,3127,1259,4386,3215,846,4061,3150,20,207,0,0,4,66,1172,1469
2,09/09/2022,0215-Anna Nagar Tower,86088,108154,700,2256,29970,0,0,119014,3170,7395,10565,0,250,250,2877,1085,3962,3021,788,3809,3007,21,188,0,0,7,91,975,1282
2,09/09/2022,0217-Thirumangalam,254844,319769,1200,9000,93124,0,0,358168,67995,19880,87875,0,3500,3500,8207,3118,11325,8376,2584,10960,8462,67,741,3,0,12,253,2826,3902
2,09/09/2022,0219-Koyambedu,182473,250906,1520,4520,95848,0,0,284361,13560,9570,23130,0,10500,10500,5997,3248,9245,5498,2115,7613,5647,58,919,11,0,20,186,2979,4173
2,09/09/2022,0221-Puratchi Thalaivi Dr. J. Jayalalithaa CMBT,92605,235661,0,4448,89556,0,0,186609,0,0,0,0,0,0,3505,2920,6425,6002,5207,11209,5413,37,1268,2,0,13,172,2700,4192
2,09/09/2022,0223-Arumbakkam,58447,66787,0,1256,29910,0,0,89613,1880,455,2335,0,11750,11750,1625,1041,2666,1705,629,2334,1490,49,0,0,0,8,50,980,1087
2,09/09/2022,0225-Vadapalani,168428,242129,3300,6280,63230,0,0,241238,23400,4550,27950,0,11500,11500,6252,2131,8383,5310,2696,8006,6530,46,1798,0,0,32,232,1907,4015
2,09/09/2022,0227-Ashok Nagar,101988,156791,450,3464,51158,0,0,157060,7420,5810,13230,0,0,0,3950,1722,5672,3832,1388,5220,3998,28,654,1,0,7,135,1590,2415
2,09/09/2022,0229-Ekkattuthangal,87210,139334,600,4512,42484,0,0,134806,2125,4570,6695,0,250,250,3668,1542,5210,3771,990,4761,3849,19,316,0,0,8,153,1311,1807
2,09/09/2022,0231-Arignar Anna Alandur,161262,223539,325,4616,81600,0,0,247803,8440,8705,17145,0,2750,2750,5458,2674,8132,5244,1878,7122,5413,45,682,3,0,17,152,2407,3306
2,09/09/2022,0233-St. Thomas Mount,77892,116063,3605,4104,41406,0,0,127007,3925,2925,6850,0,2000,2000,2919,1401,4320,2911,1009,3920,2829,27,197,2,0,6,134,1254,1620
1,10/09/2022,01ED-Wimco Nagar Depot Metro,71596,69293,0,1528,29222,0,0,102346,180,50,230,0,4250,4250,1533,748,2281,1368,413,1781,1224,16,1,1,0,17,45,703,783
1,10/09/2022,01EF-Wimco Nagar Metro,92021,115601,1100,2736,40258,0,0,136115,23590,5525,29115,0,0,0,2420,1054,3474,2448,923,3371,2320,70,95,3,0,14,77,957,1216
1,10/09/2022,01F1-Thiruvotriyur Metro,93392,94872,660,3016,30014,0,0,127082,1840,1630,3470,0,0,0,2236,857,3093,2293,781,3074,2167,76,0,2,0,13,79,765,935
1,10/09/2022,01F3-Thiruvotriyur Theradi Metro,103835,119904,1900,2568,41266,0,0,149569,1250,2200,3450,0,0,0,2371,1187,3558,2701,1117,3818,2654,37,162,1,0,5,79,1065,1349
1,10/09/2022,01F5-Kaladipet Metro,83425,87572,150,2232,32108,0,0,117915,1060,1270,2330,0,0,0,2125,967,3092,2162,853,3015,2018,28,0,1,0,7,67,900,1003
1,10/09/2022,01F7-Tollgate Metro,54094,50954,1550,1280,17108,0,0,74032,80,225,305,0,0,0,1258,560,1818,1288,439,1727,1236,31,10,1,0,10,44,509,605
1,10/09/2022,01F9-New Washermenpet Metro,79741,84071,400,1392,29060,0,0,110593,1225,1625,2850,0,1250,1250,2115,957,3072,2262,811,3073,2167,21,72,0,0,9,48,910,1060
1,10/09/2022,01FB-Tondiarpet Metro,69971,80839,50,1168,24012,0,0,95201,2870,2245,5115,0,0,0,2136,758,2894,2176,794,2970,2169,34,178,0,0,5,45,704,966
1,10/09/2022,01FD-Thiagaraya College Metro,93659,106377,613,2096,39468,0,0,135836,5840,2405,8245,0,1750,1750,2705,1312,4017,2779,1084,3863,2678,86,64,0,0,3,79,1213,1445
1,10/09/2022,0101-Washermanpet,76826,107185,720,2120,49062,0,0,128728,9615,5085,14700,0,8500,8500,2380,1644,4024,2420,1341,3761,2330,18,118,0,0,15,81,1556,1788
1,10/09/2022,0103-Mannadi,72268,94858,1200,2136,34134,0,0,109738,8065,10315,18380,0,1500,1500,2259,1188,3447,2503,1156,3659,2535,18,196,3,0,3,74,1110,1404
1,10/09/2022,0105-High Court,83016,169694,1700,2512,62164,0,0,149392,1200,1145,2345,0,0,0,4137,2044,6181,3780,2130,5910,4245,25,686,2,0,10,102,1952,2777
1,10/09/2022,0109-Government Estate,78967,146096,1200,2696,61618,0,0,144481,3095,5630,8725,0,4750,4750,3101,2164,5265,3508,1919,5427,3532,29,352,2,0,21,115,1988,2507
1,10/09/2022,0111-LIC,32498,83421,230,1736,33572,0,0,68036,1315,445,1760,0,0,0,1686,1145,2831,2109,824,2933,2000,16,0,3,0,7,67,1062,1155
1,10/09/2022,0113-Thousand Lights,81921,142717,830,4784,40910,0,0,128445,440,215,655,0,0,0,3450,1540,4990,3987,1400,5387,4000,20,187,0,0,6,173,1279,1665
1,10/09/2022,0115-AG-DMS,52566,78829,900,1856,25140,0,0,80462,0,0,0,0,0,0,1903,863,2766,1949,698,2647,2036,22,190,0,0,3,62,769,1046
1,10/09/2022,0117-Teynampet,50198,76054,50,2408,26394,0,0,79050,0,0,0,0,0,0,1832,963,2795,2105,799,2904,2023,21,40,0,0,8,88,867,1024
1,10/09/2022,0119-Nandanam,48114,78502,200,1632,33262,0,0,83208,0,550,550,0,1000,1000,1712,1182,2894,1981,808,2789,1849,30,0,4,0,14,68,1080,1196
1,10/09/2022,0121-Saidapet,29195,60464,508,1288,29102,0,0,60093,2945,825,3770,0,4000,4000,1015,970,1985,1365,719,2084,1182,13,0,1,0,4,51,902,971
1,10/09/2022,0123-Little Mount,47201,69256,400,1968,27928,0,0,77497,8320,3550,11870,0,0,0,1731,994,2725,1542,708,2250,1573,6,195,0,0,6,72,901,1180
1,10/09/2022,0125-Guindy,103132,208531,2230,5520,91526,0,0,202408,6200,2965,9165,0,0,0,4294,2962,7256,4146,2501,6647,4355,28,792,7,0,19,209,2712,3767
1,10/09/2022,0129-Nanganallur Road,21366,37314,500,360,16456,0,0,38682,2670,2640,5310,0,0,0,642,491,1133,857,375,1232,751,5,0,2,0,4,12,465,488
1,10/09/2022,0131-Meenambakkam,91645,124900,850,2648,54472,0,0,149615,9590,10345,19935,0,0,0,2542,1525,4067,2245,1071,3316,2310,29,302,4,0,12,82,1434,1863
1,10/09/2022,0133-Chennai International Airport,156729,362715,1700,12968,194028,0,0,365425,14265,7020,21285,0,2250,2250,4637,5432,10069,5315,4536,9851,5196,69,1125,13,0,44,378,4744,6373
2,10/09/2022,0201-Puratchi Thalaivar Dr. M.G. Ramachandran Central,325515,475091,1300,12664,114280,0,0,453759,16315,2535,18850,0,5600,5600,12809,4118,16927,8300,8430,16730,13301,71,6411,19,0,42,468,3494,10505
2,10/09/2022,0203-Egmore,82979,137899,500,3968,48508,0,0,135955,13265,3480,16745,0,9500,9500,2840,1748,4588,2708,2674,5382,3297,18,1208,6,0,26,146,1598,3002
2,10/09/2022,0205-Nehru Park,36251,43980,200,1344,20034,0,0,57829,2105,430,2535,0,4000,4000,972,732,1704,1055,540,1595,996,9,90,3,0,4,42,667,815
2,10/09/2022,0207-Kilpauk,28646,43844,300,688,16454,0,0,46088,425,85,510,0,0,0,991,567,1558,1057,499,1556,1058,6,130,0,0,2,30,518,686
2,10/09/2022,0209-Pachaiyappas College,36407,41954,200,592,14596,0,0,51795,2130,1420,3550,0,6000,6000,1139,535,1674,1108,424,1532,1118,12,111,0,0,3,29,493,648
2,10/09/2022,0211-Shenoy Nagar,26495,37774,0,1184,14576,0,0,42255,2430,940,3370,0,2000,2000,870,510,1380,997,483,1480,954,10,57,0,0,3,27,468,565
2,10/09/2022,0213-Anna Nagar East,60932,98825,1358,2488,35526,0,0,100304,1235,2070,3305,0,0,0,2383,1300,3683,2404,1093,3497,2455,21,290,8,0,7,92,1188,1606
2,10/09/2022,0215-Anna Nagar Tower,56547,86513,200,2776,30876,0,0,90399,3605,4805,8410,0,250,250,1985,1134,3119,2120,944,3064,2133,28,252,3,0,3,93,993,1372
2,10/09/2022,0217-Thirumangalam,181282,267633,1700,7808,106638,0,0,297428,95290,11005,106295,0,0,0,5644,3618,9262,5826,2998,8824,5868,73,871,13,0,19,282,3233,4491
2,10/09/2022,0219-Koyambedu,125698,199940,1390,5008,94222,0,0,226318,13630,5760,19390,0,4000,4000,4120,3223,7343,3745,2249,5994,3881,49,903,4,0,22,192,2943,4113
2,10/09/2022,0221-Puratchi Thalaivi Dr. J. Jayalalithaa CMBT,66881,205621,2350,3464,110594,0,0,183289,0,0,0,0,0,0,2587,3549,6136,4245,4708,8953,3563,35,853,2,0,8,140,3342,4380
2,10/09/2022,0223-Arumbakkam,37692,57866,0,1752,28664,0,0,68108,2180,2475,4655,0,2250,2250,1173,1053,2226,1380,713,2093,1170,32,1,1,0,15,51,956,1056
2,10/09/2022,0225-Vadapalani,124542,233196,872,8992,97894,0,0,232300,37930,6600,44530,0,1500,1500,4654,3510,8164,4513,3449,7962,5138,40,1363,5,0,22,339,3014,4783
2,10/09/2022,0227-Ashok Nagar,95933,118867,2470,3536,38704,0,0,140643,7355,4625,11980,0,3000,3000,2979,1393,4372,2614,1594,4208,3097,22,864,1,0,3,143,1205,2238
2,10/09/2022,0229-Ekkattuthangal,60067,82046,1150,2144,32562,0,0,95923,1045,1775,2820,0,0,0,1883,1171,3054,1918,849,2767,1950,13,285,0,0,5,86,1048,1437
2,10/09/2022,0231-Arignar Anna Alandur,125236,194169,2100,5256,81920,0,0,214512,10710,5625,16335,0,1500,1500,4026,2686,6712,3663,2198,5861,4029,57,922,8,0,22,169,2364,3542
2,10/09/2022,0233-St. Thomas Mount,71330,111644,260,5816,53062,0,0,130468,1410,720,2130,1000,7250,8250,2034,1781,3815,2144,1174,3318,2145,32,283,2,0,6,171,1538,2032
1,11/09/2022,01ED-Wimco Nagar Depot Metro,50417,71193,0,2232,35702,0,0,88351,90,130,220,0,2250,2250,1051,735,1786,1161,449,1610,1045,20,4,0,0,25,61,852,962
1,11/09/2022,01EF-Wimco Nagar Metro,61422,88522,200,2384,40300,0,0,104306,17125,3450,20575,0,0,0,1460,1016,2476,1513,988,2501,1428,63,105,12,0,31,65,940,1216
1,11/09/2022,01F1-Thiruvotriyur Metro,67684,79411,200,2600,36814,0,0,107298,1590,880,2470,0,0,0,1293,999,2292,1465,745,2210,1344,44,0,0,0,15,76,913,1048
1,11/09/2022,01F3-Thiruvotriyur Theradi Metro,75384,110076,500,3320,50738,0,0,129942,1440,1595,3035,0,0,0,1718,1390,3108,2074,1302,3376,1933,33,112,0,0,26,82,1240,1493
1,11/09/2022,01F5-Kaladipet Metro,56244,77860,2200,2144,39842,0,0,100430,995,1275,2270,0,0,0,1261,1128,2389,1470,964,2434,1328,24,3,0,0,17,60,1062,1166
1,11/09/2022,01F7-Tollgate Metro,48810,50012,200,968,9478,0,0,59456,380,425,805,0,0,0,1288,290,1578,931,537,1468,1322,20,483,0,0,15,26,256,800
1,11/09/2022,01F9-New Washermenpet Metro,46495,72295,200,1184,36100,0,0,83979,1460,775,2235,0,0,0,1318,1108,2426,1413,808,2221,1333,19,105,0,0,12,40,1067,1243
1,11/09/2022,01FB-Tondiarpet Metro,54709,74839,0,2184,35622,0,0,92515,3465,1950,5415,0,500,500,1256,1089,2345,1454,1028,2482,1374,25,75,0,0,19,65,998,1182
1,11/09/2022,01FD-Thiagaraya College Metro,67766,102388,100,2920,51500,0,0,122286,7160,2400,9560,0,1000,1000,1822,1628,3450,2021,1254,3275,1897,37,79,0,0,14,103,1494,1727
1,11/09/2022,0101-Washermanpet,61076,89846,250,2016,46826,0,0,110168,18135,4260,22395,0,10000,10000,1550,1531,3081,1619,1427,3046,1583,13,217,0,0,22,83,1426,1761
1,11/09/2022,0103-Mannadi,32500,69672,0,1192,41134,0,0,74826,11005,5145,16150,0,1500,1500,1042,1323,2365,1179,1107,2286,1130,11,183,0,0,2,42,1275,1513
1,11/09/2022,0105-High Court,33763,71740,200,1216,40116,0,0,75295,3070,750,3820,0,0,0,1217,1409,2626,1250,950,2200,1269,11,135,0,0,10,40,1337,1533
1,11/09/2022,0109-Government Estate,41500,89945,500,2336,44196,0,0,88532,5100,1825,6925,0,0,0,1602,1522,3124,1620,1346,2966,1753,20,394,0,0,16,91,1395,1916
1,11/09/2022,0111-LIC,19643,48325,600,1784,24702,0,0,46729,1560,705,2265,0,0,0,797,854,1651,1065,685,1750,931,8,0,1,0,12,60,781,862
1,11/09/2022,0113-Thousand Lights,32655,68471,1496,2272,33978,0,0,70401,145,100,245,0,0,0,1120,1166,2286,1516,945,2461,1325,13,56,4,0,12,90,1038,1213
1,11/09/2022,0115-AG-DMS,20145,40929,0,1104,18694,0,0,39943,0,0,0,0,0,0,792,633,1425,783,540,1323,820,9,139,0,0,1,44,553,746
1,11/09/2022,0117-Teynampet,21744,43516,100,1424,20896,0,0,44164,0,0,0,0,0,0,723,761,1484,1008,708,1716,876,10,0,0,0,11,56,686,763
1,11/09/2022,0119-Nandanam,23457,46560,700,1408,25690,0,0,51255,30,5,35,0,0,0,766,887,1653,1019,618,1637,836,16,0,10,0,14,43,802,885
1,11/09/2022,0121-Saidapet,21631,51123,43,1568,29448,0,0,52690,2530,970,3500,0,6000,6000,647,964,1611,945,803,1748,787,4,2,1,0,7,49,917,980
1,11/09/2022,0123-Little Mount,33690,55298,200,1816,25746,0,0,61452,8305,3950,12255,0,0,0,1086,901,1987,1047,683,1730,1103,15,180,1,0,13,71,796,1076
1,11/09/2022,0125-Guindy,83075,180433,450,7688,91594,0,0,182807,9190,2280,11470,0,0,0,2818,2912,5730,2769,2531,5300,3041,33,873,8,0,31,247,2616,3808
1,11/09/2022,0129-Nanganallur Road,13750,27068,100,752,15662,0,0,30264,2785,1090,3875,0,0,0,290,473,763,522,354,876,403,9,0,0,0,1,25,439,474
1,11/09/2022,0131-Meenambakkam,58604,98799,300,2560,50710,0,0,112174,11385,6550,17935,0,0,0,1485,1365,2850,1434,1111,2545,1454,25,290,5,0,21,81,1275,1697
1,11/09/2022,0133-Chennai International Airport,117214,336320,1400,10368,203604,0,0,332586,11740,4820,16560,0,2250,2250,3566,5454,9020,4417,4347,8764,4039,52,862,14,0,69,316,4852,6165
2,11/09/2022,0201-Puratchi Thalaivar Dr. M.G. Ramachandran Central,310787,419740,3250,13552,96588,0,0,424177,26985,3625,30610,0,2800,2800,10951,3460,14411,5387,7920,13307,11206,61,7074,54,0,43,501,2876,10609
2,11/09/2022,0203-Egmore,65288,123164,1650,3816,67590,0,0,138344,15350,2675,18025,0,12000,12000,1844,2161,4005,2006,2482,4488,2095,15,702,22,0,15,129,2192,3075
2,11/09/2022,0205-Nehru Park,15826,29278,50,584,16366,0,0,32826,1925,240,2165,0,0,0,525,583,1108,542,495,1037,519,4,109,0,0,1,22,545,681
2,11/09/2022,0207-Kilpauk,15814,30374,350,1592,13058,0,0,30814,615,60,675,0,0,0,572,496,1068,673,427,1100,684,11,122,3,0,1,66,420,623
2,11/09/2022,0209-Pachaiyappas College,26923,28883,250,664,13194,0,0,41031,880,780,1660,0,10000,10000,619,472,1091,614,399,1013,598,10,81,0,0,2,24,444,561
2,11/09/2022,0211-Shenoy Nagar,20846,25218,350,800,11992,0,0,33988,2640,1330,3970,0,2000,2000,302,427,729,529,344,873,525,8,91,0,0,2,29,385,515
2,11/09/2022,0213-Anna Nagar East,34963,65406,100,2040,30222,0,0,67325,1260,1315,2575,0,0,0,1364,1080,2444,1376,897,2273,1379,13,229,0,0,8,63,960,1273
2,11/09/2022,0215-Anna Nagar Tower,31515,63587,0,1944,25986,0,0,59445,5525,2660,8185,0,0,0,1281,944,2225,1395,836,2231,1436,13,264,3,0,3,69,844,1196
2,11/09/2022,0217-Thirumangalam,126209,211805,750,8256,102066,0,0,237281,96855,7555,104410,0,0,0,3696,3423,7119,3857,2791,6648,3932,53,905,15,0,15,303,3044,4335
2,11/09/2022,0219-Koyambedu,89912,161478,700,5200,94556,0,0,190368,8585,3970,12555,0,8750,8750,2642,3141,5783,2623,2110,4733,2441,38,667,8,0,24,163,2910,3810
2,11/09/2022,0221-Puratchi Thalaivi Dr. J. Jayalalithaa CMBT,71223,199912,530,4032,115616,0,0,191401,0,0,0,0,0,0,2514,3722,6236,3193,4302,7495,2997,32,1098,6,0,14,170,3497,4817
2,11/09/2022,0223-Arumbakkam,25331,46929,0,1344,27042,0,0,53717,1285,285,1570,0,10000,10000,715,993,1708,989,631,1620,812,18,5,0,0,17,53,911,1004
2,11/09/2022,0225-Vadapalani,106119,213473,150,8336,92556,0,0,207161,36430,5640,42070,0,3000,3000,3916,3174,7090,3583,3215,6798,4361,33,1609,0,0,26,326,2745,4739
2,11/09/2022,0227-Ashok Nagar,67802,98996,400,3048,40864,0,0,112114,6725,3155,9880,0,3000,3000,1928,1204,3132,1833,1403,3236,2055,22,674,2,0,5,109,1312,2124
2,11/09/2022,0229-Ekkattuthangal,33961,50476,300,1712,24932,0,0,60905,390,135,525,0,0,0,916,893,1809,1177,796,1973,1057,15,203,0,0,3,81,784,1086
2,11/09/2022,0231-Arignar Anna Alandur,82295,163159,0,6200,85980,0,0,174475,9070,4825,13895,0,0,0,2496,2744,5240,2465,2132,4597,2672,37,693,7,0,23,192,2454,3406
2,11/09/2022,0233-St. Thomas Mount,55852,81893,200,4024,45198,0,0,105274,1810,1420,3230,0,6500,6500,1167,1494,2661,1347,1246,2593,1318,31,248,0,0,3,134,1355,1771
1,12/09/2022,01ED-Wimco Nagar Depot Metro,95330,83051,0,1136,24178,0,0,120644,310,300,610,0,6250,6250,2055,600,2655,1751,467,2218,1803,27,135,3,0,11,36,589,801
1,12/09/2022,01EF-Wimco Nagar Metro,143111,145129,300,3160,34468,0,0,181039,28165,7685,35850,0,500,500,3442,924,4366,3477,1029,4506,3422,46,152,3,0,9,93,824,1127
1,12/09/2022,01F1-Thiruvotriyur Metro,142238,119566,0,1376,30320,0,0,173934,1575,1705,3280,0,0,0,2904,825,3729,3112,715,3827,2956,43,9,1,0,10,43,790,896
1,12/09/2022,01F3-Thiruvotriyur Theradi Metro,131986,132272,810,1856,31160,0,0,165812,1125,2925,4050,0,0,0,3060,933,3993,3383,1036,4419,3369,42,205,3,0,14,66,849,1179
1,12/09/2022,01F5-Kaladipet Metro,136064,111681,300,1424,30674,0,0,168462,1250,2620,3870,0,0,0,3025,921,3946,3157,750,3907,2976,25,0,1,0,9,49,869,953
1,12/09/2022,01F7-Tollgate Metro,88646,65835,362,368,15736,0,0,105112,660,125,785,0,0,0,1868,469,2337,1771,494,2265,1780,37,141,0,0,14,13,458,663
1,12/09/2022,01F9-New Washermenpet Metro,120633,113528,2400,1760,34858,0,0,159651,1550,1820,3370,0,250,250,2971,1163,4134,3238,916,4154,3104,26,69,2,0,5,57,1115,1274
1,12/09/2022,01FB-Tondiarpet Metro,137759,108725,600,1840,27884,0,0,168083,6335,3630,9965,0,250,250,2949,934,3883,3114,933,4047,3134,35,150,2,0,7,58,862,1114
1,12/09/2022,01FD-Thiagaraya College Metro,144226,139447,700,1912,42502,0,0,189340,5185,3975,9160,0,500,500,3888,1404,5292,4007,1196,5203,3906,57,41,4,0,13,71,1338,1524
1,12/09/2022,0101-Washermanpet,120207,137513,1000,1616,49284,0,0,172107,5695,4495,10190,0,8750,8750,3612,1674,5286,3657,1407,5064,3562,24,144,0,0,11,61,1597,1837
1,12/09/2022,0103-Mannadi,105955,114546,6700,1640,31588,0,0,145883,23205,6850,30055,0,1500,1500,3169,1097,4266,3500,1183,4683,3457,22,118,1,0,2,59,1029,1231
1,12/09/2022,0105-High Court,153821,233842,1300,2128,66520,0,0,223769,1220,1600,2820,0,0,0,6664,2329,8993,6789,1802,8591,6868,20,359,0,0,3,89,2175,2646
1,12/09/2022,0109-Government Estate,109752,152884,700,1648,55662,0,0,167762,8165,3385,11550,0,7750,7750,3780,1897,5677,4452,1520,5972,4311,21,201,3,0,7,74,1766,2072
1,12/09/2022,0111-LIC,113065,172986,1120,1688,35230,0,0,151103,2270,735,3005,0,0,0,4896,1255,6151,5770,1024,6794,5553,35,0,1,0,4,63,1143,1246
1,12/09/2022,0113-Thousand Lights,184489,245620,2500,4272,45650,0,0,236911,685,335,1020,0,0,0,7240,1653,8893,8215,1480,9695,8015,61,106,4,0,5,159,1435,1770
1,12/09/2022,0115-AG-DMS,134425,148728,850,1632,29388,0,0,166295,0,0,0,0,250,250,4551,985,5536,4723,710,5433,4692,40,142,3,0,2,69,875,1131
1,12/09/2022,0117-Teynampet,111534,152388,690,1312,34164,0,0,147700,0,0,0,0,0,0,4547,1207,5754,5221,984,6205,4918,27,0,6,0,7,55,1138,1233
1,12/09/2022,0119-Nandanam,117694,127354,2550,1680,32238,0,0,154162,0,0,0,0,250,250,3556,1198,4754,4383,968,5351,4080,35,1,0,0,5,77,1086,1204
1,12/09/2022,0121-Saidapet,65959,86317,0,1264,29448,0,0,96671,3210,1915,5125,0,4500,4500,1909,1020,2929,2466,805,3271,2299,21,0,1,0,4,54,957,1037
1,12/09/2022,0123-Little Mount,97986,94031,1900,2056,24832,0,0,126774,4840,4630,9470,0,2500,2500,3156,931,4087,2891,728,3619,2835,25,147,2,0,4,74,827,1079
1,12/09/2022,0125-Guindy,179415,274782,2650,6512,74556,0,0,263133,12400,5730,18130,0,3000,3000,7978,2620,10598,7428,2314,9742,7787,58,954,5,0,12,238,2259,3526
1,12/09/2022,0129-Nanganallur Road,60939,49747,200,552,14184,0,0,75875,2440,6885,9325,0,0,0,1261,424,1685,1454,325,1779,1364,8,1,0,0,0,18,399,426
1,12/09/2022,0131-Meenambakkam,158808,153024,4350,2304,43822,0,0,209284,9650,17430,27080,0,0,0,4107,1248,5355,3585,1026,4611,3695,27,275,7,0,6,74,1166,1555
1,12/09/2022,0133-Chennai International Airport,222442,363288,3850,8856,144366,0,0,379514,10595,12210,22805,0,14500,14500,6334,3956,10290,6884,3859,10743,6888,72,1192,17,0,21,253,3533,5088
2,12/09/2022,0201-Puratchi Thalaivar Dr. M.G. Ramachandran Central,449756,525000,5290,15504,86158,0,0,556708,37505,3215,40720,0,4500,4500,18351,3421,21772,11359,7710,19069,17071,123,6989,9,1,30,603,2604,10359
2,12/09/2022,0203-Egmore,92212,148633,940,4720,70380,0,0,168252,19260,4335,23595,0,10500,10500,2965,2546,5511,3076,2255,5331,3024,22,696,3,0,6,183,2313,3223
2,12/09/2022,0205-Nehru Park,43123,46212,0,440,16106,0,0,59669,1975,1965,3940,0,2000,2000,1343,578,1921,1413,497,1910,1311,17,69,0,0,3,17,560,666
2,12/09/2022,0207-Kilpauk,43802,63636,350,792,20174,0,0,65118,455,350,805,0,250,250,1590,717,2307,1815,577,2392,1746,13,108,0,0,1,37,670,829
2,12/09/2022,0209-Pachaiyappas College,55307,57738,1020,440,17856,0,0,74623,1390,460,1850,0,4500,4500,1825,690,2515,1829,471,2300,1707,10,99,2,0,6,20,654,791
2,12/09/2022,0211-Shenoy Nagar,56811,48004,500,808,13330,0,0,71449,2710,2150,4860,0,2000,2000,1293,473,1766,1500,423,1923,1432,11,58,0,0,2,25,441,537
2,12/09/2022,0213-Anna Nagar East,100611,119544,2134,1640,34304,0,0,138689,670,3395,4065,0,250,250,3248,1241,4489,3565,912,4477,3420,25,178,1,0,5,65,1153,1427
2,12/09/2022,0215-Anna Nagar Tower,127784,109435,1050,1792,27544,0,0,158170,4450,9480,13930,0,1250,1250,2966,975,3941,3266,761,4027,3178,23,204,1,0,2,64,899,1193
2,12/09/2022,0217-Thirumangalam,304057,315293,1200,4960,89896,0,0,400113,58530,19665,78195,0,1500,1500,8184,3005,11189,8839,2580,11419,8526,63,516,11,0,4,178,2743,3515
2,12/09/2022,0219-Koyambedu,219491,264872,3250,4880,109684,0,0,337305,20385,9815,30200,0,13000,13000,6246,3600,9846,5648,2215,7863,5749,59,743,4,0,9,209,3385,4409
2,12/09/2022,0221-Puratchi Thalaivi Dr. J. Jayalalithaa CMBT,144043,236188,2400,5824,77462,0,0,229729,0,0,0,0,0,0,5259,2663,7922,4250,3667,7917,5699,39,2519,3,1,7,244,2306,5119
2,12/09/2022,0223-Arumbakkam,67153,66741,600,1240,26032,0,0,95025,2280,450,2730,0,3750,3750,1646,945,2591,1866,686,2552,1664,48,4,1,0,10,45,883,991
2,12/09/2022,0225-Vadapalani,170879,229046,2105,3184,69662,0,0,245830,23040,3600,26640,0,9500,9500,5587,2324,7911,5860,2288,8148,5982,67,1072,5,0,12,125,2153,3434
2,12/09/2022,0227-Ashok Nagar,133359,152290,4300,2656,30256,0,0,170571,9300,9835,19135,0,7000,7000,4395,1035,5430,4085,1475,5560,4606,31,1050,4,0,4,92,918,2099
2,12/09/2022,0229-Ekkattuthangal,116863,134176,1400,1936,29596,0,0,149795,2800,5145,7945,0,0,0,3578,1029,4607,4248,1082,5330,4181,29,294,0,0,1,66,902,1292
2,12/09/2022,0231-Arignar Anna Alandur,213566,214178,4550,4456,70502,0,0,293074,12220,8390,20610,0,4000,4000,5597,2359,7956,5512,1717,7229,5532,57,518,10,0,11,132,2137,2865
2,12/09/2022,0233-St. Thomas Mount,91868,108849,1670,2832,34576,0,0,130946,3890,5715,9605,0,2750,2750,2823,1168,3991,2974,901,3875,2866,29,149,4,0,3,97,1039,1321
1,13/09/2022,01ED-Wimco Nagar Depot Metro,87069,72572,0,1104,22094,0,0,110267,185,710,895,0,1500,1500,1913,556,2469,1642,314,1956,1602,10,3,2,0,3,34,550,602
1,13/09/2022,01EF-Wimco Nagar Metro,130739,133582,1110,2384,29844,0,0,164077,24640,7160,31800,0,0,0,3347,812,4159,3286,810,4096,3256,41,59,4,0,8,68,724,904
1,13/09/2022,01F1-Thiruvotriyur Metro,114848,102788,0,912,20964,0,0,136724,1030,1605,2635,0,0,0,2880,568,3448,2821,509,3330,2736,57,0,1,0,3,29,543,633
1,13/09/2022,01F3-Thiruvotriyur Theradi Metro,107378,114145,900,1416,22760,0,0,132454,1570,2795,4365,0,0,0,2760,694,3454,3137,690,3827,3117,19,65,2,0,5,46,628,765
1,13/09/2022,01F5-Kaladipet Metro,105737,98366,400,1336,19370,0,0,126843,1335,2630,3965,0,0,0,3012,613,3625,3006,581,3587,2934,33,0,0,0,3,38,579,653
1,13/09/2022,01F7-Tollgate Metro,63739,55285,1000,472,13652,0,0,78863,150,145,295,0,0,0,1611,436,2047,1578,324,1902,1519,29,0,0,0,5,17,414,465
1,13/09/2022,01F9-New Washermenpet Metro,99257,94940,600,640,21610,0,0,122107,1025,1735,2760,0,1000,1000,2910,753,3663,2986,743,3729,2939,24,58,2,0,4,22,728,838
1,13/09/2022,01FB-Tondiarpet Metro,89786,96115,900,1504,22758,0,0,114948,3045,4800,7845,0,750,750,2847,785,3632,2969,711,3680,2896,10,0,1,0,1,52,731,795
1,13/09/2022,01FD-Thiagaraya College Metro,120161,117081,710,1896,26152,0,0,148919,5220,5470,10690,0,1500,1500,3667,951,4618,3797,868,4665,3741,55,29,2,0,2,47,908,1043
1,13/09/2022,0101-Washermanpet,104797,118800,1200,1360,36096,0,0,143453,8570,4310,12880,0,15750,15750,3490,1217,4707,3429,1030,4459,3398,20,83,1,0,6,52,1180,1342
1,13/09/2022,0103-Mannadi,83734,112955,0,952,30886,0,0,115572,10295,7530,17825,0,3000,3000,3162,1072,4234,3508,1046,4554,3477,21,77,1,0,2,39,1027,1167
1,13/09/2022,0105-High Court,160380,244926,300,1952,65974,0,0,228606,1100,1435,2535,0,0,0,7162,2326,9488,7092,1878,8970,7303,37,408,2,0,2,82,2192,2723
1,13/09/2022,0109-Government Estate,94404,147553,570,1752,47218,0,0,143944,2360,2845,5205,0,0,0,3929,1675,5604,4398,1385,5783,4433,36,242,0,0,1,72,1563,1914
1,13/09/2022,0111-LIC,102371,168332,4700,1752,30446,0,0,139269,1695,570,2265,0,5250,5250,4872,1109,5981,5669,902,6571,5565,44,0,2,0,4,75,1001,1126
1,13/09/2022,0113-Thousand Lights,156065,237630,2920,3200,34590,0,0,196775,660,380,1040,0,0,0,7433,1298,8731,8132,1235,9367,8178,40,193,0,1,2,136,1091,1463
1,13/09/2022,0115-AG-DMS,115811,145786,700,1672,27268,0,0,145451,0,0,0,0,250,250,4643,922,5565,4663,723,5386,4684,30,109,2,0,1,60,834,1036
1,13/09/2022,0117-Teynampet,102560,149963,200,1784,31284,0,0,135828,0,0,0,0,1000,1000,4639,1156,5795,5135,858,5993,4961,27,0,0,0,5,52,1084,1168
1,13/09/2022,0119-Nandanam,103617,117546,270,1912,24276,0,0,130075,0,0,0,0,750,750,3689,943,4632,4106,799,4905,4033,52,0,1,0,3,78,829,963
1,13/09/2022,0121-Saidapet,56492,76846,300,912,20178,0,0,77882,1345,1550,2895,0,2250,2250,1899,747,2646,2388,635,3023,2307,15,0,1,0,1,41,691,749
1,13/09/2022,0123-Little Mount,97009,88772,230,1648,22156,0,0,121043,4155,5720,9875,0,1250,1250,3167,846,4013,2675,592,3267,2730,25,113,0,0,2,63,769,972
1,13/09/2022,0125-Guindy,160226,244368,1800,7288,60606,0,0,229920,8485,5620,14105,0,3500,3500,7527,2127,9654,7027,2143,9170,7259,49,500,6,0,6,188,1865,2614
1,13/09/2022,0129-Nanganallur Road,64403,48178,2400,688,10698,0,0,78189,1465,6315,7780,0,0,0,1353,345,1698,1457,299,1756,1427,16,0,0,0,3,26,314,359
1,13/09/2022,0131-Meenambakkam,143035,137313,700,2552,34962,0,0,181249,7150,15720,22870,0,0,0,4007,1035,5042,3427,809,4236,3511,29,179,2,0,5,62,974,1251
1,13/09/2022,0133-Chennai International Airport,171529,319449,500,4976,138832,0,0,315837,9435,10815,20250,0,6750,6750,5413,3751,9164,6229,3169,9398,5891,57,504,11,0,10,148,3499,4229
2,13/09/2022,0201-Puratchi Thalaivar Dr. M.G. Ramachandran Central,353907,445882,770,10344,88796,0,0,453817,24745,3185,27930,0,8450,8450,15154,3368,18522,10521,6477,16998,14446,87,4637,10,0,17,397,2860,8008
2,13/09/2022,0203-Egmore,93571,124804,400,2240,56360,0,0,152571,15460,4255,19715,0,11500,11500,2539,1954,4493,2631,2102,4733,2708,28,596,5,0,5,87,1886,2607
2,13/09/2022,0205-Nehru Park,37929,46719,2200,680,15276,0,0,56085,1095,1590,2685,0,250,250,1304,567,1871,1350,404,1754,1331,11,75,0,0,3,26,529,644
2,13/09/2022,0207-Kilpauk,40731,57836,0,648,16048,0,0,57427,410,345,755,0,250,250,1555,568,2123,1659,480,2139,1657,14,64,4,0,2,24,533,641
2,13/09/2022,0209-Pachaiyappas College,45985,50237,100,1192,13170,0,0,60447,1400,660,2060,0,10000,10000,1644,526,2170,1631,451,2082,1579,12,43,2,0,0,30,487,574
2,13/09/2022,0211-Shenoy Nagar,46442,46067,0,632,11760,0,0,58834,890,1760,2650,0,3000,3000,1322,432,1754,1449,393,1842,1402,13,41,0,0,2,27,399,482
2,13/09/2022,0213-Anna Nagar East,93072,110111,1000,1520,28806,0,0,124398,700,3870,4570,0,0,0,3152,1057,4209,3236,929,4165,3244,31,148,2,0,2,65,973,1221
2,13/09/2022,0215-Anna Nagar Tower,103332,105656,500,1712,25506,0,0,131050,3135,7125,10260,0,2000,2000,2946,932,3878,3078,770,3848,3103,32,164,1,0,2,68,846,1113
2,13/09/2022,0217-Thirumangalam,299531,298769,400,5040,74458,0,0,379429,60855,20265,81120,0,500,500,8215,2504,10719,8479,2095,10574,8447,69,436,3,0,5,152,2300,2965
2,13/09/2022,0219-Koyambedu,185698,219588,600,3568,73914,0,0,263780,11285,13200,24485,5000,11750,16750,5754,2501,8255,5400,1726,7126,5364,57,481,2,0,7,106,2363,3016
2,13/09/2022,0221-Puratchi Thalaivi Dr. J. Jayalalithaa CMBT,73035,176288,1100,2088,93282,0,0,169505,0,0,0,0,0,0,2609,3047,5656,3674,2911,6585,3263,30,380,6,0,4,88,2911,3419
2,13/09/2022,0223-Arumbakkam,70452,61186,500,1536,21990,0,0,94478,900,410,1310,0,5250,5250,1622,815,2437,1709,631,2340,1600,28,3,3,0,3,42,746,825
2,13/09/2022,0225-Vadapalani,126203,205422,550,3872,58876,0,0,189501,19700,4280,23980,0,6500,6500,5359,2070,7429,5195,2179,7374,5611,46,943,1,0,4,142,1856,2992
2,13/09/2022,0227-Ashok Nagar,125022,141268,1760,2280,25428,0,0,154490,5800,7455,13255,0,4500,4500,4171,887,5058,3771,1223,4994,4364,18,875,1,0,1,96,753,1744
2,13/09/2022,0229-Ekkattuthangal,98315,135843,200,1912,29984,0,0,130411,505,2680,3185,0,0,0,3766,1066,4832,4178,938,5116,4250,21,249,0,0,1,83,943,1297
2,13/09/2022,0231-Arignar Anna Alandur,156091,193927,1300,3440,55378,0,0,216209,13075,10825,23900,0,3500,3500,5477,1866,7343,5214,1509,6723,5368,52,399,3,0,9,113,1675,2251
2,13/09/2022,0233-St. Thomas Mount,84056,100974,28,3288,32616,0,0,119988,5055,2755,7810,0,2875,2875,2703,1092,3795,2784,757,3541,2679,39,43,2,0,0,74,992,1150
1,14/09/2022,01ED-Wimco Nagar Depot Metro,73612,78942,0,1064,27164,0,0,101840,230,390,620,0,4500,4500,1968,651,2619,1677,368,2045,1643,16,2,2,0,1,31,684,736
1,14/09/2022,01EF-Wimco Nagar Metro,136236,141557,1550,2536,36136,0,0,176458,14185,6930,21115,0,250,250,3494,955,4449,3350,898,4248,3302,65,63,1,0,15,68,870,1082
1,14/09/2022,01F1-Thiruvotriyur Metro,127747,106234,1650,1752,21550,0,0,152699,2035,1470,3505,0,0,0,2969,598,3567,2914,517,3431,2817,60,0,0,0,7,47,576,690
1,14/09/2022,01F3-Thiruvotriyur Theradi Metro,104352,116590,100,1664,28698,0,0,134814,1515,2600,4115,0,0,0,2795,833,3628,3099,789,3888,3033,23,35,3,0,1,46,752,860
1,14/09/2022,01F5-Kaladipet Metro,110872,106086,700,1688,26840,0,0,140100,985,2120,3105,0,0,0,3045,836,3881,3038,758,3796,2967,17,0,0,0,3,59,782,861
1,14/09/2022,01F7-Tollgate Metro,63857,56154,100,744,12660,0,0,77361,25,205,230,0,0,0,1656,408,2064,1665,353,2018,1589,25,0,0,0,5,22,384,436
1,14/09/2022,01F9-New Washermenpet Metro,95694,100407,0,1048,23716,0,0,120458,1200,2025,3225,0,0,0,3025,833,3858,3082,773,3855,3059,27,67,1,0,7,39,798,939
1,14/09/2022,01FB-Tondiarpet Metro,102336,100983,724,1680,24686,0,0,129426,2820,3450,6270,0,500,500,2871,839,3710,3060,822,3882,2998,29,5,3,0,5,58,778,878
1,14/09/2022,01FD-Thiagaraya College Metro,117510,125066,0,1568,30774,0,0,149852,5725,2910,8635,0,2750,2750,3700,1059,4759,3853,838,4691,3817,57,36,0,0,8,53,999,1153
1,14/09/2022,0101-Washermanpet,114588,125576,600,2080,41248,0,0,158516,6520,5315,11835,0,15250,15250,3720,1439,5159,3428,1117,4545,3437,18,111,1,0,6,69,1356,1561
1,14/09/2022,0103-Mannadi,88593,114010,100,1480,32620,0,0,122793,11970,7440,19410,0,1500,1500,3108,1143,4251,3513,1054,4567,3429,18,88,2,0,1,43,1094,1246
1,14/09/2022,0105-High Court,135320,230145,0,3024,64940,0,0,203284,1200,2095,3295,0,0,0,6589,2300,8889,6789,1707,8496,6781,47,180,2,0,2,95,2157,2483
1,14/09/2022,0109-Government Estate,93612,147848,550,1800,47586,0,0,143548,3765,2930,6695,0,250,250,3869,1735,5604,4474,1425,5899,4408,27,183,0,0,4,65,1633,1912
1,14/09/2022,0111-LIC,99858,175319,500,2232,32274,0,0,134864,990,970,1960,0,0,0,5101,1186,6287,5863,947,6810,5775,37,1,1,0,2,82,1055,1178
1,14/09/2022,0113-Thousand Lights,146014,249070,1200,5488,42986,0,0,195688,450,330,780,0,0,0,7579,1609,9188,8229,1403,9632,8266,32,126,0,0,7,173,1363,1701
1,14/09/2022,0115-AG-DMS,114398,148825,2000,1976,26866,0,0,145240,0,0,0,0,0,0,4681,932,5613,4749,745,5494,4823,29,143,3,0,1,75,835,1086
1,14/09/2022,0117-Teynampet,91999,149876,100,1664,30196,0,0,123959,0,0,0,0,4750,4750,4601,1125,5726,5123,938,6061,4961,27,0,0,0,4,70,1025,1126
1,14/09/2022,0119-Nandanam,95993,123731,1475,2328,27998,0,0,127794,615,0,615,0,1750,1750,3707,1087,4794,4263,832,5095,4150,44,0,1,0,3,104,942,1094
1,14/09/2022,0121-Saidapet,61839,83380,200,1328,25632,0,0,88999,1405,1905,3310,0,4000,4000,1983,902,2885,2424,683,3107,2316,15,0,0,0,4,50,846,915
1,14/09/2022,0123-Little Mount,92325,93538,0,1872,22670,0,0,116867,3995,6535,10530,0,2000,2000,3309,884,4193,2782,612,3394,2884,25,173,1,0,1,80,768,1048
1,14/09/2022,0125-Guindy,149928,263184,3147,7408,75536,0,0,236019,5960,5300,11260,0,0,0,7563,2606,10169,7196,2200,9396,7407,48,446,3,0,6,217,2356,3076
1,14/09/2022,0129-Nanganallur Road,52802,48190,200,456,11376,0,0,64834,875,5855,6730,0,0,0,1321,354,1675,1495,298,1793,1409,10,0,2,0,1,16,321,350
1,14/09/2022,0131-Meenambakkam,131500,143234,1300,2080,40304,0,0,175184,6720,16790,23510,0,0,0,4061,1149,5210,3468,894,4362,3543,26,194,0,0,1,63,1080,1364
1,14/09/2022,0133-Chennai International Airport,187868,320045,3460,7624,136238,0,0,335190,7555,9615,17170,0,4500,4500,5435,3797,9232,6271,3344,9615,5946,53,582,12,0,7,226,3432,4312
2,14/09/2022,0201-Puratchi Thalaivar Dr. M.G. Ramachandran Central,378638,459795,2000,9560,48106,0,0,438304,16875,2195,19070,0,4950,4950,16639,1935,18574,10537,6897,17434,16215,79,6372,4,0,9,379,1488,8331
2,14/09/2022,0203-Egmore,87288,127763,252,3072,58942,0,0,149554,14345,3745,18090,0,12750,12750,2596,1930,4526,2733,2231,4964,2747,31,569,18,0,8,104,1953,2683
2,14/09/2022,0205-Nehru Park,40725,45626,200,1280,14978,0,0,57183,1325,1830,3155,0,1000,1000,1309,566,1875,1266,434,1700,1286,6,95,1,0,0,42,504,648
2,14/09/2022,0207-Kilpauk,42311,59540,500,864,16858,0,0,60533,425,405,830,0,0,0,1638,629,2267,1752,474,2226,1730,14,85,0,0,1,39,578,717
2,14/09/2022,0209-Pachaiyappas College,47405,53253,250,392,15194,0,0,63241,1440,960,2400,0,5000,5000,1683,571,2254,1669,401,2070,1607,18,62,3,0,0,17,544,644
2,14/09/2022,0211-Shenoy Nagar,41559,47694,0,728,12358,0,0,54645,1710,1470,3180,0,0,0,1335,450,1785,1452,414,1866,1457,13,64,0,0,0,30,410,517
2,14/09/2022,0213-Anna Nagar East,92885,112256,650,1816,29542,0,0,124893,745,4260,5005,0,0,0,3109,1083,4192,3301,853,4154,3277,26,190,0,0,1,78,990,1285
2,14/09/2022,0215-Anna Nagar Tower,90011,107919,800,1384,26896,0,0,119091,2745,3985,6730,0,2750,2750,2987,922,3909,3120,795,3915,3132,31,192,2,0,0,52,888,1165
2,14/09/2022,0217-Thirumangalam,266094,312165,2400,5192,81598,0,0,355284,50905,22955,73860,0,1000,1000,8341,2765,11106,8707,2231,10938,8657,61,491,8,0,5,187,2509,3261
2,14/09/2022,0219-Koyambedu,172647,232954,2150,4168,85196,0,0,264161,11000,15960,26960,5000,6000,11000,5726,2889,8615,5521,1855,7376,5444,42,461,7,0,6,156,2680,3352
2,14/09/2022,0221-Puratchi Thalaivi Dr. J. Jayalalithaa CMBT,66444,175123,1050,2960,86764,0,0,157218,0,0,0,0,0,0,2618,2831,5449,3851,3180,7031,3481,43,466,5,0,4,113,2677,3308
2,14/09/2022,0223-Arumbakkam,65526,63525,650,976,24588,0,0,91740,7090,680,7770,0,4750,4750,1648,881,2529,1771,633,2404,1626,47,0,0,0,3,44,820,914
2,14/09/2022,0225-Vadapalani,143647,215837,1750,3752,66128,0,0,215277,19000,4460,23460,0,5000,5000,5439,2206,7645,5453,2169,7622,5686,56,857,1,0,8,145,2065,3132
2,14/09/2022,0227-Ashok Nagar,109716,141832,350,2552,40228,0,0,152846,6465,7735,14200,0,12500,12500,3832,1398,5230,3758,1262,5020,3945,29,452,5,0,0,105,1269,1860
2,14/09/2022,0229-Ekkattuthangal,92965,135979,500,2120,29700,0,0,125285,480,2975,3455,0,250,250,3881,1078,4959,4186,979,5165,4264,31,280,1,0,1,88,955,1356
2,14/09/2022,0231-Arignar Anna Alandur,168220,202564,1610,3336,58404,0,0,231570,8320,9810,18130,0,750,750,5605,1969,7574,5477,1553,7030,5586,45,433,1,0,5,119,1771,2374
2,14/09/2022,0233-St. Thomas Mount,82340,107161,100,2648,36452,0,0,121540,1510,2400,3910,0,3250,3250,2832,1235,4067,2878,826,3704,2771,25,10,1,0,2,102,1109,1249
1,15/09/2022,01ED-Wimco Nagar Depot Metro,76728,76531,0,1776,23984,0,0,102488,155,195,350,0,3250,3250,1978,609,2587,1669,336,2005,1639,17,0,4,0,8,42,585,656
1,15/09/2022,01EF-Wimco Nagar Metro,129848,139031,250,2688,34084,0,0,166870,11715,6270,17985,0,250,250,3516,922,4438,3292,869,4161,3259,47,68,3,0,10,79,825,1032
1,15/09/2022,01F1-Thiruvotriyur Metro,111815,104539,0,1824,19650,0,0,133289,655,1925,2580,0,0,0,2968,575,3543,2892,531,3423,2838,55,0,4,0,5,52,521,637
1,15/09/2022,01F3-Thiruvotriyur Theradi Metro,102351,121075,1240,1920,29038,0,0,134549,830,2680,3510,0,0,0,2825,865,3690,3184,820,4004,3134,29,51,1,0,6,59,799,945
1,15/09/2022,01F5-Kaladipet Metro,109754,103924,250,1656,23540,0,0,135200,895,2670,3565,0,0,0,3103,768,3871,3059,676,3735,2992,25,1,1,0,4,53,711,795
1,15/09/2022,01F7-Tollgate Metro,61369,56234,750,312,12672,0,0,75103,140,135,275,0,0,0,1567,393,1960,1656,335,1991,1590,33,0,0,0,7,15,376,431
1,15/09/2022,01F9-New Washermenpet Metro,105762,100020,150,904,22996,0,0,129812,1055,1875,2930,0,500,500,3061,802,3863,3115,707,3822,3089,26,36,0,0,9,34,769,874
1,15/09/2022,01FB-Tondiarpet Metro,84519,101778,284,1296,23808,0,0,109907,4910,3720,8630,0,750,750,2922,793,3715,3120,719,3839,3044,27,1,2,0,5,49,740,824
1,15/09/2022,01FD-Thiagaraya College Metro,116819,120488,500,1384,27174,0,0,145877,2910,2640,5550,0,1250,1250,3734,983,4717,3775,876,4651,3831,57,123,1,1,4,46,919,1151
1,15/09/2022,0101-Washermanpet,110958,125340,100,2984,41248,0,0,155290,5645,4785,10430,0,21250,21250,3662,1448,5110,3394,1184,4578,3438,14,130,0,0,4,91,1344,1583
1,15/09/2022,0103-Mannadi,90588,108246,2510,1000,29484,0,0,123582,12180,5495,17675,0,1500,1500,3030,1017,4047,3333,1094,4427,3314,25,64,0,0,0,39,976,1104
1,15/09/2022,0105-High Court,129599,227021,200,2016,61254,0,0,193069,1190,2095,3285,0,0,0,6487,2164,8651,6704,1714,8418,6779,31,181,2,0,2,81,2055,2352
1,15/09/2022,0109-Government Estate,93246,155406,820,2472,48556,0,0,145094,2855,2780,5635,0,500,500,4100,1736,5836,4664,1474,6138,4702,28,215,1,0,13,95,1588,1940
1,15/09/2022,0111-LIC,80515,179464,1520,2232,33922,0,0,118189,2590,685,3275,0,0,0,5097,1221,6318,5908,1000,6908,5873,20,38,1,0,4,84,1093,1240
1,15/09/2022,0113-Thousand Lights,133617,249212,1450,4568,48192,0,0,187827,915,285,1200,0,1250,1250,7392,1797,9189,8245,1368,9613,8121,41,0,2,0,4,169,1556,1772
1,15/09/2022,0115-AG-DMS,88127,144862,1200,2040,26688,0,0,118055,0,0,0,0,0,0,4525,948,5473,4563,734,5297,4659,16,139,0,0,1,83,827,1066
1,15/09/2022,0117-Teynampet,102812,148417,0,1824,28122,0,0,132758,0,0,0,0,0,0,4713,1094,5807,5089,925,6014,5002,31,1,4,0,2,78,976,1092
1,15/09/2022,0119-Nandanam,98661,122297,800,2112,26396,0,0,127969,50,0,50,0,4000,4000,3843,1042,4885,4221,896,5117,4147,44,0,1,0,5,96,905,1051
1,15/09/2022,0121-Saidapet,50100,80803,100,1136,22600,0,0,73936,6970,2555,9525,0,6500,6500,1978,812,2790,2436,713,3149,2350,12,0,0,0,0,49,761,822
1,15/09/2022,0123-Little Mount,76721,90447,900,2128,22718,0,0,102467,3985,6015,10000,0,0,0,3180,885,4065,2720,616,3336,2783,22,136,4,0,3,82,771,1018
1,15/09/2022,0125-Guindy,147567,264784,700,5216,63450,0,0,216933,4545,5350,9895,0,6000,6000,8192,2108,10300,7159,2313,9472,7856,39,870,1,0,7,207,1982,3106
1,15/09/2022,0129-Nanganallur Road,44924,47432,700,512,10874,0,0,57010,1465,6435,7900,0,0,0,1349,348,1697,1472,296,1768,1414,12,0,1,0,1,19,319,352
1,15/09/2022,0131-Meenambakkam,117911,136818,0,3000,35860,0,0,156771,7780,17645,25425,0,0,0,3938,1080,5018,3322,855,4177,3445,27,178,0,0,1,80,975,1261
1,15/09/2022,0133-Chennai International Airport,175990,343628,1400,6984,145718,0,0,330092,7750,9955,17705,0,6250,6250,5822,3985,9807,6358,3704,10062,6328,50,729,8,0,23,208,3638,4656
2,15/09/2022,0201-Puratchi Thalaivar Dr. M.G. Ramachandran Central,310899,448540,1995,8968,103144,0,0,425006,19710,1570,21280,0,11750,11750,14392,3773,18165,10713,6876,17589,14029,86,4077,6,0,12,345,3307,7833
2,15/09/2022,0203-Egmore,80729,131532,400,2128,57450,0,0,140707,13425,3940,17365,0,9750,9750,2712,1946,4658,2833,2377,5210,2969,14,701,12,0,9,87,1893,2716
2,15/09/2022,0205-Nehru Park,48419,45489,700,1000,13654,0,0,63773,1135,1390,2525,0,2000,2000,1360,523,1883,1299,404,1703,1336,12,111,2,1,0,36,476,638
2,15/09/2022,0207-Kilpauk,49850,57212,100,1024,10060,0,0,61034,415,290,705,0,1000,1000,1796,399,2195,1666,523,2189,1874,14,275,0,0,1,45,348,683
2,15/09/2022,0209-Pachaiyappas College,52601,55187,350,680,14562,0,0,68193,1040,1030,2070,0,4000,4000,1835,529,2364,1704,380,2084,1711,14,122,1,0,3,26,533,699
2,15/09/2022,0211-Shenoy Nagar,46329,46901,0,912,11440,0,0,58681,1150,1630,2780,0,500,500,1318,438,1756,1468,414,1882,1456,8,43,1,0,0,34,390,476
2,15/09/2022,0213-Anna Nagar East,93001,113929,0,2240,30222,0,0,125463,1525,3755,5280,0,7500,7500,3240,1116,4356,3303,915,4218,3343,19,168,0,0,3,85,1006,1281
2,15/09/2022,0215-Anna Nagar Tower,92830,107108,700,1424,26660,0,0,121614,3615,6590,10205,0,10000,10000,2957,952,3909,3065,768,3833,3127,18,200,0,0,0,57,871,1146
2,15/09/2022,0217-Thirumangalam,251898,305787,2700,6272,77928,0,0,338798,80830,23645,104475,0,0,0,8430,2681,11111,8563,2290,10853,8595,54,419,5,0,4,217,2398,3097
2,15/09/2022,0219-Koyambedu,177326,244958,700,5688,80562,0,0,264276,10445,13460,23905,10000,8500,18500,6242,2794,9036,5727,2148,7875,6048,47,862,7,0,10,198,2501,3625
2,15/09/2022,0221-Puratchi Thalaivi Dr. J. Jayalalithaa CMBT,62931,154009,400,1752,70260,0,0,135343,0,0,0,0,0,0,2532,2332,4864,3638,3255,6893,3343,27,430,3,0,4,82,2222,2768
2,15/09/2022,0223-Arumbakkam,63221,63322,800,1008,22494,0,0,87523,1805,620,2425,0,6750,6750,1733,840,2573,1860,614,2474,1692,39,0,0,0,5,42,778,864
2,15/09/2022,0225-Vadapalani,144230,223509,2104,5624,67256,0,0,219214,30000,4940,34940,0,5500,5500,5597,2340,7937,5519,2481,8000,5985,47,926,4,0,11,213,2076,3277
2,15/09/2022,0227-Ashok Nagar,96347,143199,2900,3320,46682,0,0,149249,5215,7060,12275,0,8000,8000,3676,1651,5327,3775,1384,5159,3777,36,263,0,0,3,124,1481,1907
2,15/09/2022,0229-Ekkattuthangal,97211,136255,1400,2920,31080,0,0,132611,935,170,1105,0,500,500,3866,1143,5009,4141,981,5122,4229,23,252,0,0,1,103,972,1351
2,15/09/2022,0231-Arignar Anna Alandur,163973,198758,1600,4064,62438,0,0,232075,7205,11615,18820,0,6250,6250,5311,2081,7392,5229,1618,6847,5325,47,337,3,0,3,139,1875,2404
2,15/09/2022,0233-St. Thomas Mount,77662,109948,1100,3824,38720,0,0,121306,2870,3630,6500,250,3500,3750,2857,1284,4141,2876,885,3761,2800,33,5,0,0,5,115,1177,1335
1,16/09/2022,01ED-Wimco Nagar Depot Metro,82717,74076,500,904,22814,0,0,106935,280,555,835,0,750,750,2048,583,2631,1634,329,1963,1631,23,54,1,0,3,29,552,662
1,16/09/2022,01EF-Wimco Nagar Metro,116587,138409,50,3016,34190,0,0,153843,11805,7195,19000,0,250,250,3478,910,4388,3311,923,4234,3275,53,42,2,0,9,79,816,1001
1,16/09/2022,01F1-Thiruvotriyur Metro,111273,105430,0,1000,21590,0,0,133863,985,1555,2540,0,0,0,3002,579,3581,2868,450,3318,2803,59,0,1,0,8,30,546,644
1,16/09/2022,01F3-Thiruvotriyur Theradi Metro,100438,124468,1200,1584,33376,0,0,136598,835,2530,3365,0,0,0,2977,953,3930,3170,787,3957,3131,19,69,2,0,2,51,909,1052
1,16/09/2022,01F5-Kaladipet Metro,107610,106563,800,1496,24620,0,0,134526,795,2470,3265,0,0,0,3152,790,3942,3111,636,3747,3045,24,1,2,0,8,55,740,830
1,16/09/2022,01F7-Tollgate Metro,56616,55613,0,432,12976,0,0,70024,415,765,1180,0,0,0,1658,421,2079,1604,322,1926,1554,41,1,1,0,3,17,391,454
1,16/09/2022,01F9-New Washermenpet Metro,90855,96371,154,1000,23494,0,0,115503,1140,1765,2905,0,250,250,2875,804,3679,2962,702,3664,2931,14,39,3,0,4,35,772,867
1,16/09/2022,01FB-Tondiarpet Metro,83393,96370,800,856,23268,0,0,108317,6405,3195,9600,0,1750,1750,2898,784,3682,2961,768,3729,2884,23,4,1,0,3,32,748,811
1,16/09/2022,01FD-Thiagaraya College Metro,110384,124424,400,1336,30674,0,0,142794,3900,2575,6475,0,1500,1500,3788,1082,4870,3916,890,4806,3858,37,20,0,0,5,38,1029,1129
1,16/09/2022,0101-Washermanpet,87132,120286,500,1464,40586,0,0,129682,6385,3690,10075,0,3250,3250,3497,1385,4882,3304,1322,4626,3301,30,102,1,0,2,55,1317,1507
1,16/09/2022,0103-Mannadi,81909,115438,200,864,26442,0,0,109415,21905,5660,27565,0,0,0,3441,924,4365,3508,1031,4539,3686,12,297,2,0,0,39,876,1226
1,16/09/2022,0105-High Court,138958,238358,100,2352,73514,0,0,214924,885,1645,2530,0,0,0,6679,2573,9252,6787,1833,8620,6805,46,169,0,0,2,96,2438,2751
1,16/09/2022,0109-Government Estate,85991,150247,1050,1688,47784,0,0,136513,3665,2280,5945,0,3250,3250,4059,1698,5757,4473,1503,5976,4528,24,248,4,0,9,79,1573,1937
1,16/09/2022,0111-LIC,68730,176198,330,2104,35056,0,0,106220,1175,720,1895,0,0,0,4952,1261,6213,5773,977,6750,5686,17,0,1,0,1,86,1129,1234
1,16/09/2022,0113-Thousand Lights,126733,246186,1000,4712,44218,0,0,176663,345,345,690,0,0,0,7336,1612,8948,8135,1462,9597,8082,30,111,3,0,6,180,1421,1751
1,16/09/2022,0115-AG-DMS,93804,148634,901,1976,28976,0,0,125657,0,0,0,0,1000,1000,4656,997,5653,4618,736,5354,4729,22,177,0,0,2,79,889,1169
1,16/09/2022,0117-Teynampet,97694,153598,200,1760,34148,0,0,133802,0,0,0,0,500,500,4702,1259,5961,5112,950,6062,4980,38,0,1,0,4,72,1151,1266
1,16/09/2022,0119-Nandanam,83523,128284,300,2280,34592,0,0,120695,0,0,0,0,0,0,3687,1283,4970,4150,885,5035,4045,43,0,1,0,3,79,1148,1274
1,16/09/2022,0121-Saidapet,35218,82744,1000,1464,24944,0,0,62626,3490,1500,4990,0,500,500,2018,908,2926,2392,714,3106,2314,10,0,0,0,1,64,838,913
1,16/09/2022,0123-Little Mount,82532,98810,550,2008,28172,0,0,113262,3580,6495,10075,0,1000,1000,3344,1071,4415,2778,641,3419,2857,17,187,3,0,5,72,948,1232
1,16/09/2022,0125-Guindy,140127,278207,950,7536,85262,0,0,233875,5320,5330,10650,0,9500,9500,7880,2953,10833,7217,2391,9608,7619,42,647,2,0,8,264,2614,3577
1,16/09/2022,0129-Nanganallur Road,41450,48164,200,536,11094,0,0,53280,1520,5660,7180,0,0,0,1294,361,1655,1463,318,1781,1414,11,1,0,0,1,15,332,360
1,16/09/2022,0131-Meenambakkam,112446,141444,1000,2056,36498,0,0,152000,5570,15475,21045,0,0,0,4071,1071,5142,3475,912,4387,3562,33,231,1,0,2,63,986,1316
1,16/09/2022,0133-Chennai International Airport,175800,350710,620,9528,156104,0,0,342052,11270,9275,20545,0,3750,3750,6002,4305,10307,6527,3758,10285,6316,71,707,27,0,24,241,3882,4952
2,16/09/2022,0201-Puratchi Thalaivar Dr. M.G. Ramachandran Central,337641,499419,536,9072,104940,0,0,452189,14810,1910,16720,0,7300,7300,15207,3954,19161,11917,7988,19905,15688,93,4873,8,0,15,382,3374,8745
2,16/09/2022,0203-Egmore,78646,140370,550,2400,53648,0,0,135244,11425,3560,14985,0,7750,7750,2895,1804,4699,3207,2613,5820,3481,23,837,11,0,5,95,1779,2750
2,16/09/2022,0205-Nehru Park,42154,47985,2500,784,15428,0,0,60866,1770,2010,3780,0,4500,4500,1457,575,2032,1347,492,1839,1362,13,122,0,0,2,31,540,708
2,16/09/2022,0207-Kilpauk,35445,61624,200,1048,18922,0,0,55615,440,285,725,0,0,0,1617,706,2323,1693,519,2212,1708,6,91,0,0,0,47,650,794
2,16/09/2022,0209-Pachaiyappas College,46101,55407,500,984,15878,0,0,63463,930,860,1790,0,5000,5000,1734,626,2360,1653,499,2152,1651,9,81,2,0,2,39,579,712
2,16/09/2022,0211-Shenoy Nagar,37332,52068,100,776,13946,0,0,52154,1430,1650,3080,0,2000,2000,1422,503,1925,1573,439,2012,1538,7,62,0,0,9,29,460,567
2,16/09/2022,0213-Anna Nagar East,79546,117599,0,2168,30990,0,0,112704,935,3845,4780,0,1500,1500,3414,1171,4585,3378,992,4370,3469,25,229,1,0,4,90,1053,1402
2,16/09/2022,0215-Anna Nagar Tower,77908,106064,434,1504,29372,0,0,109218,2585,8905,11490,0,1000,1000,2811,1072,3883,2936,858,3794,2978,25,245,3,0,5,51,977,1306
2,16/09/2022,0217-Thirumangalam,250938,319744,1220,5728,79724,0,0,337610,74005,21110,95115,0,1500,1500,8805,2743,11548,8717,2499,11216,9026,54,786,6,0,7,206,2447,3506
2,16/09/2022,0219-Koyambedu,167994,237281,700,4024,82772,0,0,255490,8455,10395,18850,0,10250,10250,5978,2873,8851,5714,2138,7852,5718,41,650,9,0,8,155,2667,3530
2,16/09/2022,0221-Puratchi Thalaivi Dr. J. Jayalalithaa CMBT,62670,180150,200,2400,81268,0,0,146538,0,0,0,0,0,0,2500,2719,5219,4641,4317,8958,3930,27,418,4,0,9,103,2587,3148
2,16/09/2022,0223-Arumbakkam,49267,62823,142,1688,23998,0,0,75095,8305,365,8670,0,2250,2250,1709,888,2597,1803,720,2523,1632,39,0,2,0,4,48,826,919
2,16/09/2022,0225-Vadapalani,151415,229361,530,4648,63304,0,0,219897,31380,5380,36760,0,7000,7000,5977,2261,8238,5507,2667,8174,6286,47,1354,4,0,8,167,2000,3580
2,16/09/2022,0227-Ashok Nagar,101636,154291,1750,3960,49900,0,0,157246,6600,8505,15105,0,6000,6000,4008,1765,5773,3857,1444,5301,4014,32,432,1,0,3,142,1550,2160
2,16/09/2022,0229-Ekkattuthangal,79121,140886,500,3312,39896,0,0,122829,65,1820,1885,0,0,0,3860,1426,5286,3842,946,4788,4025,26,306,1,0,4,133,1231,1701
2,16/09/2022,0231-Arignar Anna Alandur,138919,208935,900,4480,65812,0,0,210111,7965,10640,18605,0,2500,2500,5672,2187,7859,5332,1722,7054,5570,47,519,5,0,6,169,1941,2687
2,16/09/2022,0233-St. Thomas Mount,75570,111104,200,3080,40650,0,0,119500,1440,2780,4220,0,4250,4250,2800,1364,4164,2846,871,3717,2750,26,41,0,0,1,112,1225,1405
1,17/09/2022,01ED-Wimco Nagar Depot Metro,68775,70291,300,1040,27538,0,0,97653,130,230,360,0,1250,1250,1733,684,2417,1440,376,1816,1355,14,0,3,0,10,28,653,708
1,17/09/2022,01EF-Wimco Nagar Metro,101806,128880,120,2600,33744,0,0,138270,11950,5600,17550,0,250,250,3023,894,3917,2885,1002,3887,2946,28,249,2,1,12,80,808,1180
1,17/09/2022,01F1-Thiruvotriyur Metro,97649,97967,0,1632,24734,0,0,124015,1170,1220,2390,0,0,0,2672,704,3376,2550,594,3144,2467,63,19,0,0,6,51,652,791
1,17/09/2022,01F3-Thiruvotriyur Theradi Metro,91771,118899,50,1952,34924,0,0,128697,1570,2445,4015,0,0,0,2642,1011,3653,2898,977,3875,2828,42,100,2,0,7,61,935,1147
1,17/09/2022,01F5-Kaladipet Metro,82246,92664,0,1304,25712,0,0,109262,925,1885,2810,0,0,0,2628,810,3438,2627,707,3334,2476,26,11,0,0,4,42,761,844
1,17/09/2022,01F7-Tollgate Metro,52267,54485,0,616,16612,0,0,69495,230,325,555,0,0,0,1474,512,1986,1449,440,1889,1382,30,8,0,0,12,21,491,562
1,17/09/2022,01F9-New Washermenpet Metro,86017,90072,130,1080,26120,0,0,113347,1825,1675,3500,0,250,250,2593,857,3450,2590,805,3395,2557,18,93,4,0,3,36,821,975
1,17/09/2022,01FB-Tondiarpet Metro,69329,93710,0,1336,28926,0,0,99591,5390,2255,7645,0,250,250,2373,969,3342,2670,801,3471,2525,22,1,1,0,7,43,923,997
1,17/09/2022,01FD-Thiagaraya College Metro,100261,116290,500,2536,33996,0,0,137293,4490,5345,9835,0,0,0,3317,1189,4506,3368,980,4348,3325,84,55,0,0,3,85,1099,1326
1,17/09/2022,0101-Washermanpet,108734,119461,0,2440,45338,0,0,156512,9220,8420,17640,0,24500,24500,3178,1574,4752,3093,1362,4455,3064,11,164,4,0,9,99,1458,1745
1,17/09/2022,0103-Mannadi,79897,107808,2650,1520,34644,0,0,118711,14110,5210,19320,0,0,0,2811,1208,4019,3044,1183,4227,3060,15,175,0,0,0,52,1150,1392
1,17/09/2022,0105-High Court,84957,200897,400,2928,77200,0,0,165485,1955,1775,3730,0,0,0,4746,2666,7412,4991,2010,7001,5004,27,333,0,0,5,112,2466,2943
1,17/09/2022,0109-Government Estate,83105,158920,1000,2408,55342,0,0,141855,4645,3400,8045,0,250,250,3936,1994,5930,4059,1820,5879,4383,25,669,5,0,3,95,1836,2633
1,17/09/2022,0111-LIC,84786,150403,520,2968,33998,0,0,122272,1005,760,1765,0,0,0,4100,1235,5335,4600,1044,5644,4652,26,139,0,0,4,110,1082,1361
1,17/09/2022,0113-Thousand Lights,98328,191937,1300,3816,52320,0,0,155764,575,365,940,0,0,0,4918,1877,6795,5902,1553,7455,5606,33,0,1,0,7,143,1659,1843
1,17/09/2022,0115-AG-DMS,68731,96302,300,1472,24202,0,0,94705,0,0,0,0,1000,1000,2626,820,3446,2760,649,3409,2820,14,167,2,0,4,59,740,986
1,17/09/2022,0117-Teynampet,72746,118306,0,1512,33866,0,0,108124,0,0,0,0,4000,4000,3283,1222,4505,3697,916,4613,3463,17,0,4,0,3,63,1127,1214
1,17/09/2022,0119-Nandanam,62992,92911,500,2016,31736,0,0,97244,85,0,85,0,0,0,2425,1161,3586,2657,755,3412,2542,33,4,5,0,7,69,1059,1177
1,17/09/2022,0121-Saidapet,33865,75260,0,1128,29752,0,0,64745,2280,2485,4765,0,0,0,1562,998,2560,1982,774,2756,1780,16,0,5,0,0,46,945,1012
1,17/09/2022,0123-Little Mount,66965,76378,1600,2104,26952,0,0,97621,3005,4385,7390,0,0,0,2229,982,3211,1840,720,2560,1931,19,221,5,0,8,72,869,1194
1,17/09/2022,0125-Guindy,123600,253888,330,5896,92764,0,0,222590,4490,4050,8540,0,1500,1500,6128,3094,9222,5607,2708,8315,6037,44,1080,1,0,9,220,2787,4141
1,17/09/2022,0129-Nanganallur Road,46557,44185,615,792,15120,0,0,63084,1565,4685,6250,0,0,0,971,474,1445,1160,363,1523,1059,12,0,0,1,8,23,447,491
1,17/09/2022,0131-Meenambakkam,124503,133425,400,2744,46684,0,0,174331,8330,14730,23060,0,0,0,3285,1346,4631,2847,1029,3876,2872,36,290,3,0,5,83,1238,1655
1,17/09/2022,0133-Chennai International Airport,171575,364219,1200,10736,176422,0,0,359933,17155,9345,26500,0,4500,4500,5423,4918,10341,5804,4382,10186,5873,62,1348,15,0,23,324,4297,6069
2,17/09/2022,0201-Puratchi Thalaivar Dr. M.G. Ramachandran Central,347479,491787,768,10024,96934,0,0,455205,17650,1985,19635,0,4000,4000,14711,3607,18318,10122,8216,18338,15077,80,6458,17,0,32,397,3004,9988
2,17/09/2022,0203-Egmore,97163,140866,200,2752,58150,0,0,158265,15705,2330,18035,0,13750,13750,2811,2024,4835,3155,2632,5787,3234,34,894,67,0,14,107,1902,3018
2,17/09/2022,0205-Nehru Park,34936,50929,0,600,19386,0,0,54922,2440,2060,4500,0,0,0,1352,652,2004,1254,560,1814,1331,12,223,0,0,3,28,656,922
2,17/09/2022,0207-Kilpauk,33066,57804,50,656,20028,0,0,53800,405,205,610,0,0,0,1534,710,2244,1588,536,2124,1526,9,116,0,0,2,33,662,822
2,17/09/2022,0209-Pachaiyappas College,44404,48637,0,664,15024,0,0,60092,3020,470,3490,0,2000,2000,1482,548,2030,1418,435,1853,1393,17,101,1,0,3,22,516,660
2,17/09/2022,0211-Shenoy Nagar,29181,46871,0,752,15324,0,0,45257,2190,1180,3370,0,0,0,1187,521,1708,1329,473,1802,1281,9,82,0,0,4,27,482,604
2,17/09/2022,0213-Anna Nagar East,69085,108158,120,2160,36364,0,0,107729,1335,2355,3690,0,0,0,2731,1303,4034,2873,1063,3936,2846,12,277,0,0,6,76,1205,1576
2,17/09/2022,0215-Anna Nagar Tower,75229,106126,300,1944,34204,0,0,111677,7885,5470,13355,0,0,0,2670,1212,3882,2709,1044,3753,2761,22,336,0,0,4,75,1113,1550
2,17/09/2022,0217-Thirumangalam,238008,302761,1100,6616,96390,0,0,342114,145150,17045,162195,0,500,500,7477,3254,10731,7285,2960,10245,7626,58,1232,6,0,11,242,2931,4480
2,17/09/2022,0219-Koyambedu,155909,224788,1200,4768,96654,0,0,258531,11425,6405,17830,0,12750,12750,4810,3299,8109,4641,2275,6916,4728,44,907,3,0,10,181,3014,4159
2,17/09/2022,0221-Puratchi Thalaivi Dr. J. Jayalalithaa CMBT,73014,186640,0,2728,89018,0,0,164760,0,0,0,0,0,0,2677,2941,5618,4082,4038,8120,3697,37,867,5,0,2,112,2772,3795
2,17/09/2022,0223-Arumbakkam,41217,60221,200,1056,28258,0,0,70731,1715,355,2070,0,250,250,1348,1019,2367,1477,774,2251,1313,39,14,0,0,2,47,952,1054
2,17/09/2022,0225-Vadapalani,131218,252384,800,6760,96110,0,0,234888,39630,7470,47100,0,1500,1500,5462,3418,8880,5423,3583,9006,5948,35,1463,6,0,11,284,3024,4823
2,17/09/2022,0227-Ashok Nagar,81080,144290,630,4504,55298,0,0,141512,5705,6545,12250,0,3000,3000,3430,1938,5368,3398,1600,4998,3498,35,539,5,0,0,155,1725,2459
2,17/09/2022,0229-Ekkattuthangal,59923,92664,200,1920,32766,0,0,94809,315,655,970,0,1250,1250,2317,1156,3473,2385,873,3258,2438,24,369,0,0,8,79,1027,1507
2,17/09/2022,0231-Arignar Anna Alandur,131106,203038,500,4576,81024,0,0,217206,10165,7720,17885,0,3250,3250,4598,2637,7235,4405,2268,6673,4595,71,822,14,0,8,158,2304,3377
2,17/09/2022,0233-St. Thomas Mount,66867,114622,100,2976,55710,0,0,125653,2240,1245,3485,0,250,250,2241,1767,4008,2596,1127,3723,2257,29,16,5,0,6,103,1655,1814
1,18/09/2022,01ED-Wimco Nagar Depot Metro,36686,55212,0,168,27028,0,0,63882,95,85,180,0,0,0,933,614,1547,998,379,1377,870,16,0,3,0,15,6,625,665
1,18/09/2022,01EF-Wimco Nagar Metro,54886,78734,600,1208,38778,0,0,95472,13200,4200,17400,0,0,0,1240,932,2172,1311,842,2153,1217,61,76,4,0,15,30,884,1070
1,18/09/2022,01F1-Thiruvotriyur Metro,55671,68484,0,632,29834,0,0,86137,1295,835,2130,0,0,0,1157,763,1920,1352,618,1970,1255,29,29,1,0,7,19,756,841
1,18/09/2022,01F3-Thiruvotriyur Theradi Metro,64883,88999,0,944,39746,0,0,105573,1005,1090,2095,0,0,0,1533,1066,2599,1690,888,2578,1619,46,129,2,0,11,32,1018,1238
1,18/09/2022,01F5-Kaladipet Metro,43970,61325,0,528,27868,0,0,72366,940,1240,2180,0,0,0,1208,815,2023,1365,608,1973,1210,18,0,0,0,8,16,790,832
1,18/09/2022,01F7-Tollgate Metro,28463,44736,100,288,21138,0,0,49989,125,220,345,0,0,0,790,613,1403,924,473,1397,805,24,1,0,0,20,11,596,652
1,18/09/2022,01F9-New Washermenpet Metro,48801,56349,50,184,25692,0,0,74727,1535,1020,2555,0,1000,1000,1163,777,1940,1230,609,1839,1167,15,65,3,0,4,7,764,858
1,18/09/2022,01FB-Tondiarpet Metro,47849,58985,0,608,27492,0,0,75949,2820,1585,4405,0,0,0,1160,846,2006,1295,787,2082,1181,18,1,0,0,16,21,811,867
1,18/09/2022,01FD-Thiagaraya College Metro,61864,81174,100,1256,39174,0,0,102394,4990,3725,8715,0,1000,1000,1567,1169,2736,1639,870,2509,1577,37,59,2,0,6,30,1112,1246
1,18/09/2022,0101-Washermanpet,53334,80874,0,528,44592,0,0,98454,9405,3400,12805,0,12000,12000,1326,1370,2696,1398,1191,2589,1321,16,166,5,0,11,22,1332,1552
1,18/09/2022,0103-Mannadi,35560,64613,100,376,35718,0,0,71754,29635,2145,31780,0,1500,1500,1048,1143,2191,1210,1088,2298,1136,18,178,0,0,4,18,1143,1361
1,18/09/2022,0105-High Court,26605,72869,200,456,39514,0,0,66775,800,975,1775,0,0,0,1290,1346,2636,1301,1163,2464,1317,14,207,2,0,3,20,1305,1551
1,18/09/2022,0109-Government Estate,49679,96311,390,624,48558,0,0,99251,2200,1870,4070,0,5000,5000,1732,1642,3374,1838,1433,3271,1872,18,384,3,0,20,25,1544,1994
1,18/09/2022,0111-LIC,19043,48723,0,120,25564,0,0,44727,845,215,1060,0,2000,2000,771,836,1607,1051,611,1662,899,10,3,0,0,5,3,796,817
1,18/09/2022,0113-Thousand Lights,35361,78203,0,616,35752,0,0,71729,270,115,385,0,0,0,1492,1189,2681,1835,1171,3006,1647,17,216,0,0,16,23,1110,1382
1,18/09/2022,0115-AG-DMS,23228,39460,0,224,17464,0,0,40916,0,0,0,0,0,0,783,554,1337,804,462,1266,807,13,143,2,0,1,9,507,675
1,18/09/2022,0117-Teynampet,22863,38784,100,240,18274,0,0,41477,0,0,0,0,1000,1000,686,638,1324,983,684,1667,805,16,0,1,0,7,10,599,633
1,18/09/2022,0119-Nandanam,22465,43893,100,208,26338,0,0,49111,45,0,45,0,0,0,734,898,1632,901,658,1559,713,23,0,6,0,7,9,865,910
1,18/09/2022,0121-Saidapet,22198,47583,0,512,26810,0,0,49520,2995,505,3500,0,2250,2250,700,861,1561,919,736,1655,749,16,0,0,0,9,24,821,870
1,18/09/2022,0123-Little Mount,32495,54373,400,736,24770,0,0,58401,7335,2410,9745,0,0,0,1166,842,2008,1122,660,1782,1123,19,233,4,0,6,27,772,1061
1,18/09/2022,0125-Guindy,63032,155208,400,2472,87038,0,0,152942,7050,2365,9415,0,0,0,2386,2808,5194,2589,2412,5001,2411,42,570,0,0,17,71,2578,3278
1,18/09/2022,0129-Nanganallur Road,12574,20998,130,312,11478,0,0,24494,1235,2075,3310,0,0,0,323,351,674,448,241,689,347,3,0,0,0,0,12,332,347
1,18/09/2022,0131-Meenambakkam,49236,74408,100,1480,38960,0,0,89776,9060,6560,15620,0,0,0,1252,1064,2316,1106,854,1960,1124,31,275,11,0,4,38,1033,1392
1,18/09/2022,0133-Chennai International Airport,122633,329120,400,7928,197000,0,0,327961,14935,3625,18560,0,0,0,3575,5383,8958,4435,4301,8736,4031,56,1097,26,1,33,220,4554,5987
2,18/09/2022,0201-Puratchi Thalaivar Dr. M.G. Ramachandran Central,276811,393915,600,5632,103272,0,0,386315,23125,4535,27660,0,3250,3250,10265,3465,13730,5084,7668,12752,10134,49,6347,18,0,40,201,3045,9700
2,18/09/2022,0203-Egmore,81261,115942,100,1600,46198,0,0,129159,11800,1885,13685,0,10500,10500,2480,1420,3900,2007,2254,4261,2634,18,1256,4,0,20,62,1467,2827
2,18/09/2022,0205-Nehru Park,18310,32610,200,56,18810,0,0,37376,1120,800,1920,0,2000,2000,571,619,1190,577,415,992,551,7,131,2,0,0,3,622,765
2,18/09/2022,0207-Kilpauk,17005,31773,100,136,17136,0,0,34377,135,40,175,0,0,0,559,575,1134,599,452,1051,578,3,103,2,0,2,6,565,681
2,18/09/2022,0209-Pachaiyappas College,36016,28893,0,80,12608,0,0,48704,940,1210,2150,0,20000,20000,638,458,1096,662,383,1045,641,11,91,0,0,7,4,439,552
2,18/09/2022,0211-Shenoy Nagar,17381,25629,100,224,10664,0,0,28369,2700,920,3620,0,0,0,555,362,917,600,344,944,588,5,104,3,0,4,10,342,468
2,18/09/2022,0213-Anna Nagar East,39415,62666,0,400,30434,0,0,70249,1330,1525,2855,0,0,0,1273,994,2267,1328,748,2076,1242,12,225,1,0,3,16,954,1211
2,18/09/2022,0215-Anna Nagar Tower,38855,68337,200,416,30462,0,0,69933,4010,2410,6420,0,0,0,1409,1007,2416,1509,773,2282,1432,22,269,0,0,6,18,958,1273
2,18/09/2022,0217-Thirumangalam,121436,205227,650,1528,104628,0,0,228242,98955,5890,104845,0,0,0,3655,3295,6950,3874,2769,6643,3627,62,796,8,0,17,53,3100,4036
2,18/09/2022,0219-Koyambedu,76920,156991,100,1256,92674,0,0,170950,9940,5190,15130,0,250,250,2542,3087,5629,2664,2139,4803,2389,34,637,12,0,15,55,2881,3634
2,18/09/2022,0221-Puratchi Thalaivi Dr. J. Jayalalithaa CMBT,59231,155709,0,984,90548,0,0,150763,0,0,0,0,0,0,2067,2914,4981,2634,3460,6094,2385,26,845,8,0,17,43,2820,3759
2,18/09/2022,0223-Arumbakkam,24987,40375,200,432,25148,0,0,50767,1035,245,1280,0,4000,4000,667,885,1552,878,622,1500,651,31,0,1,0,9,17,842,900
2,18/09/2022,0225-Vadapalani,109160,215422,700,1112,99646,0,0,210618,45560,6890,52450,0,2500,2500,4194,2962,7156,3745,3664,7409,4279,49,1687,5,0,18,44,2940,4743
2,18/09/2022,0227-Ashok Nagar,62895,92183,700,1656,48458,0,0,113709,7225,4005,11230,0,9000,9000,1634,1593,3227,1715,1341,3056,1669,19,373,3,0,8,52,1483,1938
2,18/09/2022,0229-Ekkattuthangal,36795,52560,100,392,23890,0,0,61177,115,495,610,0,0,0,1081,804,1885,1256,755,2011,1160,9,300,6,0,4,19,753,1091
2,18/09/2022,0231-Arignar Anna Alandur,80875,131116,0,1016,68036,0,0,149927,10935,3950,14885,0,250,250,2206,2130,4336,2325,1758,4083,2251,44,554,5,0,19,35,1965,2622
2,18/09/2022,0233-St. Thomas Mount,37943,85460,100,1160,57416,0,0,96619,3550,3285,6835,0,500,500,1016,1786,2802,1457,1191,2648,1045,27,6,3,0,10,42,1689,1777
1,19/09/2022,01ED-Wimco Nagar Depot Metro,91200,75812,100,504,24614,0,0,116418,280,265,545,0,3000,3000,1979,587,2566,1694,357,2051,1622,19,0,1,0,7,16,620,663
1,19/09/2022,01EF-Wimco Nagar Metro,144636,141286,800,1104,35228,0,0,181768,18700,7755,26455,0,0,0,3594,857,4451,3367,829,4196,3313,52,93,1,0,8,29,849,1032
1,19/09/2022,01F1-Thiruvotriyur Metro,130393,104363,101,704,21778,0,0,152976,1250,1795,3045,0,0,0,2907,618,3525,2819,498,3317,2759,44,0,1,0,2,22,594,663
1,19/09/2022,01F3-Thiruvotriyur Theradi Metro,119246,118802,100,664,24998,0,0,145008,1060,2905,3965,0,0,0,2876,729,3605,3185,814,3999,3186,26,146,2,0,1,18,681,874
1,19/09/2022,01F5-Kaladipet Metro,140481,101890,0,680,21516,0,0,162677,1115,2565,3680,0,0,0,3041,676,3717,3105,611,3716,2989,26,0,1,0,4,14,655,700
1,19/09/2022,01F7-Tollgate Metro,80039,58126,0,160,14880,0,0,95079,110,75,185,0,0,0,1663,446,2109,1643,358,2001,1572,31,1,0,0,5,5,436,478
1,19/09/2022,01F9-New Washermenpet Metro,126867,98949,300,592,24142,0,0,151901,1150,1830,2980,0,1750,1750,2934,808,3742,3085,698,3783,3013,25,41,3,0,0,24,786,879
1,19/09/2022,01FB-Tondiarpet Metro,112202,102062,1500,560,25498,0,0,139760,7430,3545,10975,0,500,500,2919,812,3731,3107,732,3839,3009,30,0,0,0,3,22,779,834
1,19/09/2022,01FD-Thiagaraya College Metro,142249,120842,2000,784,30290,0,0,175323,4845,5110,9955,0,3000,3000,3701,1053,4754,3804,834,4638,3727,30,18,3,0,2,29,1007,1089
1,19/09/2022,0101-Washermanpet,127510,123692,2446,1304,37664,0,0,168924,6550,3585,10135,0,18000,18000,3667,1283,4950,3450,1276,4726,3534,35,213,2,0,1,49,1221,1521
1,19/09/2022,0103-Mannadi,93493,112514,400,920,29578,0,0,124391,11055,7710,18765,0,1500,1500,3164,1017,4181,3532,1094,4626,3496,22,80,1,0,2,37,972,1114
1,19/09/2022,0105-High Court,168555,255583,600,2704,79680,0,0,251539,1455,1620,3075,0,0,0,7085,2801,9886,7145,2124,9269,7184,45,290,2,0,6,112,2664,3119
1,19/09/2022,0109-Government Estate,110832,155330,1250,1448,52216,0,0,165746,3600,3785,7385,0,3500,3500,3935,1836,5771,4483,1456,5939,4506,25,274,1,0,8,65,1733,2106
1,19/09/2022,0111-LIC,94742,178372,1222,2024,34910,0,0,132898,1115,815,1930,0,0,0,5047,1262,6309,5950,943,6893,5800,30,0,0,0,2,79,1140,1251
1,19/09/2022,0113-Thousand Lights,155275,251794,2462,3680,47336,0,0,208753,705,240,945,0,0,0,7404,1688,9092,8507,1342,9849,8258,38,0,4,0,6,143,1553,1744
1,19/09/2022,0115-AG-DMS,112158,146609,930,1824,24638,0,0,139550,0,0,0,0,0,0,4730,876,5606,4784,664,5448,4789,45,118,0,0,1,71,770,1005
1,19/09/2022,0117-Teynampet,121770,148800,2150,1552,29482,0,0,154954,0,0,0,0,0,0,4645,1090,5735,5178,908,6086,4975,35,13,1,0,1,49,1014,1113
1,19/09/2022,0119-Nandanam,100940,130878,1416,1936,30784,0,0,135076,95,0,95,0,4000,4000,3897,1135,5032,4478,825,5303,4289,48,0,0,0,11,75,1048,1182
1,19/09/2022,0121-Saidapet,63063,82801,0,640,24498,0,0,88201,1840,1510,3350,0,4500,4500,1958,857,2815,2491,698,3189,2342,18,0,3,0,0,26,815,862
1,19/09/2022,0123-Little Mount,90321,94002,310,1648,24320,0,0,116599,4470,6685,11155,0,1000,1000,3221,938,4159,2854,668,3522,2838,22,162,1,0,1,54,839,1079
1,19/09/2022,0125-Guindy,148383,265747,2160,5656,78394,0,0,234593,8340,7305,15645,0,4500,4500,7682,2685,10367,7497,2270,9767,7424,49,386,2,0,4,151,2460,3052
1,19/09/2022,0129-Nanganallur Road,56873,49227,0,1048,11934,0,0,69855,1705,5965,7670,0,0,0,1358,374,1732,1515,298,1813,1432,10,0,1,0,4,13,353,381
1,19/09/2022,0131-Meenambakkam,159909,140834,750,1752,37530,0,0,199941,10045,16150,26195,0,0,0,3960,1078,5038,3494,917,4411,3516,28,191,3,0,1,51,1014,1288
1,19/09/2022,0133-Chennai International Airport,182698,340770,300,6408,149832,0,0,339238,10590,11320,21910,0,6000,6000,5786,4087,9873,6491,3419,9910,6195,63,561,9,0,15,171,3702,4521
2,19/09/2022,0201-Puratchi Thalaivar Dr. M.G. Ramachandran Central,390621,484063,1064,7248,79060,0,0,477993,30640,4005,34645,0,8900,8900,17202,2846,20048,10726,7254,17980,16049,123,6113,6,0,12,268,2442,8964
2,19/09/2022,0203-Egmore,92999,137839,300,1448,64282,0,0,159029,19095,3990,23085,0,11000,11000,2902,2136,5038,2806,2408,5214,2897,35,624,16,0,9,62,2094,2840
2,19/09/2022,0205-Nehru Park,49547,45624,0,552,13844,0,0,63943,995,2415,3410,0,2000,2000,1433,513,1946,1346,453,1799,1339,11,112,0,0,0,22,478,623
2,19/09/2022,0207-Kilpauk,44149,62446,450,840,19376,0,0,64815,470,305,775,0,0,0,1655,687,2342,1760,541,2301,1743,14,95,1,0,3,35,639,787
2,19/09/2022,0209-Pachaiyappas College,61311,56800,750,368,16168,0,0,78597,1100,1670,2770,0,14000,14000,1769,619,2388,1810,452,2262,1721,18,100,3,0,3,19,583,726
2,19/09/2022,0211-Shenoy Nagar,46223,50987,0,680,13014,0,0,59917,1360,1590,2950,0,2000,2000,1429,472,1901,1586,407,1993,1543,16,72,0,0,4,29,428,549
2,19/09/2022,0213-Anna Nagar East,110218,114564,100,1240,29158,0,0,140716,1020,4200,5220,0,3000,3000,3237,1066,4303,3428,862,4290,3392,29,203,0,0,2,53,990,1277
2,19/09/2022,0215-Anna Nagar Tower,101186,111081,1870,1408,28024,0,0,132488,6640,8790,15430,0,500,500,3070,1001,4071,3240,819,4059,3228,19,174,0,0,2,48,934,1177
2,19/09/2022,0217-Thirumangalam,320457,302503,2082,3672,74736,0,0,400947,56360,22070,78430,0,0,0,8422,2474,10896,8653,2255,10908,8586,61,571,6,0,1,126,2283,3048
2,19/09/2022,0219-Koyambedu,206905,243075,100,3104,88188,0,0,298297,18620,13020,31640,2000,12500,14500,6122,2961,9083,5737,2038,7775,5688,65,558,8,0,15,114,2789,3549
2,19/09/2022,0221-Puratchi Thalaivi Dr. J. Jayalalithaa CMBT,92857,193097,0,1832,91474,0,0,186163,0,0,0,0,0,0,3308,2909,6217,3666,3186,6852,3845,51,952,9,0,4,79,2786,3881
2,19/09/2022,0223-Arumbakkam,69528,64612,0,672,24260,0,0,94460,1120,885,2005,0,6750,6750,1666,869,2535,1870,629,2499,1686,26,0,8,0,2,25,836,897
2,19/09/2022,0225-Vadapalani,153331,210122,505,4184,60450,0,0,218470,24540,5240,29780,0,7000,7000,5362,2036,7398,5419,2238,7657,5732,49,968,8,0,7,124,1878,3034
2,19/09/2022,0227-Ashok Nagar,114412,146242,364,2368,47838,0,0,164982,9725,9860,19585,0,10500,10500,3697,1599,5296,4040,1302,5342,3857,28,244,4,0,7,78,1464,1825
2,19/09/2022,0229-Ekkattuthangal,99981,135683,1129,1624,29336,0,0,132070,0,2190,2190,0,1500,1500,3669,1050,4719,4362,968,5330,4254,23,237,0,0,2,69,915,1246
2,19/09/2022,0231-Arignar Anna Alandur,201865,200214,100,1720,59890,0,0,263575,9540,10485,20025,0,5500,5500,5690,1955,7645,5320,1573,6893,5444,48,492,1,0,9,72,1795,2417
2,19/09/2022,0233-St. Thomas Mount,84968,111828,0,2040,36456,0,0,123464,3420,2920,6340,0,5500,5500,2855,1204,4059,3052,902,3954,2921,24,27,0,0,7,69,1109,1236
1,20/09/2022,01ED-Wimco Nagar Depot Metro,80936,72680,500,896,19096,0,0,101428,215,270,485,0,2500,2500,2072,457,2529,1647,319,1966,1693,11,59,1,0,3,27,475,576
1,20/09/2022,01EF-Wimco Nagar Metro,134115,132190,1050,2000,27896,0,0,165061,14525,7240,21765,0,2500,2500,3438,751,4189,3197,724,3921,3244,39,106,2,0,5,58,687,897
1,20/09/2022,01F1-Thiruvotriyur Metro,121830,104233,500,976,20752,0,0,144058,1140,1575,2715,0,0,0,2870,580,3450,2862,470,3332,2805,29,0,2,0,4,30,547,612
1,20/09/2022,01F3-Thiruvotriyur Theradi Metro,101866,115372,1000,1592,26036,0,0,130494,900,3050,3950,0,0,0,2826,771,3597,3106,673,3779,3074,11,37,2,0,1,47,700,798
1,20/09/2022,01F5-Kaladipet Metro,108406,96136,8,936,19088,0,0,128438,860,2365,3225,0,0,0,3018,610,3628,2948,525,3473,2892,37,2,0,0,0,29,578,646
1,20/09/2022,01F7-Tollgate Metro,56452,52788,200,568,10970,0,0,68190,85,510,595,0,0,0,1599,356,1955,1580,322,1902,1544,24,2,0,0,2,18,328,374
1,20/09/2022,01F9-New Washermenpet Metro,95716,93359,0,680,20048,0,0,116444,1380,2395,3775,0,500,500,2944,681,3625,2961,693,3654,2932,19,33,4,0,3,21,658,738
1,20/09/2022,01FB-Tondiarpet Metro,90023,98122,70,880,21192,0,0,112165,3240,3860,7100,0,0,0,2884,716,3600,3064,648,3712,3012,16,1,1,0,2,29,669,718
1,20/09/2022,01FD-Thiagaraya College Metro,113663,115900,0,1856,25556,0,0,141075,5540,2830,8370,0,500,500,3700,962,4662,3795,821,4616,3757,50,19,1,0,3,39,915,1027
1,20/09/2022,0101-Washermanpet,112616,121659,600,1448,38680,0,0,153344,7485,4335,11820,0,9750,9750,3588,1375,4963,3406,1111,4517,3422,22,86,0,0,2,62,1295,1467
1,20/09/2022,0103-Mannadi,96433,109796,200,1312,26960,0,0,124905,12260,6550,18810,0,0,0,3221,942,4163,3513,1015,4528,3478,23,56,1,0,0,34,900,1014
1,20/09/2022,0105-High Court,154817,247496,500,2696,69670,0,0,227683,1485,1900,3385,0,0,0,7269,2409,9678,7237,1970,9207,7296,41,207,0,0,4,95,2289,2636
1,20/09/2022,0109-Government Estate,91664,144247,790,2040,44700,0,0,139194,4085,2695,6780,0,750,750,3879,1602,5481,4360,1419,5779,4436,31,228,0,0,3,73,1474,1809
1,20/09/2022,0111-LIC,92074,173468,1324,1848,29388,0,0,124634,2035,670,2705,0,250,250,5104,1068,6172,5876,942,6818,5810,32,4,6,0,4,74,953,1073
1,20/09/2022,0113-Thousand Lights,154107,244768,1200,3816,36500,0,0,195623,550,430,980,0,250,250,7598,1375,8973,8296,1346,9642,8375,28,167,1,0,4,163,1154,1517
1,20/09/2022,0115-AG-DMS,121209,148056,150,1640,24148,0,0,147147,0,0,0,0,0,0,4937,844,5781,4801,712,5513,4875,26,139,0,0,2,60,766,993
1,20/09/2022,0117-Teynampet,93246,147981,1500,1624,25576,0,0,121946,0,0,0,0,0,0,4748,993,5741,5191,892,6083,5117,39,54,0,0,1,66,893,1053
1,20/09/2022,0119-Nandanam,105117,127938,800,1600,27984,0,0,135501,145,5,150,0,2000,2000,3960,1054,5014,4389,806,5195,4280,46,0,1,0,9,69,971,1096
1,20/09/2022,0121-Saidapet,48815,80840,100,1200,21832,0,0,71947,1865,2250,4115,0,2250,2250,2012,783,2795,2450,609,3059,2382,13,0,2,0,2,45,739,801
1,20/09/2022,0123-Little Mount,89396,93640,900,1320,23550,0,0,115166,4100,6530,10630,0,250,250,3313,889,4202,2790,658,3448,2848,29,152,0,0,1,58,792,1032
1,20/09/2022,0125-Guindy,131420,248112,1510,4992,67916,0,0,205838,5045,6770,11815,0,1500,1500,7539,2452,9991,7130,2039,9169,7221,42,284,5,0,3,190,2137,2661
1,20/09/2022,0129-Nanganallur Road,42620,47676,40,536,10250,0,0,53446,990,6350,7340,0,0,0,1357,326,1683,1451,267,1718,1415,7,1,0,0,1,18,297,324
1,20/09/2022,0131-Meenambakkam,138828,136882,1370,1928,32214,0,0,174340,6710,17510,24220,0,0,0,4100,940,5040,3447,808,4255,3583,22,179,6,0,1,63,853,1124
1,20/09/2022,0133-Chennai International Airport,182601,321454,254,7664,140356,0,0,330875,10135,12075,22210,0,5250,5250,5395,3839,9234,6082,3336,9418,5936,58,476,12,0,11,197,3544,4298
2,20/09/2022,0201-Puratchi Thalaivar Dr. M.G. Ramachandran Central,312715,431755,1455,9384,94840,0,0,418394,16025,2470,18495,0,4900,4900,14308,3497,17805,10529,6354,16883,13829,104,3748,12,0,16,366,3075,7321
2,20/09/2022,0203-Egmore,80571,120657,500,2360,52148,0,0,135579,11610,3630,15240,0,10000,10000,2633,1739,4372,2554,2329,4883,2781,28,575,10,0,10,89,1733,2445
2,20/09/2022,0205-Nehru Park,37613,47005,100,656,15004,0,0,53373,1280,2555,3835,0,2500,2500,1373,545,1918,1317,429,1746,1344,9,95,0,0,0,27,510,641
2,20/09/2022,0207-Kilpauk,36916,56105,0,872,15806,0,0,53594,475,250,725,0,0,0,1575,589,2164,1633,532,2165,1636,20,68,2,0,4,38,533,665
2,20/09/2022,0209-Pachaiyappas College,42397,52444,0,688,13406,0,0,56491,890,560,1450,0,0,0,1713,542,2255,1692,462,2154,1665,12,66,1,0,2,31,501,613
2,20/09/2022,0211-Shenoy Nagar,45457,46492,0,512,9822,0,0,55791,4030,2430,6460,0,500,500,1359,371,1730,1511,360,1871,1507,10,63,0,0,1,21,345,440
2,20/09/2022,0213-Anna Nagar East,99113,112775,100,2744,27192,0,0,129149,1915,3955,5870,0,0,0,3305,1034,4339,3344,824,4168,3429,26,189,1,0,2,86,922,1226
2,20/09/2022,0215-Anna Nagar Tower,105152,108091,0,1600,26690,0,0,133442,1905,8580,10485,0,500,500,3022,959,3981,3176,792,3968,3169,24,155,0,0,0,57,888,1124
2,20/09/2022,0217-Thirumangalam,277350,300234,1000,5432,69344,0,0,353126,60860,21745,82605,0,3000,3000,8455,2376,10831,8704,2214,10918,8724,66,414,1,0,5,197,2123,2806
2,20/09/2022,0219-Koyambedu,206228,229512,1600,4112,77970,0,0,289910,8840,10120,18960,0,6500,6500,5812,2650,8462,5535,1840,7375,5567,72,400,6,6,6,135,2441,3066
2,20/09/2022,0221-Puratchi Thalaivi Dr. J. Jayalalithaa CMBT,62068,155655,200,2032,75512,0,0,139812,0,0,0,0,0,0,2361,2480,4841,3399,2931,6330,3207,39,310,7,0,5,81,2373,2815
2,20/09/2022,0223-Arumbakkam,54548,61627,0,952,21494,0,0,76994,1520,810,2330,0,2250,2250,1674,777,2451,1741,619,2360,1649,24,0,1,0,6,38,728,797
2,20/09/2022,0225-Vadapalani,131059,213375,200,4016,60050,0,0,195325,17520,4230,21750,0,1500,1500,5432,2072,7504,5275,2290,7565,5812,54,897,0,0,4,151,1891,2997
2,20/09/2022,0227-Ashok Nagar,96816,137794,320,2152,43782,0,0,143070,4275,8660,12935,0,3000,3000,3619,1497,5116,3780,1244,5024,3714,26,165,3,0,1,95,1351,1641
2,20/09/2022,0229-Ekkattuthangal,89669,131428,2380,2168,25928,0,0,120145,540,85,625,0,0,0,3907,953,4860,4121,939,5060,4248,20,257,1,0,1,88,820,1187
2,20/09/2022,0231-Arignar Anna Alandur,148585,189579,100,3304,49090,0,0,201079,7890,12640,20530,0,3000,3000,5466,1631,7097,5229,1504,6733,5444,46,440,3,0,3,127,1481,2100
2,20/09/2022,0233-St. Thomas Mount,95052,104048,554,2544,31112,0,0,129262,6635,2825,9460,0,7875,7875,2879,1051,3930,2991,748,3739,2880,25,11,0,0,0,73,951,1060
1,21/09/2022,01ED-Wimco Nagar Depot Metro,72555,72610,200,1016,23212,0,0,96983,60,285,345,0,2750,2750,1944,537,2481,1614,368,1982,1580,17,0,2,0,0,29,575,623
1,21/09/2022,01EF-Wimco Nagar Metro,116119,135104,500,2328,30362,0,0,149309,9570,7095,16665,0,500,500,3563,811,4374,3254,743,3997,3268,55,74,4,0,7,61,735,936
1,21/09/2022,01F1-Thiruvotriyur Metro,119722,103333,0,1536,20990,0,0,142248,880,1525,2405,0,0,0,2867,599,3466,2793,503,3296,2749,34,0,0,0,4,49,551,638
1,21/09/2022,01F3-Thiruvotriyur Theradi Metro,104402,117661,200,1976,25822,0,0,132400,765,2745,3510,0,0,0,2890,745,3635,3178,794,3972,3164,37,58,3,0,6,42,689,835
1,21/09/2022,01F5-Kaladipet Metro,102437,99415,50,1360,20840,0,0,124687,1285,2495,3780,0,0,0,3010,661,3671,2967,584,3551,2921,24,0,0,0,4,46,616,690
1,21/09/2022,01F7-Tollgate Metro,61847,57784,0,768,12902,0,0,75517,330,770,1100,0,0,0,1677,408,2085,1654,333,1987,1635,18,0,0,0,6,27,374,425
1,21/09/2022,01F9-New Washermenpet Metro,96857,93838,0,688,19650,0,0,117195,1090,1940,3030,0,500,500,2942,682,3624,2993,683,3676,2993,11,57,0,0,1,24,659,752
1,21/09/2022,01FB-Tondiarpet Metro,89898,100351,0,1400,25026,0,0,116324,2300,3495,5795,0,1750,1750,2842,834,3676,3015,766,3781,2962,22,1,1,0,1,40,786,851
1,21/09/2022,01FD-Thiagaraya College Metro,108992,125064,100,1744,30722,0,0,141558,3295,2540,5835,0,2000,2000,3778,1123,4901,3891,869,4760,3889,36,24,1,0,2,56,1054,1173
1,21/09/2022,0101-Washermanpet,95176,120138,1150,1688,37112,0,0,135126,7260,3740,11000,0,10750,10750,3641,1311,4952,3347,1234,4581,3427,21,104,0,0,4,72,1238,1439
1,21/09/2022,0103-Mannadi,91145,114930,500,888,29424,0,0,121957,5050,8380,13430,0,1500,1500,3210,999,4209,3615,1012,4627,3585,19,75,1,0,1,27,964,1087
1,21/09/2022,0105-High Court,150973,241377,150,2688,69938,0,0,223749,1260,1625,2885,0,0,0,7040,2460,9500,7008,1838,8846,7067,27,175,2,0,1,107,2311,2623
1,21/09/2022,0109-Government Estate,90621,148110,0,1784,44986,0,0,137391,3450,3350,6800,0,1750,1750,3967,1631,5598,4418,1483,5901,4517,25,249,7,0,5,74,1493,1853
1,21/09/2022,0111-LIC,75376,152375,25,3488,29070,0,0,107959,3570,695,4265,0,1000,1000,4371,1064,5435,5046,902,5948,5005,19,0,0,0,1,81,946,1047
1,21/09/2022,0113-Thousand Lights,121633,248941,1300,3832,42152,0,0,168917,750,390,1140,0,0,0,7516,1573,9089,8328,1342,9670,8309,36,132,0,0,3,165,1348,1684
1,21/09/2022,0115-AG-DMS,124942,154839,200,2048,27816,0,0,155006,0,0,0,0,2000,2000,5098,994,6092,4939,802,5741,5024,37,166,2,0,0,82,882,1169
1,21/09/2022,0117-Teynampet,100199,149575,1540,1704,27854,0,0,131297,0,0,0,0,250,250,4801,1064,5865,5174,914,6088,5088,36,17,1,0,1,67,962,1084
1,21/09/2022,0119-Nandanam,89956,134867,1598,1920,31234,0,0,124708,105,35,140,0,0,0,4038,1174,5212,4558,1020,5578,4420,40,0,2,0,15,79,1063,1199
1,21/09/2022,0121-Saidapet,49674,81536,0,896,23340,0,0,73910,1470,1740,3210,0,4000,4000,1941,834,2775,2452,713,3165,2338,15,0,2,0,0,41,785,843
1,21/09/2022,0123-Little Mount,84599,92305,1000,1512,21236,0,0,108347,13415,8105,21520,0,3000,3000,3340,836,4176,2887,604,3491,2930,28,140,1,0,3,61,742,975
1,21/09/2022,0125-Guindy,117990,258781,3700,5752,73486,0,0,200928,4915,5775,10690,0,0,0,7653,2662,10315,7136,2273,9409,7375,29,342,6,0,2,235,2351,2965
1,21/09/2022,0129-Nanganallur Road,46583,47779,50,248,11604,0,0,58485,730,6470,7200,0,0,0,1293,360,1653,1456,305,1761,1393,6,0,1,0,0,11,340,358
1,21/09/2022,0131-Meenambakkam,123029,137317,500,2656,35252,0,0,161437,5475,16135,21610,0,0,0,4000,1044,5044,3381,911,4292,3499,19,192,1,0,0,63,968,1243
1,21/09/2022,0133-Chennai International Airport,169325,330224,2520,7616,146300,0,0,325761,8325,12945,21270,0,6750,6750,5587,4010,9597,6154,3539,9693,6046,56,537,14,0,13,196,3691,4507
2,21/09/2022,0201-Puratchi Thalaivar Dr. M.G. Ramachandran Central,306938,444154,850,8584,101006,0,0,417378,14135,2700,16835,0,6200,6200,14177,3680,17857,10611,6817,17428,13923,96,3857,12,0,10,338,3282,7595
2,21/09/2022,0203-Egmore,91119,122775,200,2056,48330,0,0,141705,10785,3535,14320,0,10000,10000,2715,1648,4363,2476,2343,4819,3014,30,796,12,0,4,87,1568,2497
2,21/09/2022,0205-Nehru Park,44404,45598,500,736,15106,0,0,60746,755,1730,2485,0,6000,6000,1346,553,1899,1246,463,1709,1278,14,92,0,0,0,29,518,653
2,21/09/2022,0207-Kilpauk,34630,60492,0,1160,17444,0,0,53234,430,510,940,0,0,0,1737,671,2408,1742,575,2317,1751,14,83,1,0,1,50,609,758
2,21/09/2022,0209-Pachaiyappas College,45971,52350,270,664,13578,0,0,60483,1080,660,1740,0,4000,4000,1733,551,2284,1678,436,2114,1651,14,69,1,0,2,27,506,619
2,21/09/2022,0211-Shenoy Nagar,40926,47797,40,472,11820,0,0,53258,1120,1520,2640,0,6000,6000,1365,432,1797,1506,398,1904,1489,8,67,0,0,1,18,404,498
2,21/09/2022,0213-Anna Nagar East,84403,108170,380,1544,27672,0,0,113999,1470,3705,5175,0,0,0,3096,1040,4136,3156,910,4066,3209,25,161,0,0,0,67,936,1189
2,21/09/2022,0215-Anna Nagar Tower,87129,105066,100,1392,24552,0,0,113173,4630,11245,15875,0,1500,1500,3042,887,3929,3120,809,3929,3101,25,139,1,0,1,50,811,1027
2,21/09/2022,0217-Thirumangalam,258489,308805,2040,7296,76608,0,0,344433,56950,22435,79385,0,3000,3000,8412,2601,11013,8642,2231,10873,8721,56,429,8,0,4,212,2348,3057
2,21/09/2022,0219-Koyambedu,195205,229496,2000,3912,78404,0,0,279521,7365,8745,16110,0,16250,16250,5802,2605,8407,5475,1902,7377,5528,56,420,3,1,6,141,2451,3078
2,21/09/2022,0221-Puratchi Thalaivi Dr. J. Jayalalithaa CMBT,55977,149596,700,1848,71594,0,0,130119,0,0,0,0,0,0,2349,2349,4698,3247,3140,6387,3133,21,325,5,0,0,87,2250,2688
2,21/09/2022,0223-Arumbakkam,61170,62742,110,896,20808,0,0,82984,1560,500,2060,0,2000,2000,1782,750,2532,1854,598,2452,1738,38,3,3,0,7,38,696,785
2,21/09/2022,0225-Vadapalani,134125,207968,800,4144,64438,0,0,203507,18940,4590,23530,0,4000,4000,5178,2222,7400,5327,2297,7624,5535,40,590,6,0,11,156,2006,2809
2,21/09/2022,0227-Ashok Nagar,83650,141665,468,3048,48164,0,0,135330,6645,6425,13070,0,0,0,3641,1639,5280,3706,1367,5073,3677,28,190,3,0,3,108,1481,1813
2,21/09/2022,0229-Ekkattuthangal,89732,137002,300,2216,29584,0,0,121832,430,4310,4740,0,0,0,3870,1050,4920,4193,970,5163,4303,29,265,0,0,2,89,906,1291
2,21/09/2022,0231-Arignar Anna Alandur,166050,196503,1775,3696,57670,0,0,229191,6245,8705,14950,0,7000,7000,5438,1985,7423,5229,1611,6840,5412,56,376,2,0,4,150,1738,2326
2,21/09/2022,0233-St. Thomas Mount,89320,106581,600,2352,33656,0,0,125928,2605,3130,5735,6000,8700,14700,2889,1134,4023,2961,902,3863,2849,23,9,1,0,2,79,1024,1138
1,22/09/2022,01ED-Wimco Nagar Depot Metro,75924,72726,100,1128,22046,0,0,99198,1115,255,1370,0,750,750,1994,580,2574,1654,318,1972,1628,15,0,2,0,0,35,541,593
1,22/09/2022,01EF-Wimco Nagar Metro,119985,133640,632,3944,27626,0,0,152187,11210,7340,18550,0,250,250,3559,751,4310,3237,712,3949,3293,56,106,4,0,6,79,674,925
1,22/09/2022,01F1-Thiruvotriyur Metro,100605,105220,0,1176,20156,0,0,121937,1050,1650,2700,0,0,0,2938,559,3497,2891,468,3359,2846,43,0,0,0,0,35,525,603
1,22/09/2022,01F3-Thiruvotriyur Theradi Metro,97250,117368,430,1296,25442,0,0,124418,715,2605,3320,0,0,0,2941,737,3678,3178,735,3913,3149,27,60,3,0,3,35,682,810
1,22/09/2022,01F5-Kaladipet Metro,104334,103280,0,888,23056,0,0,128278,840,2720,3560,0,0,0,3129,725,3854,3122,599,3721,3021,22,1,0,0,0,32,689,744
1,22/09/2022,01F7-Tollgate Metro,59192,56177,0,848,12984,0,0,73024,180,150,330,0,0,0,1626,435,2061,1641,323,1964,1598,24,0,0,0,2,26,406,458
1,22/09/2022,01F9-New Washermenpet Metro,95862,96112,50,848,22156,0,0,118916,1310,1925,3235,0,1000,1000,2989,760,3749,3000,617,3617,2967,20,38,1,0,0,32,733,824
1,22/09/2022,01FB-Tondiarpet Metro,86722,94956,100,1344,20038,0,0,108204,2080,4420,6500,0,250,250,2876,694,3570,3019,719,3738,2954,22,1,1,0,1,47,629,701
1,22/09/2022,01FD-Thiagaraya College Metro,102410,119087,100,824,26522,0,0,129856,3355,3515,6870,0,2250,2250,3801,965,4766,3841,801,4642,3815,31,38,2,0,4,32,925,1032
1,22/09/2022,0101-Washermanpet,83107,121725,1200,1728,37978,0,0,124013,7240,3870,11110,0,7000,7000,3604,1328,4932,3431,1169,4600,3438,22,92,0,0,1,71,1249,1435
1,22/09/2022,0103-Mannadi,77907,112508,200,1168,30210,0,0,109485,7915,6915,14830,0,0,0,3221,1057,4278,3475,997,4472,3478,25,99,1,0,0,48,993,1166
1,22/09/2022,0105-High Court,144303,257220,150,2552,79094,0,0,226099,855,1760,2615,0,0,0,7010,2799,9809,7269,2186,9455,7281,38,210,0,0,4,111,2642,3005
1,22/09/2022,0109-Government Estate,97085,148445,1450,1880,46396,0,0,146811,2930,3275,6205,0,7750,7750,3970,1639,5609,4495,1512,6007,4515,27,244,0,0,6,67,1565,1909
1,22/09/2022,0111-LIC,77764,175794,1180,2016,32018,0,0,112978,1145,700,1845,0,250,250,5080,1183,6263,5851,978,6829,5777,29,0,0,0,2,80,1063,1174
1,22/09/2022,0113-Thousand Lights,163120,243696,1450,4408,33602,0,0,202580,430,450,880,0,0,0,7616,1315,8931,8224,1320,9544,8433,24,307,0,0,7,186,1081,1605
1,22/09/2022,0115-AG-DMS,101942,152346,1250,1560,26824,0,0,131576,0,0,0,0,250,250,4960,934,5894,4909,671,5580,4963,29,138,10,0,1,65,843,1086
1,22/09/2022,0117-Teynampet,96418,147359,400,1792,27604,0,0,126214,0,0,0,0,0,0,4676,1056,5732,5159,892,6051,5022,28,0,0,0,3,71,956,1058
1,22/09/2022,0119-Nandanam,96288,128311,1010,2008,29062,0,0,128368,0,25,25,0,500,500,3889,1116,5005,4319,878,5197,4238,34,2,3,0,11,84,1000,1134
1,22/09/2022,0121-Saidapet,50831,81000,100,1376,22528,0,0,74835,2975,1790,4765,0,1750,1750,2024,807,2831,2478,653,3131,2367,17,0,3,0,0,51,752,823
1,22/09/2022,0123-Little Mount,78506,93799,50,1232,22014,0,0,101802,3270,7940,11210,0,3000,3000,3385,808,4193,2827,537,3364,2909,27,166,2,0,1,52,723,971
1,22/09/2022,0125-Guindy,130133,250751,1550,5448,69702,0,0,206833,5480,4585,10065,0,0,0,7475,2467,9942,7084,2085,9169,7233,43,304,7,0,7,211,2177,2749
1,22/09/2022,0129-Nanganallur Road,61617,49108,100,1136,10480,0,0,73333,1015,6410,7425,0,0,0,1405,341,1746,1520,283,1803,1472,7,0,1,0,1,15,315,339
1,22/09/2022,0131-Meenambakkam,115312,138258,0,2480,33120,0,0,150912,5860,15065,20925,0,0,0,4001,992,4993,3442,846,4288,3558,14,205,4,0,1,71,909,1204
1,22/09/2022,0133-Chennai International Airport,163112,342471,1090,6664,152210,0,0,323076,9885,11300,21185,0,10000,10000,5733,4157,9890,6484,3719,10203,6197,60,586,13,0,18,188,3858,4723
2,22/09/2022,0201-Puratchi Thalaivar Dr. M.G. Ramachandran Central,330814,450671,1400,8288,81458,0,0,421960,18310,2395,20705,0,7050,7050,15219,2925,18144,10827,6773,17600,14859,95,4664,11,0,14,320,2647,7751
2,22/09/2022,0203-Egmore,74224,124753,700,1792,56046,0,0,132762,11070,3725,14795,0,13000,13000,2433,1898,4331,2708,2395,5103,2764,26,470,6,0,7,71,1844,2424
2,22/09/2022,0205-Nehru Park,33977,45112,758,776,15332,0,0,50843,1130,3515,4645,0,0,0,1326,565,1891,1254,486,1740,1285,16,87,0,0,0,29,516,648
2,22/09/2022,0207-Kilpauk,35873,59478,0,752,17792,0,0,54417,795,445,1240,0,0,0,1576,647,2223,1665,559,2224,1683,14,83,0,0,0,31,600,728
2,22/09/2022,0209-Pachaiyappas College,43085,52020,0,424,14338,0,0,57847,910,1060,1970,0,8500,8500,1731,558,2289,1656,448,2104,1607,13,58,1,0,2,16,527,617
2,22/09/2022,0211-Shenoy Nagar,46319,48011,300,776,10178,0,0,57573,1370,2140,3510,0,2000,2000,1424,390,1814,1494,389,1883,1544,7,95,1,0,5,33,348,489
2,22/09/2022,0213-Anna Nagar East,86701,116503,1100,1808,30232,0,0,119841,895,4160,5055,0,0,0,3361,1111,4472,3428,884,4312,3472,24,157,0,0,3,68,1012,1264
2,22/09/2022,0215-Anna Nagar Tower,84910,104436,780,1472,23724,0,0,110886,2730,7740,10470,0,1250,1250,3036,867,3903,3054,718,3772,3104,17,178,0,0,0,55,794,1044
2,22/09/2022,0217-Thirumangalam,261197,308952,1300,5240,77048,0,0,344785,47255,23060,70315,0,0,0,8548,2664,11212,8686,2290,10976,8749,49,500,2,0,5,206,2380,3142
2,22/09/2022,0219-Koyambedu,323439,229590,1300,4776,76674,0,0,406189,8695,14875,23570,0,10500,10500,5961,2559,8520,5672,1802,7474,5643,198,402,2,0,13,139,2373,3127
2,22/09/2022,0221-Puratchi Thalaivi Dr. J. Jayalalithaa CMBT,57254,150498,200,2496,67754,0,0,127704,0,0,0,0,0,0,2332,2226,4558,3483,3064,6547,3291,23,353,6,0,2,81,2108,2573
2,22/09/2022,0223-Arumbakkam,53725,59298,0,1128,20054,0,0,74907,1090,535,1625,0,6750,6750,1700,748,2448,1767,579,2346,1645,36,1,2,0,3,52,690,784
2,22/09/2022,0225-Vadapalani,109435,201553,550,3616,56250,0,0,169851,17150,4320,21470,0,5000,5000,5283,1927,7210,5289,1960,7249,5606,26,799,1,0,6,142,1758,2732
2,22/09/2022,0227-Ashok Nagar,97247,137670,1300,2320,44080,0,0,144947,6550,6635,13185,0,3500,3500,3641,1516,5157,3699,1229,4928,3678,36,201,8,0,0,89,1358,1692
2,22/09/2022,0229-Ekkattuthangal,84119,134463,650,1616,31030,0,0,117415,1505,4810,6315,0,250,250,3828,1077,4905,4046,865,4911,4135,17,233,0,0,2,67,954,1273
2,22/09/2022,0231-Arignar Anna Alandur,156047,195811,3100,3352,55482,0,0,217981,7365,9360,16725,0,3750,3750,5527,1845,7372,5309,1513,6822,5468,49,412,3,0,5,112,1645,2226
2,22/09/2022,0233-St. Thomas Mount,70329,100926,1375,3536,29582,0,0,104822,3285,3840,7125,6000,9300,15300,2761,1020,3781,2867,584,3451,2784,23,15,0,0,1,81,893,1013
1,23/09/2022,01ED-Wimco Nagar Depot Metro,74447,72127,700,1296,21732,0,0,98175,105,285,390,0,3500,3500,1976,566,2542,1635,314,1949,1608,17,1,2,0,2,37,532,591
1,23/09/2022,01EF-Wimco Nagar Metro,114504,135974,1120,2088,32366,0,0,150078,11800,6395,18195,0,1000,1000,3496,825,4321,3249,710,3959,3226,43,83,5,0,9,61,769,970
1,23/09/2022,01F1-Thiruvotriyur Metro,111781,105934,200,1680,21434,0,0,135095,955,1525,2480,0,0,0,2996,561,3557,2863,442,3305,2815,44,0,1,0,4,51,561,661
1,23/09/2022,01F3-Thiruvotriyur Theradi Metro,101945,119878,0,1552,26184,0,0,129681,790,2980,3770,0,0,0,3043,780,3823,3246,740,3986,3225,34,120,3,0,1,51,716,925
1,23/09/2022,01F5-Kaladipet Metro,101104,98981,0,1352,20386,0,0,122842,910,2580,3490,0,0,0,3052,681,3733,3001,557,3558,2951,28,1,0,0,2,47,624,702
1,23/09/2022,01F7-Tollgate Metro,54307,58339,0,424,12926,0,0,67657,1015,175,1190,0,0,0,1695,405,2100,1747,312,2059,1663,29,2,0,0,6,15,387,439
1,23/09/2022,01F9-New Washermenpet Metro,85966,96583,2,808,22620,0,0,109396,1020,2290,3310,0,0,0,3030,772,3802,3028,597,3625,2972,22,36,2,0,3,28,740,831
1,23/09/2022,01FB-Tondiarpet Metro,77714,102865,100,1448,25056,0,0,104318,7295,3330,10625,0,250,250,2851,861,3712,3101,745,3846,3046,19,4,1,0,2,47,807,880
1,23/09/2022,01FD-Thiagaraya College Metro,108580,123289,884,1456,29494,0,0,140414,3835,3030,6865,0,2500,2500,3881,1044,4925,3924,898,4822,3864,46,30,0,0,2,54,974,1106
1,23/09/2022,0101-Washermanpet,95764,123080,400,1784,40142,0,0,138090,9560,3890,13450,0,12500,12500,3660,1396,5056,3385,1195,4580,3387,15,96,0,0,2,68,1315,1496
1,23/09/2022,0103-Mannadi,81604,119540,200,1152,35092,0,0,118048,11000,6545,17545,0,0,0,3261,1197,4458,3614,1122,4736,3551,15,98,0,0,2,43,1139,1297
1,23/09/2022,0105-High Court,137109,239849,1000,2728,68604,0,0,209441,1425,1880,3305,0,0,0,6801,2436,9237,6982,1811,8793,7001,37,211,0,0,4,104,2290,2646
1,23/09/2022,0109-Government Estate,90289,154446,250,1888,50150,0,0,142577,2895,5495,8390,0,3750,3750,4041,1773,5814,4587,1516,6103,4573,29,282,0,0,10,76,1647,2044
1,23/09/2022,0111-LIC,75677,184116,1750,2344,36696,0,0,116467,1865,1610,3475,0,3000,3000,5163,1328,6491,6069,1006,7075,5939,32,22,1,0,12,94,1202,1363
1,23/09/2022,0113-Thousand Lights,142753,244384,692,3976,32374,0,0,179795,615,385,1000,0,0,0,7853,1251,9104,8130,1314,9444,8456,34,485,1,0,7,179,990,1696
1,23/09/2022,0115-AG-DMS,104022,157194,1000,2040,32522,0,0,139584,0,0,0,0,250,250,4968,1132,6100,4839,706,5545,4918,18,191,4,0,1,75,1038,1327
1,23/09/2022,0117-Teynampet,98462,153345,320,3848,17916,0,0,120546,0,0,0,0,0,0,5205,712,5917,5150,901,6051,5545,27,560,3,0,3,122,609,1324
1,23/09/2022,0119-Nandanam,82891,130055,1150,2576,34504,0,0,121121,55,0,55,0,3750,3750,3913,1289,5202,4209,860,5069,4078,39,3,0,0,4,112,1142,1300
1,23/09/2022,0121-Saidapet,44175,80322,64,1624,22766,0,0,68629,2295,2465,4760,0,4500,4500,2037,831,2868,2417,614,3031,2322,17,0,0,0,1,68,760,846
1,23/09/2022,0123-Little Mount,85641,97164,500,2360,24080,0,0,112581,4145,6395,10540,0,5000,5000,3394,940,4334,2843,597,3440,2949,29,213,1,0,0,94,798,1135
1,23/09/2022,0125-Guindy,119842,272428,3430,6352,77148,0,0,206772,5475,5125,10600,0,0,0,8007,2734,10741,7325,2103,9428,7693,32,706,1,0,10,250,2393,3392
1,23/09/2022,0129-Nanganallur Road,57590,50082,150,568,12332,0,0,70640,580,6285,6865,0,0,0,1368,391,1759,1517,287,1804,1445,9,2,2,0,1,21,358,393
1,23/09/2022,0131-Meenambakkam,110243,140722,750,2560,36754,0,0,150307,6115,14850,20965,0,0,0,3991,1076,5067,3505,805,4310,3549,26,199,2,0,7,78,1006,1318
1,23/09/2022,0133-Chennai International Airport,178485,372401,400,8864,175510,0,0,363259,10665,12630,23295,0,11000,11000,5993,4768,10761,6667,3683,10350,6370,58,693,11,0,16,263,4346,5387
2,23/09/2022,0201-Puratchi Thalaivar Dr. M.G. Ramachandran Central,359426,487124,1120,8072,68222,0,0,436840,13615,2350,15965,0,8950,8950,16100,2528,18628,12309,8153,20462,16723,102,5638,6,0,21,364,2156,8287
2,23/09/2022,0203-Egmore,73663,144654,0,2664,53098,0,0,129425,8925,4770,13695,0,6750,6750,2956,1531,4487,3170,2619,5789,3631,19,902,7,0,6,97,1716,2747
2,23/09/2022,0205-Nehru Park,36671,50905,0,528,17746,0,0,54945,2150,1575,3725,0,250,250,1413,633,2046,1409,458,1867,1391,19,95,0,0,2,20,595,731
2,23/09/2022,0207-Kilpauk,36242,62039,100,744,18572,0,0,55658,455,285,740,0,250,250,1624,672,2296,1798,490,2288,1754,10,97,0,0,2,31,627,767
2,23/09/2022,0209-Pachaiyappas College,37780,53134,500,504,15214,0,0,53998,1040,670,1710,0,4500,4500,1723,597,2320,1679,446,2125,1610,15,101,2,0,0,23,572,713
2,23/09/2022,0211-Shenoy Nagar,39247,50916,0,552,14872,0,0,54671,990,1860,2850,0,0,0,1407,531,1938,1512,397,1909,1483,6,72,0,0,0,24,494,596
2,23/09/2022,0213-Anna Nagar East,80644,115888,0,1904,29434,0,0,111982,1080,3735,4815,0,6000,6000,3429,1103,4532,3452,843,4295,3475,21,211,1,0,0,78,1004,1315
2,23/09/2022,0215-Anna Nagar Tower,86551,108745,600,1392,25938,0,0,114481,2840,4960,7800,0,250,250,3155,951,4106,3222,792,4014,3212,26,234,0,0,4,58,873,1195
2,23/09/2022,0217-Thirumangalam,245457,325033,1270,6744,91792,0,0,345263,57605,21170,78775,0,1500,1500,8682,3106,11788,8674,2373,11047,8760,56,580,7,1,3,253,2800,3700
2,23/09/2022,0219-Koyambedu,169233,247616,1515,4536,82228,0,0,257512,7670,15670,23340,0,12000,12000,6441,2805,9246,5880,2263,8143,6045,71,772,2,0,25,171,2563,3604
2,23/09/2022,0221-Puratchi Thalaivi Dr. J. Jayalalithaa CMBT,50808,176154,1128,2504,74648,0,0,129088,0,0,0,0,0,0,2400,2455,4855,4890,4465,9355,4060,19,336,11,0,3,96,2319,2784
2,23/09/2022,0223-Arumbakkam,58148,61441,800,1056,21762,0,0,81766,1480,385,1865,0,12500,12500,1709,782,2491,1814,603,2417,1677,29,3,2,0,3,34,724,795
2,23/09/2022,0225-Vadapalani,126013,220540,530,4544,74170,0,0,205257,23120,4860,27980,0,2500,2500,5404,2574,7978,5474,2183,7657,5669,44,753,3,0,7,176,2306,3289
2,23/09/2022,0227-Ashok Nagar,90803,150848,1450,3664,52736,0,0,148653,5790,6315,12105,0,9000,9000,3919,1866,5785,3771,1359,5130,3823,20,292,1,0,2,141,1650,2106
2,23/09/2022,0229-Ekkattuthangal,90206,138362,800,3416,33280,0,0,127702,455,5515,5970,0,1000,1000,4013,1145,5158,3862,872,4734,4154,28,419,0,0,3,117,1000,1567
2,23/09/2022,0231-Arignar Anna Alandur,154469,211539,750,4040,71314,0,0,230573,6430,8015,14445,0,3750,3750,5532,2366,7898,5293,1570,6863,5445,43,509,2,0,1,152,2110,2817
2,23/09/2022,0233-St. Thomas Mount,85276,119148,1200,2712,45102,0,0,134290,4025,3495,7520,3000,1600,4600,2907,1467,4374,3009,876,3885,2899,22,14,0,0,5,106,1369,1516
1,24/09/2022,01ED-Wimco Nagar Depot Metro,52758,62080,500,1224,23470,0,0,77952,105,40,145,0,500,500,1580,606,2186,1329,277,1606,1219,15,17,0,0,6,34,556,628
1,24/09/2022,01EF-Wimco Nagar Metro,117035,111550,300,1680,14960,0,0,133975,10095,5435,15530,0,250,250,3019,279,3298,2647,642,3289,2911,41,505,4,0,13,50,340,953
1,24/09/2022,01F1-Thiruvotriyur Metro,95867,88469,0,2016,19792,0,0,117675,1005,1395,2400,0,0,0,2467,567,3034,2328,472,2800,2289,39,133,1,0,2,59,520,754
1,24/09/2022,01F3-Thiruvotriyur Theradi Metro,80637,109700,0,1328,30280,0,0,112245,825,1845,2670,0,0,0,2475,887,3362,2745,763,3508,2676,32,192,5,0,5,45,801,1080
1,24/09/2022,01F5-Kaladipet Metro,79477,82918,600,1344,22070,0,0,103491,635,1635,2270,0,0,0,2364,681,3045,2392,508,2900,2255,23,70,1,0,1,42,624,761
1,24/09/2022,01F7-Tollgate Metro,42854,48548,100,688,12078,0,0,55720,110,560,670,0,0,0,1354,376,1730,1344,367,1711,1300,26,109,1,0,4,21,353,514
1,24/09/2022,01F9-New Washermenpet Metro,71185,78951,100,800,20074,0,0,92159,1240,1275,2515,0,1000,1000,2427,639,3066,2398,503,2901,2340,11,176,3,0,3,27,636,856
1,24/09/2022,01FB-Tondiarpet Metro,75504,84010,200,1192,26658,0,0,103554,5105,2260,7365,0,250,250,2178,864,3042,2415,640,3055,2236,25,67,0,0,3,44,810,949
1,24/09/2022,01FD-Thiagaraya College Metro,83539,105487,680,1184,28924,0,0,114327,3420,2270,5690,0,2000,2000,2967,985,3952,3213,722,3935,3089,33,103,1,0,6,46,915,1104
1,24/09/2022,0101-Washermanpet,74378,105301,1400,1576,39488,0,0,116842,5180,3975,9155,0,7000,7000,2823,1282,4105,2738,1060,3798,2632,14,262,2,0,5,56,1213,1552
1,24/09/2022,0103-Mannadi,83426,105949,150,1040,25872,0,0,110488,22635,2900,25535,0,0,0,2982,892,3874,2972,1059,4031,3260,18,568,2,0,11,42,841,1482
1,24/09/2022,0105-High Court,94816,180474,0,2608,69780,0,0,167204,1125,2125,3250,0,0,0,4277,2337,6614,4488,1765,6253,4403,28,507,2,0,5,94,2173,2809
1,24/09/2022,0109-Government Estate,76624,137446,700,1864,46602,0,0,125790,4250,4555,8805,0,1750,1750,3265,1569,4834,3659,1305,4964,3794,28,591,0,0,16,79,1531,2245
1,24/09/2022,0111-LIC,49571,96103,300,1448,25326,0,0,76645,855,515,1370,0,0,0,2378,892,3270,2887,705,3592,2790,21,119,0,0,7,60,799,1006
1,24/09/2022,0113-Thousand Lights,90307,168566,350,3544,42208,0,0,136409,400,230,630,0,0,0,4379,1504,5883,5022,1227,6249,4935,25,364,0,0,8,133,1299,1829
1,24/09/2022,0115-AG-DMS,72644,106969,700,1352,27854,0,0,102550,0,0,0,0,0,0,2930,945,3875,2868,627,3495,2991,9,341,0,0,6,56,869,1281
1,24/09/2022,0117-Teynampet,75820,100196,100,1064,3988,0,0,80972,0,0,0,0,0,0,3451,197,3648,2969,839,3808,3706,17,1013,0,0,4,47,117,1198
1,24/09/2022,0119-Nandanam,51790,80401,0,1424,28930,0,0,82144,10,0,10,0,2000,2000,2084,1046,3130,2295,657,2952,2128,30,48,0,0,2,57,955,1092
1,24/09/2022,0121-Saidapet,35837,63154,100,1960,26638,0,0,64535,2235,1695,3930,0,4000,4000,1254,909,2163,1595,627,2222,1423,12,43,0,0,1,69,823,948
1,24/09/2022,0123-Little Mount,55576,67906,700,1392,21442,0,0,79110,2475,3270,5745,0,500,500,1950,791,2741,1818,521,2339,1806,20,299,0,0,3,53,691,1066
1,24/09/2022,0125-Guindy,106628,216107,1030,5544,76890,0,0,190092,5895,2455,8350,0,0,0,5154,2554,7708,5038,2117,7155,5151,29,1054,8,0,18,193,2246,3548
1,24/09/2022,0129-Nanganallur Road,30812,39481,800,944,12910,0,0,45466,1455,3300,4755,0,0,0,902,409,1311,1046,286,1332,957,6,51,1,0,3,22,372,455
1,24/09/2022,0131-Meenambakkam,96123,113329,608,2168,36772,0,0,135671,9050,10855,19905,0,0,0,2841,1054,3895,2391,771,3162,2513,27,467,3,0,3,68,968,1536
1,24/09/2022,0133-Chennai International Airport,161536,356080,750,11656,170730,0,0,344672,16950,9165,26115,0,4000,4000,5312,4820,10132,5913,3652,9565,5681,76,1692,15,0,18,350,4111,6262
2,24/09/2022,0201-Puratchi Thalaivar Dr. M.G. Ramachandran Central,325410,441306,2100,8936,82786,0,0,419232,13400,1185,14585,0,12100,12100,13006,3034,16040,9139,6365,15504,13312,89,6343,2,0,13,361,2597,9405
2,24/09/2022,0203-Egmore,93573,124207,700,2936,46306,0,0,143515,7805,2815,10620,0,15750,15750,2516,1528,4044,2862,2247,5109,2973,26,1053,9,0,8,110,1476,2682
2,24/09/2022,0205-Nehru Park,33692,45202,0,808,16054,0,0,50554,4865,575,5440,0,0,0,1214,590,1804,1192,461,1653,1190,8,222,0,0,0,36,544,810
2,24/09/2022,0207-Kilpauk,32718,48551,0,984,15140,0,0,48842,500,125,625,0,0,0,1202,541,1743,1329,465,1794,1318,8,146,0,0,0,40,490,684
2,24/09/2022,0209-Pachaiyappas College,47881,53636,0,584,11568,0,0,60033,1510,1300,2810,0,4000,4000,1741,406,2147,1365,497,1862,1625,18,470,2,0,1,23,402,916
2,24/09/2022,0211-Shenoy Nagar,27690,38044,0,424,12910,0,0,41024,2190,720,2910,0,2000,2000,1021,469,1490,1042,345,1387,1039,7,138,8,0,1,17,441,612
2,24/09/2022,0213-Anna Nagar East,62481,96737,1250,1416,31802,0,0,96949,970,1540,2510,0,3000,3000,2490,1138,3628,2631,847,3478,2571,13,303,2,0,6,61,1037,1422
2,24/09/2022,0215-Anna Nagar Tower,71493,98065,120,1888,26808,0,0,100309,2635,3115,5750,0,0,0,2593,964,3557,2531,827,3358,2643,22,491,0,0,5,67,866,1451
2,24/09/2022,0217-Thirumangalam,189449,279163,1790,6936,95572,0,0,293747,104430,14995,119425,0,0,0,6404,3244,9648,6644,2558,9202,6711,60,1180,4,0,11,255,2910,4420
2,24/09/2022,0219-Koyambedu,142262,201563,750,3976,76792,0,0,223780,11100,8080,19180,0,8250,8250,4700,2643,7343,4328,1767,6095,4526,58,1326,3,1,15,156,2395,3954
2,24/09/2022,0221-Puratchi Thalaivi Dr. J. Jayalalithaa CMBT,61906,154158,100,2712,67608,0,0,132326,0,0,0,0,0,0,2275,2295,4570,4053,3373,7426,3311,22,844,9,0,2,107,2130,3114
2,24/09/2022,0223-Arumbakkam,49738,58789,100,1016,25224,0,0,76078,2870,205,3075,0,3250,3250,1365,936,2301,1560,616,2176,1343,27,107,1,0,11,44,856,1046
2,24/09/2022,0225-Vadapalani,139551,229743,0,8056,66420,0,0,214027,34840,6430,41270,0,1000,1000,5551,2492,8043,5211,2840,8051,6012,55,2028,2,0,15,331,2039,4470
2,24/09/2022,0227-Ashok Nagar,84192,126863,530,2888,50224,0,0,137834,6270,5715,11985,0,6000,6000,2903,1764,4667,3036,1159,4195,2985,29,504,2,0,3,124,1571,2233
2,24/09/2022,0229-Ekkattuthangal,59684,90014,750,1744,29642,0,0,91820,605,600,1205,0,0,0,2276,1048,3324,2203,807,3010,2371,11,501,2,0,1,70,913,1498
2,24/09/2022,0231-Arignar Anna Alandur,126243,185269,400,3944,73764,0,0,204351,9895,6445,16340,0,500,500,4127,2358,6485,4073,1739,5812,4141,52,829,5,0,14,134,2073,3107
2,24/09/2022,0233-St. Thomas Mount,64234,105508,100,4544,47644,0,0,116522,2115,2350,4465,0,4200,4200,2125,1571,3696,2376,947,3323,2184,33,244,5,0,8,152,1383,1825
1,25/09/2022,01ED-Wimco Nagar Depot Metro,36978,51440,0,664,26170,0,0,63812,180,70,250,0,500,500,837,638,1475,891,362,1253,783,10,0,4,0,10,20,613,657
1,25/09/2022,01EF-Wimco Nagar Metro,54451,71251,100,2176,29818,0,0,86545,13385,3990,17375,0,4000,4000,1249,777,2026,1361,763,2124,1244,44,63,1,0,21,57,717,903
1,25/09/2022,01F1-Thiruvotriyur Metro,58062,63745,200,1872,23320,0,0,83454,865,1015,1880,0,0,0,1299,627,1926,1266,522,1788,1276,34,88,3,0,11,46,588,770
1,25/09/2022,01F3-Thiruvotriyur Theradi Metro,63667,88166,0,1992,36390,0,0,102049,775,1020,1795,0,0,0,1516,1025,2541,1746,942,2688,1683,20,151,10,0,11,65,927,1184
1,25/09/2022,01F5-Kaladipet Metro,50443,53866,0,952,23588,0,0,74983,1120,1215,2335,0,0,0,1097,682,1779,1227,558,1785,1104,20,0,0,0,5,31,647,703
1,25/09/2022,01F7-Tollgate Metro,23870,34763,0,888,16300,0,0,41058,50,195,245,0,0,0,659,504,1163,748,377,1125,663,17,13,0,0,12,26,477,545
1,25/09/2022,01F9-New Washermenpet Metro,40240,47286,0,728,20368,0,0,61336,1515,700,2215,0,0,0,1050,659,1709,1153,563,1716,1036,9,51,0,0,5,32,631,728
1,25/09/2022,01FB-Tondiarpet Metro,41948,54699,100,1808,26590,0,0,70446,9080,1435,10515,0,0,0,1106,820,1926,1209,689,1898,1086,16,2,0,0,11,41,766,836
1,25/09/2022,01FD-Thiagaraya College Metro,51270,67519,0,1584,29894,0,0,82748,6005,2040,8045,0,0,0,1476,967,2443,1535,722,2257,1466,27,62,3,0,5,55,905,1057
1,25/09/2022,0101-Washermanpet,50885,82735,0,2032,46608,0,0,99525,9435,1905,11340,0,10000,10000,1421,1541,2962,1490,1192,2682,1401,16,121,1,0,11,80,1454,1683
1,25/09/2022,0103-Mannadi,50166,64909,200,1656,26678,0,0,78700,25930,4395,30325,0,0,0,1374,909,2283,1148,1079,2227,1450,12,450,2,0,2,61,861,1388
1,25/09/2022,0105-High Court,38331,74943,400,1176,38854,0,0,78761,1500,2515,4015,0,0,0,1370,1354,2724,1419,1044,2463,1435,10,184,0,0,6,48,1290,1538
1,25/09/2022,0109-Government Estate,51475,85418,600,1704,37756,0,0,91535,3340,1515,4855,0,0,0,1806,1338,3144,1761,1253,3014,1933,14,460,15,0,15,68,1228,1800
1,25/09/2022,0111-LIC,18944,49508,500,1632,23160,0,0,44236,1825,515,2340,0,0,0,816,804,1620,1195,599,1794,1030,13,8,0,0,11,58,719,809
1,25/09/2022,0113-Thousand Lights,39308,74522,100,2200,28166,0,0,69774,4285,205,4490,0,0,0,1530,977,2507,1840,990,2830,1763,8,220,3,0,13,76,869,1189
1,25/09/2022,0115-AG-DMS,23519,42814,200,896,17430,0,0,42045,0,0,0,0,0,0,858,577,1435,872,555,1427,930,9,190,1,0,5,28,518,751
1,25/09/2022,0117-Teynampet,21812,43560,100,744,21440,0,0,44096,0,0,0,0,2000,2000,737,778,1515,1066,606,1672,880,9,7,1,0,8,32,728,785
1,25/09/2022,0119-Nandanam,22583,44470,100,1200,24582,0,0,48465,5,0,5,0,2000,2000,705,922,1627,974,537,1511,798,16,0,1,0,6,45,862,930
1,25/09/2022,0121-Saidapet,15380,44160,0,560,26282,0,0,42222,2645,645,3290,0,4000,4000,560,858,1418,892,692,1584,674,5,0,5,0,1,20,832,863
1,25/09/2022,0123-Little Mount,28869,50918,300,1456,22392,0,0,53017,9535,1735,11270,0,0,0,1074,816,1890,1062,565,1627,1096,7,209,2,0,3,48,717,986
1,25/09/2022,0125-Guindy,55902,144588,150,6888,78166,0,0,141106,6740,2135,8875,0,0,0,2237,2443,4680,2574,2080,4654,2369,18,520,3,0,12,161,2305,3019
1,25/09/2022,0129-Nanganallur Road,10065,20816,50,640,10528,0,0,21283,1080,1025,2105,0,0,0,292,331,623,457,252,709,348,13,0,1,0,2,19,309,344
1,25/09/2022,0131-Meenambakkam,48663,77369,1000,2096,37772,0,0,89531,7230,6185,13415,0,0,0,1297,1053,2350,1164,784,1948,1229,22,321,1,0,7,62,976,1389
1,25/09/2022,0133-Chennai International Airport,113541,306368,200,10848,185772,0,0,310361,15230,5060,20290,0,0,0,3223,5167,8390,4252,3838,8090,3702,75,921,23,0,27,328,4493,5867
2,25/09/2022,0201-Puratchi Thalaivar Dr. M.G. Ramachandran Central,295621,373428,400,11464,59756,0,0,367241,21720,1640,23360,0,700,700,10529,2270,12799,5158,6744,11902,10897,63,7060,10,0,27,406,1715,9281
2,25/09/2022,0203-Egmore,56209,111539,100,3760,51332,0,0,111401,10480,2455,12935,0,2500,2500,2033,1601,3634,1974,2343,4317,2242,23,968,11,0,8,144,1673,2827
2,25/09/2022,0205-Nehru Park,14040,26892,0,560,13160,0,0,27760,1230,260,1490,0,0,0,532,482,1014,611,399,1010,578,9,118,0,0,0,25,440,592
2,25/09/2022,0207-Kilpauk,13107,26069,0,344,10808,0,0,24259,370,175,545,0,0,0,570,392,962,603,391,994,602,5,101,0,0,3,19,366,494
2,25/09/2022,0209-Pachaiyappas College,17670,26261,0,400,12702,0,0,30772,760,380,1140,0,2000,2000,587,456,1043,605,351,956,559,7,50,1,0,1,15,435,509
2,25/09/2022,0211-Shenoy Nagar,17980,23356,0,688,9010,0,0,27678,1190,340,1530,0,4000,4000,541,326,867,580,278,858,566,7,114,0,0,5,23,298,447
2,25/09/2022,0213-Anna Nagar East,34491,61724,2000,1584,26022,0,0,64097,930,905,1835,0,0,0,1328,908,2236,1434,741,2175,1402,27,257,1,0,1,65,816,1167
2,25/09/2022,0215-Anna Nagar Tower,36068,63696,150,1912,26398,0,0,64528,2790,1015,3805,0,0,0,1335,983,2318,1540,789,2329,1423,12,227,7,0,5,70,880,1201
2,25/09/2022,0217-Thirumangalam,112658,190839,300,7056,90208,0,0,210222,88745,8600,97345,0,0,0,3494,3076,6570,3856,2297,6153,3658,49,772,13,0,8,258,2677,3777
2,25/09/2022,0219-Koyambedu,86593,150059,700,4000,82752,0,0,174045,11905,6230,18135,0,4000,4000,2512,2826,5338,2529,1848,4377,2476,30,730,26,0,16,140,2587,3529
2,25/09/2022,0221-Puratchi Thalaivi Dr. J. Jayalalithaa CMBT,44801,148293,500,2992,91070,0,0,139363,0,0,0,0,0,0,1661,3004,4665,2659,3177,5836,2104,22,638,1,0,4,118,2817,3600
2,25/09/2022,0223-Arumbakkam,22498,39528,0,704,21678,0,0,44880,2730,940,3670,0,2000,2000,697,782,1479,899,520,1419,711,23,5,0,0,13,31,734,806
2,25/09/2022,0225-Vadapalani,116062,196683,1580,6984,66084,0,0,190710,36530,6690,43220,0,1500,1500,4394,2387,6781,3517,3144,6661,4720,49,2113,6,0,23,292,2042,4525
2,25/09/2022,0227-Ashok Nagar,43398,83544,2000,2480,42458,0,0,90336,4255,2670,6925,0,0,0,1467,1496,2963,1717,1028,2745,1592,24,335,8,0,4,106,1347,1824
2,25/09/2022,0229-Ekkattuthangal,26407,51821,55,1544,26452,0,0,54458,195,1035,1230,0,0,0,917,932,1849,1275,570,1845,1027,19,121,0,0,4,68,850,1062
2,25/09/2022,0231-Arignar Anna Alandur,87695,127042,500,4208,52900,0,0,145303,10960,3270,14230,0,250,250,2416,1781,4197,2321,1622,3943,2608,37,838,4,0,15,143,1569,2606
2,25/09/2022,0233-St. Thomas Mount,50479,84345,100,3640,39640,0,0,93859,1780,590,2370,9000,5200,14200,1398,1225,2623,1392,1087,2479,1578,21,514,2,0,7,120,1135,1799
1,26/09/2022,01ED-Wimco Nagar Depot Metro,77423,75416,0,1304,21432,0,0,100159,500,235,735,0,3500,3500,1989,561,2550,1742,329,2071,1705,28,0,1,0,3,40,526,598
1,26/09/2022,01EF-Wimco Nagar Metro,152187,140858,270,2336,36212,0,0,191005,24925,8650,33575,0,1750,1750,3619,601,4220,3331,704,4035,3276,53,57,1,0,8,74,869,1062
1,26/09/2022,01F1-Thiruvotriyur Metro,143650,106100,0,1624,20232,0,0,165506,920,1680,2600,0,0,0,2934,555,3489,2920,462,3382,2846,36,7,1,0,6,38,533,621
1,26/09/2022,01F3-Thiruvotriyur Theradi Metro,128017,120737,400,2120,23340,0,0,153877,1340,2865,4205,0,0,0,2901,704,3605,3278,726,4004,3308,41,138,1,2,3,58,630,873
1,26/09/2022,01F5-Kaladipet Metro,139762,104990,0,2056,23164,0,0,164982,1080,2325,3405,0,0,0,3124,724,3848,3150,576,3726,3054,30,0,0,0,7,30,683,750
1,26/09/2022,01F7-Tollgate Metro,76276,55180,0,1240,12896,0,0,90412,70,245,315,0,0,0,1651,410,2061,1616,323,1939,1546,18,0,0,0,1,12,391,422
1,26/09/2022,01F9-New Washermenpet Metro,125021,100338,100,1248,23570,0,0,149939,1510,2525,4035,0,500,500,2992,801,3793,3145,658,3803,3071,30,25,0,0,5,42,759,861
1,26/09/2022,01FB-Tondiarpet Metro,110323,99061,100,1440,23490,0,0,135353,2565,3775,6340,0,750,750,2940,833,3773,3065,750,3815,2991,37,2,0,0,3,49,766,857
1,26/09/2022,01FD-Thiagaraya College Metro,139135,121938,500,1480,27602,0,0,168717,7690,3275,10965,0,1000,1000,3759,1014,4773,3906,873,4779,3849,37,46,1,0,1,51,954,1090
1,26/09/2022,0101-Washermanpet,115485,125722,1900,2024,40374,0,0,159783,6095,4130,10225,0,6000,6000,3764,1425,5189,3534,1176,4710,3523,24,107,0,0,4,71,1332,1538
1,26/09/2022,0103-Mannadi,102685,113992,800,1272,25018,0,0,129775,10395,2195,12590,0,2000,2000,3426,907,4333,3605,1048,4653,3721,16,240,2,0,1,54,844,1157
1,26/09/2022,0105-High Court,161868,236827,200,2704,67240,0,0,232012,1825,1425,3250,0,0,0,6804,2428,9232,6958,1701,8659,6940,35,176,2,0,1,101,2267,2582
1,26/09/2022,0109-Government Estate,102922,146088,1010,2000,46296,0,0,152228,2690,3155,5845,0,2750,2750,3888,1737,5625,4586,1398,5984,4459,20,114,0,0,3,102,1554,1793
1,26/09/2022,0111-LIC,121155,193746,900,2712,29000,0,0,153767,1230,660,1890,0,0,0,5730,1044,6774,6161,1124,7285,6499,26,441,1,0,6,111,913,1498
1,26/09/2022,0113-Thousand Lights,185480,248717,400,4112,23384,0,0,213376,760,485,1245,0,250,250,8079,982,9061,8478,1339,9817,8910,32,622,0,0,3,172,711,1540
1,26/09/2022,0115-AG-DMS,132223,153055,1100,2392,25222,0,0,160937,0,0,0,0,2500,2500,4983,922,5905,4995,716,5711,5017,32,148,0,0,2,82,803,1067
1,26/09/2022,0117-Teynampet,116027,151064,3300,2040,24984,0,0,146351,0,0,0,0,500,500,4868,953,5821,5322,853,6175,5234,37,89,0,0,1,73,866,1066
1,26/09/2022,0119-Nandanam,105709,125696,1170,1792,26214,0,0,134885,155,5,160,0,0,0,3804,998,4802,4442,819,5261,4255,40,0,0,0,2,80,883,1005
1,26/09/2022,0121-Saidapet,63640,82826,0,1288,23442,0,0,88370,2395,1885,4280,0,2750,2750,1918,836,2754,2533,691,3224,2402,25,0,0,0,0,58,760,843
1,26/09/2022,0123-Little Mount,98073,98214,1350,1688,24222,0,0,125333,3605,8815,12420,0,1250,1250,3377,896,4273,3006,638,3644,3022,11,178,0,0,4,68,786,1047
1,26/09/2022,0125-Guindy,151176,257167,800,7680,67086,0,0,226742,11290,5380,16670,0,0,0,7932,2393,10325,7460,2095,9555,7577,41,544,4,0,5,227,2110,2931
1,26/09/2022,0129-Nanganallur Road,52638,49573,0,400,11734,0,0,64772,1445,6365,7810,0,0,0,1336,374,1710,1538,281,1819,1452,7,0,0,0,3,16,344,370
1,26/09/2022,0131-Meenambakkam,152646,141112,1000,2912,37524,0,0,194082,9420,16645,26065,0,0,0,3996,1109,5105,3474,822,4296,3517,32,197,3,0,1,80,1013,1326
1,26/09/2022,0133-Chennai International Airport,176515,342434,200,6624,139236,0,0,322575,7925,12405,20330,0,9750,9750,5979,3838,9817,6646,3264,9910,6556,54,803,12,0,12,210,3492,4583
2,26/09/2022,0201-Puratchi Thalaivar Dr. M.G. Ramachandran Central,394041,468271,3240,13656,70006,0,0,480943,33170,3650,36820,0,7050,7050,16706,2772,19478,11005,6709,17714,15867,92,5575,15,0,8,522,2172,8384
2,26/09/2022,0203-Egmore,101934,129702,350,3320,50060,0,0,155664,18375,3360,21735,0,10000,10000,3089,1576,4665,2766,2275,5041,3160,18,846,2,0,4,133,1619,2622
2,26/09/2022,0205-Nehru Park,40298,46320,0,680,14182,0,0,55160,2180,2010,4190,0,500,500,1361,535,1896,1352,403,1755,1374,9,128,0,0,0,33,495,665
2,26/09/2022,0207-Kilpauk,41292,60482,0,1208,16668,0,0,59168,440,350,790,0,250,250,1625,626,2251,1759,514,2273,1757,14,98,4,0,1,49,561,727
2,26/09/2022,0209-Pachaiyappas College,52147,55210,100,552,15292,0,0,68091,2600,1440,4040,0,6500,6500,1746,622,2368,1787,442,2229,1686,12,75,2,0,1,23,575,688
2,26/09/2022,0211-Shenoy Nagar,51432,49296,200,760,11862,0,0,64254,2700,1510,4210,0,0,0,1381,446,1827,1551,397,1948,1540,14,80,0,0,0,30,402,526
2,26/09/2022,0213-Anna Nagar East,104967,118464,2500,2096,29852,0,0,139415,1180,3795,4975,0,6000,6000,3327,1088,4415,3561,882,4443,3524,24,156,0,0,1,78,984,1243
2,26/09/2022,0215-Anna Nagar Tower,120665,109701,1870,2792,25760,0,0,151087,3360,4540,7900,0,12250,12250,3040,968,4008,3263,783,4046,3250,16,194,0,0,2,75,850,1137
2,26/09/2022,0217-Thirumangalam,283832,310539,1228,6160,78702,0,0,369922,56065,26660,82725,0,1500,1500,8362,2678,11040,8907,2282,11189,8770,69,480,9,0,1,214,2404,3177
2,26/09/2022,0219-Koyambedu,224413,245059,1550,3856,83046,0,0,312865,15200,17720,32920,0,13750,13750,6244,2817,9061,5986,1791,7777,5966,56,583,4,0,13,153,2595,3404
2,26/09/2022,0221-Puratchi Thalaivi Dr. J. Jayalalithaa CMBT,84569,175926,50,2824,78320,0,0,165763,0,0,0,0,0,0,3153,2592,5745,3628,2810,6438,3777,26,844,5,0,1,121,2428,3425
2,26/09/2022,0223-Arumbakkam,58037,61218,0,1136,21530,0,0,80703,1920,380,2300,0,8000,8000,1601,785,2386,1812,656,2468,1654,26,1,0,0,0,46,713,786
2,26/09/2022,0225-Vadapalani,155235,203500,526,4056,57058,0,0,216875,18610,4570,23180,0,5500,5500,5201,1977,7178,5476,2064,7540,5625,41,728,1,0,5,164,1754,2693
2,26/09/2022,0227-Ashok Nagar,100343,145459,1650,2952,50146,0,0,155091,7890,9870,17760,0,0,0,3577,1692,5269,3920,1315,5235,3768,27,207,1,0,1,112,1510,1858
2,26/09/2022,0229-Ekkattuthangal,90907,138183,2790,2576,26638,0,0,122911,1405,4695,6100,0,1250,1250,3890,985,4875,4406,964,5370,4427,18,273,0,0,0,100,825,1216
2,26/09/2022,0231-Arignar Anna Alandur,175993,200557,1548,3840,59274,0,0,240655,11360,9505,20865,0,7500,7500,5631,2015,7646,5483,1559,7042,5526,38,425,3,0,5,137,1782,2390
2,26/09/2022,0233-St. Thomas Mount,108222,107568,200,2552,34290,0,0,145264,3835,4280,8115,9000,18200,27200,2824,1149,3973,3045,825,3870,2863,28,10,1,0,2,84,1033,1158
1,27/09/2022,01ED-Wimco Nagar Depot Metro,74891,73671,0,960,21870,0,0,97721,380,305,685,0,1750,1750,2039,579,2618,1655,295,1950,1628,16,0,0,0,2,28,543,589
1,27/09/2022,01EF-Wimco Nagar Metro,131429,134022,250,2528,27172,0,0,161379,11465,7140,18605,0,2500,2500,3691,745,4436,3315,713,4028,3347,64,102,2,0,7,68,658,901
1,27/09/2022,01F1-Thiruvotriyur Metro,116538,104442,0,1544,21738,0,0,139820,1025,1460,2485,0,0,0,2825,613,3438,2832,462,3294,2744,18,0,0,0,3,40,578,639
1,27/09/2022,01F3-Thiruvotriyur Theradi Metro,100852,116700,112,1264,24326,0,0,126554,1060,2815,3875,0,0,0,2926,712,3638,3183,717,3900,3154,22,64,1,0,3,36,661,787
1,27/09/2022,01F5-Kaladipet Metro,101202,103482,0,1992,21364,0,0,124558,875,2600,3475,0,0,0,3108,689,3797,3097,480,3577,3044,20,0,0,0,7,46,637,710
1,27/09/2022,01F7-Tollgate Metro,65819,56356,200,480,13332,0,0,79831,60,75,135,0,0,0,1636,432,2068,1661,310,1971,1585,8,2,0,0,2,16,403,431
1,27/09/2022,01F9-New Washermenpet Metro,87652,93924,0,856,19880,0,0,108388,965,1940,2905,0,1500,1500,2973,701,3674,3012,602,3614,2942,12,22,2,0,2,30,673,741
1,27/09/2022,01FB-Tondiarpet Metro,98690,97553,0,1168,22026,0,0,121884,3080,3555,6635,0,1000,1000,2778,762,3540,3052,644,3696,2951,22,0,1,0,1,40,707,771
1,27/09/2022,01FD-Thiagaraya College Metro,109563,116834,0,1296,24968,0,0,135827,8205,3540,11745,0,1000,1000,3695,903,4598,3827,789,4616,3764,44,25,0,0,3,42,849,963
1,27/09/2022,0101-Washermanpet,99070,123191,30,2056,36690,0,0,137846,13175,4080,17255,0,8750,8750,3684,1305,4989,3518,1108,4626,3521,20,99,1,0,3,69,1224,1416
1,27/09/2022,0103-Mannadi,99694,118731,807,1520,23522,0,0,125543,16740,3710,20450,0,0,0,3505,829,4334,3553,1119,4672,3899,15,438,3,0,2,47,766,1271
1,27/09/2022,0105-High Court,146554,249719,220,2560,72300,0,0,221634,3535,1280,4815,0,0,0,6987,2497,9484,7275,1985,9260,7277,29,213,2,0,2,111,2336,2693
1,27/09/2022,0109-Government Estate,97213,151270,1050,2320,48066,0,0,148649,3265,3735,7000,0,1000,1000,3962,1746,5708,4515,1528,6043,4546,25,227,2,0,3,101,1581,1939
1,27/09/2022,0111-LIC,114287,173238,1905,2088,17000,0,0,135280,1075,535,1610,0,2000,2000,5534,651,6185,5893,846,6739,6180,26,405,0,0,6,78,550,1065
1,27/09/2022,0113-Thousand Lights,143170,243348,1906,3728,31520,0,0,180324,350,260,610,0,250,250,7773,1228,9001,8335,1289,9624,8472,22,288,0,1,1,156,1012,1480
1,27/09/2022,0115-AG-DMS,104227,151645,600,2792,25846,0,0,133465,0,0,0,0,1000,1000,4987,961,5948,4899,698,5597,4984,20,121,0,0,1,91,831,1064
1,27/09/2022,0117-Teynampet,98447,146570,2200,1320,20578,0,0,122545,0,0,0,0,250,250,4905,765,5670,5183,807,5990,5227,32,172,0,0,2,54,688,948
1,27/09/2022,0119-Nandanam,91059,124046,1965,1872,28716,0,0,123612,550,25,575,0,250,250,3821,1103,4924,4232,821,5053,4098,30,0,1,0,3,80,982,1096
1,27/09/2022,0121-Saidapet,57714,78084,48,1408,20648,0,0,79818,1195,1630,2825,0,6500,6500,1921,752,2673,2470,632,3102,2322,12,0,2,0,0,48,703,765
1,27/09/2022,0123-Little Mount,89607,89905,550,1784,20164,0,0,112105,4330,7515,11845,0,0,0,3238,789,4027,2777,553,3330,2837,25,149,1,0,1,73,666,915
1,27/09/2022,0125-Guindy,133134,251711,1300,5240,64970,0,0,204644,5980,5350,11330,0,0,0,7688,2324,10012,7420,1875,9295,7428,25,353,0,0,10,183,2073,2644
1,27/09/2022,0129-Nanganallur Road,53999,49475,300,560,11154,0,0,66013,545,6520,7065,0,0,0,1394,345,1739,1560,281,1841,1471,10,0,0,0,2,15,323,350
1,27/09/2022,0131-Meenambakkam,129278,137047,2100,2464,32910,0,0,166752,6870,16620,23490,0,0,0,4043,949,4992,3490,833,4323,3546,9,179,2,0,3,68,879,1140
1,27/09/2022,0133-Chennai International Airport,179788,345385,1300,7392,149170,0,0,337650,10400,10800,21200,0,4500,4500,5840,4078,9918,6562,3334,9896,6331,53,696,11,0,16,236,3701,4713
2,27/09/2022,0201-Puratchi Thalaivar Dr. M.G. Ramachandran Central,337701,440231,2970,9304,66210,0,0,416185,19590,2215,21805,0,4950,4950,15446,2461,17907,10890,6326,17216,15075,92,4917,9,0,12,386,2159,7575
2,27/09/2022,0203-Egmore,72312,118563,0,2336,49152,0,0,123800,8295,5275,13570,0,6750,6750,2568,1602,4170,2639,2210,4849,2770,14,568,12,0,6,95,1603,2298
2,27/09/2022,0205-Nehru Park,75873,44138,0,592,12104,0,0,88569,880,1695,2575,0,30000,30000,1349,446,1795,1304,345,1649,1352,7,121,0,0,0,26,413,567
2,27/09/2022,0207-Kilpauk,38968,59138,0,744,16636,0,0,56348,320,410,730,0,0,0,1628,582,2210,1705,542,2247,1716,10,96,0,0,1,33,542,682
2,27/09/2022,0209-Pachaiyappas College,59288,53108,0,896,13898,0,0,74082,8560,650,9210,0,16000,16000,1756,550,2306,1653,463,2116,1635,11,84,1,0,0,38,506,640
2,27/09/2022,0211-Shenoy Nagar,39251,46374,100,776,11034,0,0,51161,1060,4060,5120,0,3000,3000,1351,410,1761,1464,374,1838,1460,13,57,0,0,1,32,366,469
2,27/09/2022,0213-Anna Nagar East,86980,117692,1000,2488,30232,0,0,120700,835,4275,5110,0,3000,3000,3390,1111,4501,3489,840,4329,3513,25,196,0,0,0,90,1017,1328
2,27/09/2022,0215-Anna Nagar Tower,103735,102538,800,1520,20996,0,0,127051,1845,3965,5810,0,1750,1750,3080,783,3863,3173,738,3911,3163,20,155,9,0,1,65,696,946
2,27/09/2022,0217-Thirumangalam,260971,313573,1670,6536,79164,0,0,348341,52350,24325,76675,0,0,0,8466,2729,11195,8803,2307,11110,8832,45,495,6,0,3,243,2414,3206
2,27/09/2022,0219-Koyambedu,177908,234810,1100,4072,78322,0,0,261402,9410,17580,26990,10000,10500,20500,6003,2687,8690,5817,1775,7592,5732,44,431,7,0,13,156,2455,3106
2,27/09/2022,0221-Puratchi Thalaivi Dr. J. Jayalalithaa CMBT,77643,151303,1800,2048,61352,0,0,142843,0,0,0,0,0,0,2645,2057,4702,3586,2828,6414,3526,29,608,6,0,2,76,1942,2663
2,27/09/2022,0223-Arumbakkam,60311,62135,1050,1632,22924,0,0,85917,1250,790,2040,0,9250,9250,1701,849,2550,1747,639,2386,1618,25,3,0,0,5,39,785,857
2,27/09/2022,0225-Vadapalani,140780,214173,300,4024,65020,0,0,210124,17700,4430,22130,0,6000,6000,5461,2236,7697,5484,2198,7682,5724,35,770,2,0,6,142,2036,2991
2,27/09/2022,0227-Ashok Nagar,103907,140630,250,3416,45100,0,0,152673,4915,7500,12415,0,12000,12000,3694,1581,5275,3838,1185,5023,3782,21,232,2,0,0,113,1416,1784
2,27/09/2022,0229-Ekkattuthangal,75275,138973,1800,3032,30590,0,0,110697,1025,5310,6335,0,500,500,3983,1125,5108,4344,856,5200,4381,16,206,0,0,3,109,957,1291
2,27/09/2022,0231-Arignar Anna Alandur,165521,200427,300,3512,59082,0,0,228415,6435,8200,14635,0,3750,3750,5511,2004,7515,5453,1545,6998,5532,45,388,1,0,6,129,1784,2353
2,27/09/2022,0233-St. Thomas Mount,83470,106813,995,5704,35156,0,0,125325,4540,3700,8240,6400,5150,11550,2837,1152,3989,2980,822,3802,2812,23,16,2,0,3,77,1056,1177
1,28/09/2022,01ED-Wimco Nagar Depot Metro,80382,78481,100,1200,20424,0,0,102106,260,235,495,0,1500,1500,2172,506,2678,1814,356,2170,1814,12,68,2,0,5,34,503,624
1,28/09/2022,01EF-Wimco Nagar Metro,120454,138692,100,3224,30974,0,0,154752,12745,6360,19105,0,250,250,3688,881,4569,3381,760,4141,3373,46,90,2,0,7,82,755,982
1,28/09/2022,01F1-Thiruvotriyur Metro,112991,107375,2008,1144,21464,0,0,137607,740,1380,2120,0,0,0,2932,602,3534,2936,479,3415,2849,27,0,3,0,4,36,573,643
1,28/09/2022,01F3-Thiruvotriyur Theradi Metro,99442,127223,0,1688,23388,0,0,124518,1130,2630,3760,0,0,0,3252,699,3951,3438,753,4191,3516,16,259,1,0,4,50,639,969
1,28/09/2022,01F5-Kaladipet Metro,107892,108887,0,1640,24178,0,0,133710,945,2715,3660,0,0,0,3139,783,3922,3239,589,3828,3123,23,0,0,0,7,55,721,806
1,28/09/2022,01F7-Tollgate Metro,54305,58968,200,528,15250,0,0,70283,115,140,255,0,250,250,1683,480,2163,1679,343,2022,1607,13,0,0,0,1,19,457,490
1,28/09/2022,01F9-New Washermenpet Metro,98982,103506,50,904,23404,0,0,123340,1205,2790,3995,0,750,750,3071,803,3874,3190,715,3905,3152,28,112,3,0,2,35,769,949
1,28/09/2022,01FB-Tondiarpet Metro,92565,99848,0,1176,23956,0,0,117697,4805,3895,8700,0,0,0,2941,804,3745,3113,684,3797,2994,19,4,1,0,5,40,761,830
1,28/09/2022,01FD-Thiagaraya College Metro,119005,126749,0,2504,30230,0,0,151739,2610,3430,6040,0,2250,2250,3800,1075,4875,4012,830,4842,3917,48,37,0,0,2,60,1013,1160
1,28/09/2022,0101-Washermanpet,106494,126370,1200,1984,36670,0,0,146348,5815,5665,11480,0,10250,10250,3872,1335,5207,3689,1179,4868,3688,26,177,1,0,4,80,1241,1529
1,28/09/2022,0103-Mannadi,113020,112050,300,1192,14322,0,0,128834,8405,5930,14335,0,0,0,3641,550,4191,3562,967,4529,3980,22,570,3,0,1,48,505,1149
1,28/09/2022,0105-High Court,133954,238253,100,2248,66666,0,0,202968,1720,1875,3595,0,0,0,6945,2344,9289,7086,1700,8786,7081,34,203,2,0,1,100,2221,2561
1,28/09/2022,0109-Government Estate,99122,145816,200,2336,45800,0,0,147458,2890,3950,6840,0,250,250,3940,1641,5581,4379,1228,5607,4414,23,233,2,0,7,96,1508,1869
1,28/09/2022,0111-LIC,102743,182501,100,2472,10506,0,0,115821,1160,705,1865,0,0,0,6075,461,6536,6051,925,6976,6713,42,792,2,0,4,101,328,1269
1,28/09/2022,0113-Thousand Lights,135042,245198,1500,5464,36976,0,0,178982,555,245,800,0,250,250,7689,1392,9081,8276,1212,9488,8325,43,265,0,0,2,185,1170,1665
1,28/09/2022,0115-AG-DMS,107573,155470,50,2912,26472,0,0,137007,0,0,0,0,1250,1250,5084,947,6031,4954,659,5613,5091,29,189,1,0,0,98,812,1129
1,28/09/2022,0117-Teynampet,82507,149110,1200,1760,26824,0,0,112291,0,0,0,0,0,0,4867,1010,5877,5202,766,5968,5100,33,43,0,0,4,59,918,1057
1,28/09/2022,0119-Nandanam,97807,125302,500,1672,27550,0,0,127529,160,5,165,0,1250,1250,3948,1003,4951,4255,778,5033,4170,27,74,5,0,5,72,927,1110
1,28/09/2022,0121-Saidapet,53750,86657,200,1144,25144,0,0,80238,2775,1405,4180,0,2000,2000,2076,875,2951,2650,648,3298,2487,15,2,0,0,1,48,819,885
1,28/09/2022,0123-Little Mount,92152,98770,650,2144,27022,0,0,121968,3825,6235,10060,0,0,0,3420,1001,4421,2883,594,3477,2926,27,176,1,0,2,74,884,1164
1,28/09/2022,0125-Guindy,140835,261774,720,5864,64612,0,0,212031,5100,5170,10270,0,0,0,7945,2301,10246,7548,1973,9521,7770,31,612,3,0,8,225,2050,2929
1,28/09/2022,0129-Nanganallur Road,56866,50771,600,288,12254,0,0,70008,920,6045,6965,0,0,0,1343,378,1721,1551,261,1812,1466,9,0,0,0,2,12,353,376
1,28/09/2022,0131-Meenambakkam,114628,147062,200,2856,41514,0,0,159198,5105,14360,19465,0,0,0,4170,1212,5382,3531,888,4419,3588,26,220,1,0,1,82,1132,1462
1,28/09/2022,0133-Chennai International Airport,162368,333244,1700,7480,142020,0,0,313568,8185,9985,18170,0,8250,8250,5704,3910,9614,6640,3076,9716,6226,72,647,7,0,11,238,3522,4497
2,28/09/2022,0201-Puratchi Thalaivar Dr. M.G. Ramachandran Central,324838,453871,1180,9392,75168,0,0,410578,13680,4050,17730,0,3550,3550,15372,2737,18109,11682,6324,18006,15383,98,4886,8,0,15,379,2430,7816
2,28/09/2022,0203-Egmore,97447,127965,400,1960,31394,0,0,131201,9225,3470,12695,0,14750,14750,3419,812,4231,2981,2219,5200,3703,25,1424,6,0,5,77,1014,2551
2,28/09/2022,0205-Nehru Park,43921,47087,0,952,14778,0,0,59651,1135,2020,3155,0,2000,2000,1371,520,1891,1336,357,1693,1343,11,103,1,0,0,37,488,640
2,28/09/2022,0207-Kilpauk,37757,63916,1000,720,21752,0,0,61229,495,380,875,0,0,0,1588,759,2347,1703,520,2223,1694,9,100,0,0,1,31,719,860
2,28/09/2022,0209-Pachaiyappas College,46024,54466,0,768,16348,0,0,63140,700,1490,2190,0,4000,4000,1747,630,2377,1673,448,2121,1595,20,60,1,0,2,27,594,704
2,28/09/2022,0211-Shenoy Nagar,42220,48474,0,584,11054,0,0,53858,1410,1780,3190,0,2000,2000,1367,409,1776,1557,359,1916,1539,9,86,0,0,0,24,382,501
2,28/09/2022,0213-Anna Nagar East,84803,116745,300,2256,30964,0,0,118323,1075,3570,4645,0,1500,1500,3275,1144,4419,3478,790,4268,3441,12,150,2,0,1,85,1035,1285
2,28/09/2022,0215-Anna Nagar Tower,83879,105216,500,1304,23658,0,0,109341,7040,7240,14280,0,1750,1750,3117,850,3967,3191,735,3926,3122,28,178,2,0,0,50,769,1027
2,28/09/2022,0217-Thirumangalam,260235,320372,750,6856,61108,0,0,328949,52455,22350,74805,0,1500,1500,9158,2149,11307,9028,2256,11284,9581,54,1139,4,0,5,245,1892,3339
2,28/09/2022,0219-Koyambedu,171409,242513,2060,5728,84672,0,0,263869,11365,13325,24690,0,8750,8750,5990,2866,8856,5965,1754,7719,5791,67,503,3,0,8,163,2648,3392
2,28/09/2022,0221-Puratchi Thalaivi Dr. J. Jayalalithaa CMBT,75744,159789,600,2496,65894,0,0,144734,0,0,0,0,0,0,2709,2153,4862,3998,3299,7297,3691,39,567,3,0,3,94,2061,2767
2,28/09/2022,0223-Arumbakkam,53766,65176,0,1568,23638,0,0,78972,1280,475,1755,0,2500,2500,1734,846,2580,1917,628,2545,1709,30,6,2,0,2,48,781,869
2,28/09/2022,0225-Vadapalani,140198,214383,300,3376,72406,0,0,216280,15910,3830,19740,0,3500,3500,5200,2486,7686,5587,2084,7671,5521,31,571,6,0,4,138,2257,3007
2,28/09/2022,0227-Ashok Nagar,88481,147623,300,3120,45122,0,0,137023,4255,6850,11105,0,0,0,3796,1575,5371,3909,1179,5088,3969,26,381,0,0,3,125,1404,1939
2,28/09/2022,0229-Ekkattuthangal,90129,140107,1050,3984,29962,0,0,125125,385,5930,6315,0,0,0,4204,1143,5347,4228,927,5155,4433,20,370,0,0,0,143,939,1472
2,28/09/2022,0231-Arignar Anna Alandur,162399,202646,650,4480,58658,0,0,226187,7595,8980,16575,0,2000,2000,5680,1995,7675,5444,1539,6983,5563,41,467,10,0,2,158,1775,2453
2,28/09/2022,0233-St. Thomas Mount,77803,109906,3400,2752,37024,0,0,120979,2785,3540,6325,6000,7200,13200,2837,1228,4065,3034,788,3822,2863,23,18,1,0,1,91,1125,1259
1,29/09/2022,01ED-Wimco Nagar Depot Metro,82553,73855,0,1024,21698,0,0,105275,895,140,1035,0,4250,4250,2077,542,2619,1774,294,2068,1669,11,0,1,0,6,31,532,581
1,29/09/2022,01EF-Wimco Nagar Metro,116101,137421,200,3064,33134,0,0,152499,9535,6795,16330,0,250,250,3535,902,4437,3365,654,4019,3270,36,82,2,0,2,83,802,1007
1,29/09/2022,01F1-Thiruvotriyur Metro,112213,105108,0,1400,20082,0,0,133695,670,1295,1965,0,0,0,2931,565,3496,2931,433,3364,2818,24,0,1,0,7,41,534,607
1,29/09/2022,01F3-Thiruvotriyur Theradi Metro,94984,125921,350,1632,27796,0,0,124762,810,2920,3730,0,0,0,3070,787,3857,3291,724,4015,3303,20,172,2,0,4,56,739,993
1,29/09/2022,01F5-Kaladipet Metro,96772,103777,0,1432,22570,0,0,120774,895,2950,3845,0,0,0,3091,724,3815,3145,529,3674,3002,31,0,1,0,2,48,676,758
1,29/09/2022,01F7-Tollgate Metro,57312,55087,0,680,12840,0,0,70832,245,330,575,0,0,0,1654,414,2068,1640,330,1970,1546,21,0,0,0,3,21,384,429
1,29/09/2022,01F9-New Washermenpet Metro,99123,100299,700,1120,22686,0,0,123629,1070,2040,3110,0,250,250,3057,776,3833,3183,593,3776,3062,24,43,1,0,5,32,733,838
1,29/09/2022,01FB-Tondiarpet Metro,82311,103433,200,1560,25016,0,0,109087,9790,3860,13650,0,0,0,2941,855,3796,3218,645,3863,3065,19,2,1,0,3,48,779,852
1,29/09/2022,01FD-Thiagaraya College Metro,106357,117782,300,1480,25914,0,0,134051,5910,2850,8760,0,2250,2250,3736,955,4691,3920,762,4682,3803,25,18,2,0,4,52,891,992
1,29/09/2022,0101-Washermanpet,101795,127070,1500,2264,28586,0,0,134145,6380,5905,12285,0,21250,21250,4126,1069,5195,3616,1032,4648,3887,17,481,0,0,5,79,961,1543
1,29/09/2022,0103-Mannadi,98074,117985,110,960,19130,0,0,118274,8075,7770,15845,0,1500,1500,3733,689,4422,3725,950,4675,4013,13,560,2,0,5,40,648,1268
1,29/09/2022,0105-High Court,147121,244260,267,2352,66854,0,0,216594,765,2160,2925,0,0,0,7035,2344,9379,7424,1609,9033,7274,34,191,0,0,2,112,2226,2565
1,29/09/2022,0109-Government Estate,91197,147284,300,2136,43554,0,0,137187,6305,3540,9845,0,3750,3750,4021,1586,5607,4674,1302,5976,4566,28,279,2,0,2,94,1441,1846
1,29/09/2022,0111-LIC,106910,180145,3300,2808,10974,0,0,123992,1350,970,2320,0,0,0,6039,486,6525,6151,816,6967,6657,43,693,0,0,3,108,348,1195
1,29/09/2022,0113-Thousand Lights,152656,257646,400,5888,37458,0,0,196402,365,250,615,0,0,0,7932,1428,9360,8665,1193,9858,8734,31,390,0,0,2,238,1145,1806
1,29/09/2022,0115-AG-DMS,110241,162242,350,2512,30900,0,0,144003,0,0,0,0,0,0,5081,1081,6162,5134,670,5804,5182,25,183,0,0,1,98,952,1259
1,29/09/2022,0117-Teynampet,103001,154300,550,1816,20588,0,0,125955,0,0,0,0,0,0,5191,824,6015,5469,747,6216,5516,17,302,0,0,2,73,712,1106
1,29/09/2022,0119-Nandanam,92303,129194,0,2336,25266,0,0,119905,140,30,170,0,0,0,4115,948,5063,4439,740,5179,4414,33,198,2,0,1,97,833,1164
1,29/09/2022,0121-Saidapet,48489,84454,100,1456,20682,0,0,70727,2815,2240,5055,0,250,250,2193,743,2936,2626,599,3225,2545,11,69,1,0,5,62,678,826
1,29/09/2022,0123-Little Mount,92166,99134,414,2608,25134,0,0,120322,3605,7025,10630,0,1000,1000,3443,984,4427,2979,519,3498,3002,17,205,1,0,1,103,823,1150
1,29/09/2022,0125-Guindy,183581,268035,1055,7048,26362,0,0,218046,4710,4155,8865,0,500,500,9522,1165,10687,7583,1863,9446,9221,32,2054,1,0,5,266,775,3133
1,29/09/2022,0129-Nanganallur Road,52554,50564,700,488,12228,0,0,65970,1165,6195,7360,0,0,0,1420,377,1797,1573,300,1873,1469,11,0,0,0,0,11,359,381
1,29/09/2022,0131-Meenambakkam,133993,146167,1000,2264,36124,0,0,173381,8135,15555,23690,0,0,0,4255,1059,5314,3713,768,4481,3723,28,220,1,0,5,75,980,1309
1,29/09/2022,0133-Chennai International Airport,176522,352831,1500,9392,148328,0,0,335742,8855,13565,22420,0,7250,7250,5974,4128,10102,7027,2930,9957,6573,53,803,12,1,20,297,3683,4869
2,29/09/2022,0201-Puratchi Thalaivar Dr. M.G. Ramachandran Central,334687,458129,1513,9712,54386,0,0,400298,12865,2685,15550,0,5700,5700,16089,2236,18325,12043,6159,18202,16112,72,5696,11,0,8,382,1752,7921
2,29/09/2022,0203-Egmore,96264,127643,200,2376,31628,0,0,130468,10730,3060,13790,0,11750,11750,3311,991,4302,3361,2330,5691,3770,17,1323,13,0,4,94,1013,2464
2,29/09/2022,0205-Nehru Park,41612,48188,0,1368,13308,0,0,56288,1245,1995,3240,0,0,0,1489,527,2016,1427,388,1815,1469,9,149,0,0,1,53,470,682
2,29/09/2022,0207-Kilpauk,39442,60242,357,1136,17210,0,0,58145,340,370,710,0,0,0,1604,634,2238,1785,496,2281,1749,10,117,0,0,0,51,577,755
2,29/09/2022,0209-Pachaiyappas College,47712,55017,100,1144,14832,0,0,63788,860,760,1620,0,4000,4000,1803,592,2395,1747,375,2122,1692,6,80,1,0,2,44,540,673
2,29/09/2022,0211-Shenoy Nagar,37005,50923,0,920,12958,0,0,50883,1370,2350,3720,0,1000,1000,1394,482,1876,1558,368,1926,1541,12,78,0,0,0,37,436,563
2,29/09/2022,0213-Anna Nagar East,84160,116597,220,2168,27626,0,0,114174,1135,4280,5415,0,0,0,3414,1061,4475,3620,742,4362,3556,14,179,0,0,2,91,942,1228
2,29/09/2022,0215-Anna Nagar Tower,86493,106906,800,1752,24576,0,0,113621,7320,9940,17260,0,500,500,3110,903,4013,3202,714,3916,3175,21,198,3,0,1,68,825,1116
2,29/09/2022,0217-Thirumangalam,269401,327534,430,9008,68138,0,0,346977,120490,21260,141750,0,0,0,9408,2222,11630,9142,2021,11163,9622,60,1178,0,0,3,277,2088,3606
2,29/09/2022,0219-Koyambedu,190914,240855,2150,4768,71686,0,0,269518,10225,11895,22120,0,8500,8500,6453,2549,9002,5789,1829,7618,6232,73,1125,5,0,10,187,2252,3652
2,29/09/2022,0221-Puratchi Thalaivi Dr. J. Jayalalithaa CMBT,65698,169855,1100,2288,70666,0,0,139752,0,0,0,0,0,0,2611,2282,4893,4772,3471,8243,3890,23,554,4,0,3,80,2181,2845
2,29/09/2022,0223-Arumbakkam,64355,62419,0,1664,21834,0,0,87853,1005,565,1570,0,4250,4250,1728,825,2553,1823,561,2384,1689,22,9,1,0,6,67,749,854
2,29/09/2022,0225-Vadapalani,129905,227586,340,5328,71860,0,0,207433,25890,5350,31240,0,5000,5000,5661,2594,8255,6070,2214,8284,6067,28,743,1,0,4,210,2259,3245
2,29/09/2022,0227-Ashok Nagar,97964,155318,550,4072,50138,0,0,152724,4960,7965,12925,0,17500,17500,4097,1806,5903,4141,1188,5329,4162,21,426,3,0,6,163,1589,2208
2,29/09/2022,0229-Ekkattuthangal,75167,137089,2500,2784,31076,0,0,111527,1060,6615,7675,0,0,0,4048,1139,5187,4155,834,4989,4258,16,304,0,0,2,119,936,1377
2,29/09/2022,0231-Arignar Anna Alandur,164526,207916,1628,3304,64050,0,0,233508,7355,7045,14400,0,2500,2500,5585,2149,7734,5684,1440,7124,5584,41,452,4,0,2,133,1918,2550
2,29/09/2022,0233-St. Thomas Mount,81559,112003,400,3248,37638,0,0,122845,2395,3815,6210,3000,1300,4300,2916,1316,4232,3098,748,3846,2930,24,15,2,0,4,115,1160,1320
1,30/09/2022,01ED-Wimco Nagar Depot Metro,91470,79712,0,1880,25894,0,0,119244,420,415,835,0,7000,7000,2137,684,2821,1807,303,2110,1709,12,1,2,0,9,54,627,705
1,30/09/2022,01EF-Wimco Nagar Metro,134855,145507,1600,3184,30316,0,0,169955,13405,8475,21880,0,3000,3000,3771,833,4604,3558,687,4245,3552,38,244,2,0,12,90,738,1124
1,30/09/2022,01F1-Thiruvotriyur Metro,123403,106210,0,1424,23174,0,0,148001,860,1480,2340,0,0,0,3060,653,3713,2895,446,3341,2754,30,17,5,0,8,47,607,714
1,30/09/2022,01F3-Thiruvotriyur Theradi Metro,127730,135160,150,2512,27238,0,0,157630,815,2825,3640,0,0,0,3452,823,4275,3543,794,4337,3613,44,359,3,0,6,63,736,1211
1,30/09/2022,01F5-Kaladipet Metro,106258,104218,32,1552,24910,0,0,132752,750,2490,3240,0,0,0,3006,771,3777,3136,511,3647,2949,20,6,0,0,2,50,719,797
1,30/09/2022,01F7-Tollgate Metro,62295,58446,500,528,15244,0,0,78567,60,405,465,0,0,0,1700,483,2183,1713,319,2032,1585,14,1,0,0,6,16,456,493
1,30/09/2022,01F9-New Washermenpet Metro,90888,101436,200,1816,26498,0,0,119402,1195,1995,3190,0,0,0,3041,903,3944,3074,617,3691,2981,6,67,2,0,5,62,846,988
1,30/09/2022,01FB-Tondiarpet Metro,97264,106112,180,1672,30074,0,0,129190,2820,4450,7270,0,1250,1250,2945,1009,3954,3218,651,3869,3017,29,0,1,0,4,63,942,1039
1,30/09/2022,01FD-Thiagaraya College Metro,122663,128409,200,1680,33384,0,0,157927,4000,2635,6635,0,0,0,3880,1157,5037,4029,759,4788,3866,58,69,1,0,3,60,1078,1269
1,30/09/2022,0101-Washermanpet,105893,127146,2370,1864,43948,0,0,154075,6545,4590,11135,0,8500,8500,3621,1504,5125,3658,1085,4743,3419,15,96,0,0,4,73,1424,1612
1,30/09/2022,0103-Mannadi,96465,121138,800,1536,26926,0,0,125727,8860,10570,19430,0,500,500,3484,912,4396,3709,1004,4713,3884,19,450,2,0,4,63,891,1429
1,30/09/2022,0105-High Court,173251,259089,100,3264,65422,0,0,242037,1675,1515,3190,0,0,0,7579,2312,9891,7438,1668,9106,7815,21,772,3,0,2,129,2155,3082
1,30/09/2022,0109-Government Estate,102291,158793,2719,3352,36788,0,0,145150,2500,2885,5385,0,1000,1000,4704,1374,6078,4771,1480,6251,5207,30,828,1,0,5,137,1176,2177
1,30/09/2022,0111-LIC,126621,187404,500,3152,14866,0,0,145139,1265,620,1885,0,250,250,5996,627,6623,6152,910,7062,6741,36,806,0,0,12,123,451,1428
1,30/09/2022,0113-Thousand Lights,167246,250152,1900,6568,44820,0,0,220534,1165,360,1525,0,2000,2000,7429,1651,9080,8100,1304,9404,8124,40,346,0,0,1,272,1396,2055
1,30/09/2022,0115-AG-DMS,114178,161764,300,2904,33928,0,0,151310,0,0,0,0,1000,1000,5009,1206,6215,4926,641,5567,5005,18,282,0,0,0,115,1037,1452
1,30/09/2022,0117-Teynampet,97686,153516,1002,2464,33908,0,0,135060,0,0,0,0,0,0,4747,1297,6044,5195,784,5979,4975,17,44,1,0,1,96,1152,1311
1,30/09/2022,0119-Nandanam,90352,136317,708,2808,31060,0,0,124928,120,0,120,0,250,250,4182,1133,5315,4262,783,5045,4379,23,335,1,0,6,99,1005,1469
1,30/09/2022,0121-Saidapet,59921,90733,500,2208,29940,0,0,92569,2670,1755,4425,0,8250,8250,2115,1074,3189,2596,667,3263,2412,19,0,0,1,6,94,987,1107
1,30/09/2022,0123-Little Mount,87923,112593,650,3144,37178,0,0,128895,2970,7175,10145,0,0,0,3435,1399,4834,2879,573,3452,3036,20,345,2,0,3,128,1223,1721
1,30/09/2022,0125-Guindy,242795,331128,782,10944,26200,0,0,280721,8485,5035,13520,0,0,0,11594,1297,12891,7703,2354,10057,11295,44,4049,4,0,16,417,667,5197
1,30/09/2022,0129-Nanganallur Road,39829,52772,2200,648,14266,0,0,56943,920,5665,6585,0,0,0,1369,448,1817,1616,330,1946,1464,6,0,0,0,3,24,407,440
1,30/09/2022,0131-Meenambakkam,133563,153166,1000,2416,45384,0,0,182363,7245,15285,22530,0,0,0,4270,1331,5601,3683,838,4521,3684,21,326,1,0,1,84,1243,1676
1,30/09/2022,0133-Chennai International Airport,213125,418072,200,16464,177040,0,0,406829,9640,12765,22405,0,6000,6000,6958,5041,11999,7516,3328,10844,7577,63,1546,14,0,18,436,4227,6304
2,30/09/2022,0201-Puratchi Thalaivar Dr. M.G. Ramachandran Central,358193,532845,1100,10688,99068,0,0,469049,11635,2660,14295,0,4900,4900,15946,3608,19554,14892,7716,22608,17281,99,5754,6,0,14,450,3193,9516
2,30/09/2022,0203-Egmore,112825,164248,400,4136,50580,0,0,167941,10440,3795,14235,0,15250,15250,3715,1811,5526,4341,2764,7105,4514,28,1522,1,0,6,158,1639,3354
2,30/09/2022,0205-Nehru Park,42231,62786,100,2456,21218,0,0,66005,1770,1630,3400,0,0,0,1752,764,2516,1591,570,2161,1707,11,247,2,0,0,87,748,1095
2,30/09/2022,0207-Kilpauk,37032,66802,1400,1368,22364,0,0,62164,340,335,675,0,0,0,1768,821,2589,1853,576,2429,1804,11,116,0,0,0,65,738,930
2,30/09/2022,0209-Pachaiyappas College,45968,55726,0,776,16328,0,0,63072,1950,670,2620,0,6000,6000,1718,657,2375,1722,462,2184,1660,5,128,5,0,0,33,617,788
2,30/09/2022,0211-Shenoy Nagar,47415,50563,0,968,13934,0,0,62317,2180,1850,4030,0,500,500,1389,520,1909,1550,374,1924,1509,18,94,0,0,1,41,459,613
2,30/09/2022,0213-Anna Nagar East,81894,125873,316,2560,35298,0,0,120068,1075,3800,4875,0,3000,3000,3553,1326,4879,3641,921,4562,3594,16,249,2,0,6,107,1216,1596
2,30/09/2022,0215-Anna Nagar Tower,81976,113865,294,2544,30466,0,0,115280,4650,8490,13140,0,1000,1000,3145,1158,4303,3291,788,4079,3233,27,256,3,0,3,103,1027,1419
2,30/09/2022,0217-Thirumangalam,300977,318613,400,9736,85022,0,0,396135,93725,21470,115195,0,0,0,9686,2948,12634,7986,2505,10491,8686,68,1420,2,0,2,341,2639,4472
2,30/09/2022,0219-Koyambedu,204492,284061,500,7320,68360,0,0,280672,13520,13470,26990,0,3750,3750,8058,2565,10623,6919,2532,9451,8046,48,2346,2,0,26,306,2119,4847
2,30/09/2022,0221-Puratchi Thalaivi Dr. J. Jayalalithaa CMBT,97638,228202,0,4096,66816,0,0,168550,0,0,0,0,0,0,3657,2352,6009,9381,6939,16320,6270,31,1414,4,0,0,182,2104,3735
2,30/09/2022,0223-Arumbakkam,51849,63610,100,1672,22480,0,0,76101,1580,350,1930,0,4000,4000,1745,875,2620,1948,572,2520,1705,24,7,4,0,2,70,787,894
2,30/09/2022,0225-Vadapalani,147482,248767,1550,8288,77984,0,0,235304,40320,7230,47550,0,2500,2500,6161,2944,9105,6002,2661,8663,6576,42,1568,5,0,11,345,2439,4410
2,30/09/2022,0227-Ashok Nagar,142561,198642,430,10288,53884,0,0,207163,5740,7050,12790,0,9500,9500,5368,2191,7559,4558,1494,6052,5510,30,1418,0,0,3,383,1633,3467
2,30/09/2022,0229-Ekkattuthangal,90161,163929,330,5656,57518,0,0,153665,775,6370,7145,0,0,0,4322,2025,6347,4104,892,4996,4270,24,434,0,0,7,197,1784,2446
2,30/09/2022,0231-Arignar Anna Alandur,164003,247732,230,6752,86704,0,0,257689,9055,8280,17335,0,2250,2250,6278,3006,9284,5897,1823,7720,6177,43,954,0,0,6,251,2562,3816
2,30/09/2022,0233-St. Thomas Mount,97076,137852,300,6096,37762,0,0,141234,5065,3450,8515,3000,1950,4950,3789,1355,5144,3165,890,4055,3712,23,829,8,0,2,195,1139,2196
1,01/10/2022,01ED-Wimco Nagar Depot Metro,70262,70107,0,1048,26854,0,0,98164,245,465,710,0,3000,3000,1734,627,2361,1525,326,1851,1331,11,1,1,0,8,31,639,691
1,01/10/2022,01EF-Wimco Nagar Metro,120419,122036,700,3064,34458,0,0,158641,8705,5470,14175,0,2250,2250,2911,884,3795,2825,752,3577,2691,41,130,1,0,18,87,800,1077
1,01/10/2022,01F1-Thiruvotriyur Metro,119080,97769,0,1536,26442,0,0,147058,1050,1170,2220,0,0,0,2555,678,3233,2565,455,3020,2328,51,0,0,0,16,46,667,780
1,01/10/2022,01F3-Thiruvotriyur Theradi Metro,122174,122300,1360,2112,26610,0,0,152256,1185,2180,3365,0,0,0,3006,754,3760,3061,780,3841,3137,25,395,1,0,6,76,706,1209
1,01/10/2022,01F5-Kaladipet Metro,99130,86009,0,1568,25736,0,0,126434,940,1810,2750,0,0,0,2368,763,3131,2483,550,3033,2203,15,0,1,0,2,53,714,785
1,01/10/2022,01F7-Tollgate Metro,64774,54900,0,1152,18192,0,0,84118,110,1020,1130,0,0,0,1401,552,1953,1458,350,1808,1327,19,5,0,0,9,41,519,593
1,01/10/2022,01F9-New Washermenpet Metro,104136,84222,400,1360,17010,0,0,122906,1725,1900,3625,0,1250,1250,2624,517,3141,2493,528,3021,2566,29,271,2,0,6,45,512,865
1,01/10/2022,01FB-Tondiarpet Metro,95084,88178,1200,1720,25590,0,0,123594,3125,2265,5390,0,500,500,2382,810,3192,2638,709,3347,2417,20,17,1,0,14,62,759,873
1,01/10/2022,01FD-Thiagaraya College Metro,121225,111964,2650,2040,33784,0,0,159699,7780,4540,12320,0,2250,2250,3156,1061,4217,3190,698,3888,3084,59,141,0,0,9,65,1012,1286
1,01/10/2022,0101-Washermanpet,98208,115103,4150,2256,44802,0,0,149416,7695,7685,15380,0,13750,13750,3108,1473,4581,2904,987,3891,2793,18,218,1,0,14,100,1389,1740
1,01/10/2022,0103-Mannadi,101419,106372,100,1744,30896,0,0,134159,22365,6950,29315,0,3000,3000,2817,1082,3899,3069,950,4019,3064,23,317,3,0,14,74,1025,1456
1,01/10/2022,0105-High Court,120279,192327,50,2968,59768,0,0,183065,2590,1945,4535,0,0,0,4966,2019,6985,4909,1237,6146,5259,38,762,0,0,16,115,1883,2814
1,01/10/2022,0109-Government Estate,90838,151479,100,4264,50828,0,0,146030,6135,2895,9030,0,500,500,3823,1844,5667,4296,1216,5512,4251,25,402,9,0,22,173,1633,2264
1,01/10/2022,0111-LIC,111339,139846,400,2904,13954,0,0,128597,1770,365,2135,0,1000,1000,4290,487,4777,4202,692,4894,4795,23,795,1,0,12,114,443,1388
1,01/10/2022,0113-Thousand Lights,162415,186421,1500,4472,37108,0,0,205495,480,300,780,0,0,0,5165,1336,6501,5764,961,6725,5804,25,436,0,0,11,158,1144,1774
1,01/10/2022,0115-AG-DMS,66295,85504,0,1640,21408,0,0,89343,0,0,0,0,0,0,2270,739,3009,2390,359,2749,2449,15,212,0,0,0,66,641,934
1,01/10/2022,0117-Teynampet,80336,106475,300,1616,29954,0,0,112206,0,0,0,0,2250,2250,2829,1073,3902,3373,592,3965,3153,21,4,4,0,8,67,1014,1118
1,01/10/2022,0119-Nandanam,77897,88069,800,1832,29794,0,0,110323,325,0,325,0,0,0,2349,998,3347,2532,551,3083,2379,33,100,2,0,10,74,949,1168
1,01/10/2022,0121-Saidapet,42574,64296,130,1368,27606,0,0,71678,2440,2425,4865,0,6000,6000,1319,887,2206,1679,531,2210,1427,6,0,1,0,3,55,870,935
1,01/10/2022,0123-Little Mount,74456,71185,100,2088,22394,0,0,99038,6615,6180,12795,0,500,500,2124,824,2948,1854,443,2297,1892,13,266,0,0,8,77,730,1094
1,01/10/2022,0125-Guindy,162206,244342,100,8160,78556,0,0,249022,5710,3330,9040,0,0,0,6245,2686,8931,5309,1838,7147,6136,39,1630,8,0,17,287,2422,4403
1,01/10/2022,0129-Nanganallur Road,36060,38724,0,560,13460,0,0,50080,1730,3425,5155,0,0,0,902,410,1312,1117,328,1445,930,6,0,1,0,2,18,389,416
1,01/10/2022,0131-Meenambakkam,162879,143947,0,3048,41726,0,0,207653,7635,14350,21985,0,0,0,3648,1210,4858,3102,876,3978,3307,23,693,2,0,12,96,1135,1961
1,01/10/2022,0133-Chennai International Airport,199549,350947,700,12104,158092,0,0,370445,15665,9875,25540,0,3750,3750,5385,4227,9612,6713,3616,10329,5991,91,1296,20,0,36,307,3897,5647
2,01/10/2022,0201-Puratchi Thalaivar Dr. M.G. Ramachandran Central,430487,517295,910,11104,57228,0,0,499729,12255,1100,13355,0,3550,3550,16186,2199,18385,11058,6763,17821,17136,79,8764,8,0,31,431,1665,10978
2,01/10/2022,0203-Egmore,95458,149792,0,2896,56168,0,0,154522,8530,2360,10890,0,16250,16250,2900,1916,4816,3790,2465,6255,3776,23,1258,4,0,19,134,1842,3280
2,01/10/2022,0205-Nehru Park,39916,58695,250,1872,20274,0,0,62312,3285,1060,4345,0,2500,2500,1474,747,2221,1439,433,1872,1546,10,337,0,0,5,91,677,1120
2,01/10/2022,0207-Kilpauk,37600,54051,0,880,17520,0,0,56000,545,130,675,0,1000,1000,1508,600,2108,1469,441,1910,1420,12,212,0,0,3,40,566,833
2,01/10/2022,0209-Pachaiyappas College,46761,44640,0,392,15396,0,0,62549,1000,290,1290,0,6000,6000,1330,527,1857,1299,337,1636,1198,10,81,1,0,1,16,512,621
2,01/10/2022,0211-Shenoy Nagar,40261,39641,0,840,11810,0,0,52911,3410,900,4310,0,2000,2000,1092,445,1537,1157,318,1475,1137,14,118,0,0,3,38,409,582
2,01/10/2022,0213-Anna Nagar East,74980,102732,100,2336,30370,0,0,107786,1005,2200,3205,0,0,0,2789,1092,3881,2990,708,3698,2852,19,265,2,0,2,92,1005,1385
2,01/10/2022,0215-Anna Nagar Tower,91317,103009,550,1976,34678,0,0,128521,5700,4500,10200,0,2500,2500,2595,1265,3860,2704,724,3428,2606,14,348,5,0,2,74,1173,1616
2,01/10/2022,0217-Thirumangalam,237804,295461,550,8384,105044,0,0,351782,138040,14650,152690,0,0,0,7028,3238,10266,7279,2357,9636,7010,52,1147,12,0,17,316,3221,4765
2,01/10/2022,0219-Koyambedu,171454,235536,300,5864,96300,0,0,273918,12240,6580,18820,13000,9500,22500,5181,3332,8513,5525,2029,7554,5176,74,1095,5,0,28,221,3077,4500
2,01/10/2022,0221-Puratchi Thalaivi Dr. J. Jayalalithaa CMBT,124832,227721,250,3448,57324,0,0,185854,0,0,0,0,0,0,4314,1888,6202,7130,5534,12664,6296,29,2426,10,0,9,129,1694,4297
2,01/10/2022,0223-Arumbakkam,52796,59213,140,2568,27082,0,0,82586,1040,170,1210,0,8500,8500,1320,1004,2324,1598,539,2137,1310,27,4,3,0,6,92,914,1046
2,01/10/2022,0225-Vadapalani,195024,265706,0,9224,67498,0,0,271746,52990,8950,61940,0,9000,9000,6921,2402,9323,6011,2546,8557,7374,56,2770,3,0,28,338,2016,5211
2,01/10/2022,0227-Ashok Nagar,137943,168107,1200,4712,39622,0,0,183477,9610,5515,15125,0,6000,6000,4787,1458,6245,3824,1329,5153,4783,30,1750,3,0,12,185,1243,3223
2,01/10/2022,0229-Ekkattuthangal,80154,98994,100,2880,36764,0,0,119898,645,705,1350,0,0,0,2491,1234,3725,2370,564,2934,2437,31,435,0,0,7,116,1151,1740
2,01/10/2022,0231-Arignar Anna Alandur,168941,203707,950,4264,78708,0,0,252863,11245,7975,19220,0,2500,2500,4685,2596,7281,4749,1675,6424,4646,82,955,11,0,21,160,2331,3560
2,01/10/2022,0233-St. Thomas Mount,107915,131849,300,3592,41400,0,0,153207,6855,2060,8915,3400,6850,10250,3210,1324,4534,2867,1022,3889,3233,25,1029,0,0,15,125,1229,2423
1,02/10/2022,01ED-Wimco Nagar Depot Metro,45133,62925,80,1896,33198,0,0,80307,505,75,580,0,3500,3500,916,807,1723,1051,483,1534,899,11,0,2,0,17,46,773,849
1,02/10/2022,01EF-Wimco Nagar Metro,70291,96125,150,2112,40038,0,0,112591,15010,3435,18445,0,250,250,1666,994,2660,1751,924,2675,1641,28,183,4,0,48,60,945,1268
1,02/10/2022,01F1-Thiruvotriyur Metro,74507,86639,0,2600,38470,0,0,115577,1110,1240,2350,0,0,0,1493,973,2466,1763,750,2513,1498,36,6,1,0,26,77,967,1113
1,02/10/2022,01F3-Thiruvotriyur Theradi Metro,103221,121262,240,3272,35824,0,0,142557,1415,1390,2805,0,0,0,2363,1005,3368,2205,1282,3487,2598,40,694,1,2,21,91,910,1759
1,02/10/2022,01F5-Kaladipet Metro,70295,77900,1700,2768,36860,0,0,111623,885,835,1720,0,0,0,1321,1123,2444,1644,832,2476,1430,15,0,1,0,20,91,1024,1151
1,02/10/2022,01F7-Tollgate Metro,34373,43163,100,1536,20576,0,0,56585,270,210,480,0,0,0,766,590,1356,927,471,1398,807,9,0,0,0,18,41,578,646
1,02/10/2022,01F9-New Washermenpet Metro,62901,70484,0,1320,26878,0,0,91099,1475,875,2350,0,0,0,1520,820,2340,1604,765,2369,1565,19,212,0,0,21,45,776,1073
1,02/10/2022,01FB-Tondiarpet Metro,47976,72575,250,2208,39440,0,0,89874,2970,1120,4090,0,0,0,1207,1209,2416,1458,826,2284,1235,15,25,0,0,15,51,1118,1224
1,02/10/2022,01FD-Thiagaraya College Metro,70296,91612,1000,2656,41102,0,0,115054,5660,3525,9185,0,2250,2250,1843,1343,3186,1944,985,2929,1891,52,180,0,0,14,82,1223,1551
1,02/10/2022,0101-Washermanpet,72082,93031,600,2888,51482,0,0,127052,11580,7090,18670,0,17750,17750,1576,1688,3264,1671,1270,2941,1526,23,215,0,0,20,82,1579,1919
1,02/10/2022,0103-Mannadi,71391,74723,150,1952,18782,0,0,92275,20350,7760,28110,0,1500,1500,1804,645,2449,1554,1091,2645,1970,13,753,1,0,13,62,599,1441
1,02/10/2022,0105-High Court,54661,88398,200,1720,29800,0,0,86381,1230,865,2095,0,0,0,2187,1077,3264,1846,1218,3064,2219,12,695,1,0,31,64,971,1774
1,02/10/2022,0109-Government Estate,47800,103526,332,3000,49190,0,0,100322,7040,1040,8080,0,250,250,1939,1782,3721,2196,1303,3499,2078,19,330,1,0,27,94,1577,2048
1,02/10/2022,0111-LIC,27874,60906,200,1456,31538,0,0,61068,6100,190,6290,0,0,0,959,1058,2017,1347,699,2046,1111,15,0,16,0,17,58,979,1085
1,02/10/2022,0113-Thousand Lights,33157,70249,200,2064,35352,0,0,70773,475,205,680,0,0,0,1140,1206,2346,1595,915,2510,1344,21,40,0,0,16,84,1044,1205
1,02/10/2022,0115-AG-DMS,25459,37799,0,968,16896,0,0,43323,0,0,0,0,1000,1000,731,548,1279,728,410,1138,750,18,167,0,0,1,35,506,727
1,02/10/2022,0117-Teynampet,29914,47414,300,824,14824,0,0,45862,0,0,0,0,0,0,1068,539,1607,1091,633,1724,1176,9,323,0,0,13,32,485,862
1,02/10/2022,0119-Nandanam,26745,46712,0,1272,27124,0,0,55141,125,0,125,0,0,0,744,929,1673,984,528,1512,763,15,14,4,0,5,47,869,954
1,02/10/2022,0121-Saidapet,20962,46780,0,1088,28280,0,0,50330,2845,900,3745,0,4000,4000,577,899,1476,1001,657,1658,684,6,0,8,0,1,35,884,934
1,02/10/2022,0123-Little Mount,36530,56852,200,1456,27508,0,0,65694,7995,1945,9940,0,2000,2000,1138,933,2071,1107,596,1703,1086,10,266,8,0,8,48,849,1189
1,02/10/2022,0125-Guindy,85021,164534,700,4656,74228,0,0,164605,4825,610,5435,0,0,0,2936,2386,5322,2801,2065,4866,3052,34,1142,4,0,28,142,2212,3562
1,02/10/2022,0129-Nanganallur Road,13819,27984,200,1160,16156,0,0,31335,1315,1170,2485,0,0,0,335,506,841,528,361,889,410,12,2,3,0,1,32,452,502
1,02/10/2022,0131-Meenambakkam,56061,98487,100,3112,51910,0,0,111183,6775,4565,11340,0,0,0,1448,1429,2877,1435,1054,2489,1425,14,393,18,0,14,81,1364,1884
1,02/10/2022,0133-Chennai International Airport,162737,339362,300,7664,175414,0,0,346115,15090,5875,20965,0,3750,3750,4462,4703,9165,5183,3818,9001,4822,39,1880,25,1,58,241,4267,6511
2,02/10/2022,0201-Puratchi Thalaivar Dr. M.G. Ramachandran Central,340952,402701,320,10344,51574,0,0,403190,17795,1790,19585,0,2350,2350,11611,1758,13369,6232,6979,13211,12103,54,8187,17,0,51,381,1522,10212
2,02/10/2022,0203-Egmore,78177,129436,600,3872,56018,0,0,138667,8560,1780,10340,0,9750,9750,2653,2020,4673,2345,2347,4692,3007,17,1536,3,0,26,163,1773,3518
2,02/10/2022,0205-Nehru Park,28312,41255,0,1664,17630,0,0,47606,4155,850,5005,0,4000,4000,857,635,1492,856,498,1354,911,12,228,2,0,11,63,575,891
2,02/10/2022,0207-Kilpauk,14324,33567,110,728,16436,0,0,31598,315,40,355,0,0,0,572,581,1153,629,423,1052,632,6,129,0,0,4,24,546,709
2,02/10/2022,0209-Pachaiyappas College,25620,27446,0,384,13274,0,0,39278,1290,210,1500,0,6000,6000,569,455,1024,588,317,905,550,9,119,0,0,6,18,432,584
2,02/10/2022,0211-Shenoy Nagar,16633,25850,500,936,11346,0,0,29415,1670,360,2030,0,0,0,523,404,927,616,317,933,558,7,94,0,0,6,33,362,502
2,02/10/2022,0213-Anna Nagar East,42186,65983,100,2296,31178,0,0,75760,1795,950,2745,0,0,0,1328,965,2293,1352,686,2038,1348,13,273,4,0,5,85,980,1360
2,02/10/2022,0215-Anna Nagar Tower,47378,65260,300,1680,30244,0,0,79602,3880,1865,5745,0,0,0,1309,1050,2359,1406,729,2135,1337,16,309,4,0,12,70,958,1369
2,02/10/2022,0217-Thirumangalam,128344,216164,200,9680,113710,0,0,251934,195895,8695,204590,0,0,0,3377,3459,6836,4055,2642,6697,3736,59,784,18,0,10,351,3348,4570
2,02/10/2022,0219-Koyambedu,106686,183730,0,6120,92694,0,0,205500,12645,3345,15990,0,3000,3000,3231,3195,6426,3543,1978,5521,3271,34,1035,15,0,51,231,2888,4254
2,02/10/2022,0221-Puratchi Thalaivi Dr. J. Jayalalithaa CMBT,61384,174029,200,3360,94394,0,0,159338,0,0,0,0,0,0,2216,3027,5243,3479,3816,7295,2836,22,1157,3,0,8,105,2845,4140
2,02/10/2022,0223-Arumbakkam,37262,41746,300,1216,23768,0,0,62546,1175,180,1355,0,12500,12500,687,879,1566,949,595,1544,719,14,2,7,0,23,44,826,916
2,02/10/2022,0225-Vadapalani,169118,238636,200,8648,58304,0,0,236270,59780,8100,67880,0,5000,5000,5919,2287,8206,4352,3502,7854,6326,41,3223,9,0,52,292,1781,5398
2,02/10/2022,0227-Ashok Nagar,68894,110083,300,3784,52216,0,0,125194,9145,2700,11845,0,6000,6000,2026,1910,3936,2113,1382,3495,2167,15,806,9,0,6,151,1676,2663
2,02/10/2022,0229-Ekkattuthangal,31070,51330,50,1960,23592,0,0,56672,385,240,625,0,0,0,1031,846,1877,1252,498,1750,1117,3,289,0,0,11,76,748,1127
2,02/10/2022,0231-Arignar Anna Alandur,106969,180437,200,4896,97384,0,0,209449,11790,5415,17205,0,0,0,2878,3151,6029,3030,2186,5216,2948,65,809,9,0,31,176,2842,3932
2,02/10/2022,0233-St. Thomas Mount,54568,86357,0,3784,41716,0,0,100068,7180,2205,9385,9000,3000,12000,1428,1423,2851,1825,1198,3023,1598,15,415,6,0,23,123,1294,1876
1,03/10/2022,01ED-Wimco Nagar Depot Metro,112059,77762,0,2088,28446,0,0,142593,140,145,285,0,11000,11000,1865,728,2593,1566,398,1964,1548,16,24,4,0,12,65,684,805
1,03/10/2022,01EF-Wimco Nagar Metro,164999,142785,338,3000,39234,0,0,207571,13575,6535,20110,0,500,500,3417,980,4397,3130,987,4117,3172,43,178,1,1,30,83,935,1271
1,03/10/2022,01F1-Thiruvotriyur Metro,151097,104865,0,1824,30276,0,0,183197,1170,1545,2715,0,0,0,2609,828,3437,2591,615,3206,2465,60,0,0,0,16,59,771,906
1,03/10/2022,01F3-Thiruvotriyur Theradi Metro,123936,118656,1700,1832,34330,0,0,161798,845,2570,3415,0,0,0,2644,980,3624,2934,921,3855,2854,22,116,3,0,10,56,929,1136
1,03/10/2022,01F5-Kaladipet Metro,132167,95429,100,1672,27806,0,0,161745,1600,2355,3955,0,0,0,2580,847,3427,2532,746,3278,2435,21,0,1,0,11,57,781,871
1,03/10/2022,01F7-Tollgate Metro,68520,55912,1100,752,16816,0,0,87188,120,590,710,0,250,250,1442,544,1986,1497,429,1926,1406,21,9,0,0,13,28,507,578
1,03/10/2022,01F9-New Washermenpet Metro,133560,92541,100,1240,27706,0,0,162606,1300,2345,3645,0,1250,1250,2569,907,3476,2602,750,3352,2499,13,91,2,0,8,46,869,1029
1,03/10/2022,01FB-Tondiarpet Metro,126362,95595,600,1952,29806,0,0,158720,2735,3110,5845,0,0,0,2477,970,3447,2682,856,3538,2551,19,2,14,1,16,65,906,1023
1,03/10/2022,01FD-Thiagaraya College Metro,120983,115301,2600,2640,36558,0,0,162781,4235,2730,6965,0,500,500,3049,1250,4299,3262,987,4249,3157,46,48,2,0,6,87,1149,1338
1,03/10/2022,0101-Washermanpet,121655,122508,300,2376,48270,0,0,172601,9565,4440,14005,0,11750,11750,3250,1670,4920,3048,1221,4269,2986,19,157,1,0,13,83,1574,1847
1,03/10/2022,0103-Mannadi,98168,109237,200,1296,31882,0,0,131546,9255,8425,17680,0,3000,3000,2855,1080,3935,2989,1128,4117,3149,25,344,1,0,7,45,1042,1464
1,03/10/2022,0105-High Court,137883,209315,200,2600,71976,0,0,212659,1525,2395,3920,0,0,0,5488,2516,8004,5687,1858,7545,5631,33,218,1,0,15,99,2381,2747
1,03/10/2022,0109-Government Estate,109839,159914,1360,2816,60090,0,0,174105,6925,2570,9495,0,5000,5000,3769,2199,5968,4368,1806,6174,4283,29,264,3,0,7,120,2015,2438
1,03/10/2022,0111-LIC,108409,148329,190,2840,34618,0,0,146057,1730,905,2635,0,2500,2500,3853,1222,5075,4604,990,5594,4546,23,76,0,0,7,98,1096,1300
1,03/10/2022,0113-Thousand Lights,208410,216827,720,5144,35744,0,0,250018,1040,305,1345,0,0,0,6423,1320,7743,6811,1445,8256,7115,23,518,0,0,8,189,1109,1847
1,03/10/2022,0115-AG-DMS,136640,133821,220,1808,28636,0,0,167304,0,0,0,0,2000,2000,4025,990,5015,4015,751,4766,4091,27,181,0,0,4,72,885,1169
1,03/10/2022,0117-Teynampet,124966,136143,600,2384,32968,0,0,160918,0,0,0,0,3000,3000,3858,1228,5086,4404,916,5320,4235,30,0,1,0,10,97,1107,1245
1,03/10/2022,0119-Nandanam,121929,113761,2550,2592,30142,0,0,157213,205,15,220,0,250,250,3137,1093,4230,3526,793,4319,3482,33,90,0,0,5,99,983,1210
1,03/10/2022,0121-Saidapet,61443,70268,1050,992,25846,0,0,89331,4535,1465,6000,0,6250,6250,1547,884,2431,1956,662,2618,1790,8,0,0,0,1,39,841,889
1,03/10/2022,0123-Little Mount,117886,89013,1868,1664,26022,0,0,147440,3525,6010,9535,0,7500,7500,2792,923,3715,2429,559,2988,2521,27,245,1,0,6,67,832,1178
1,03/10/2022,0125-Guindy,185242,247896,3100,6776,77368,0,0,272486,7720,4415,12135,0,3000,3000,6716,2684,9400,6462,2252,8714,6599,37,653,0,2,22,248,2409,3371
1,03/10/2022,0129-Nanganallur Road,57165,45133,0,792,14032,0,0,71989,2550,5845,8395,0,0,0,1120,432,1552,1303,313,1616,1179,11,0,2,1,3,27,405,449
1,03/10/2022,0131-Meenambakkam,160886,133529,1010,2720,42488,0,0,207104,7125,15215,22340,0,0,0,3498,1224,4722,3000,880,3880,3053,27,318,3,0,14,90,1147,1599
1,03/10/2022,0133-Chennai International Airport,212462,348549,1600,8744,164086,0,0,386892,12365,10365,22730,0,4500,4500,5497,4519,10016,6477,3675,10152,5872,67,824,17,1,37,270,4100,5316
2,03/10/2022,0201-Puratchi Thalaivar Dr. M.G. Ramachandran Central,492242,488880,1200,13040,52004,0,0,558486,21545,1580,23125,0,10300,10300,16369,2252,18621,10472,7142,17614,16520,113,7404,16,0,29,488,1601,9651
2,03/10/2022,0203-Egmore,89393,127523,1300,3568,56822,0,0,151083,14410,2415,16825,0,15250,15250,2395,1966,4361,2955,2430,5385,2854,19,618,9,0,9,142,1847,2644
2,03/10/2022,0205-Nehru Park,48836,56845,100,1424,20850,0,0,71210,2205,1035,3240,0,750,750,1458,747,2205,1407,531,1938,1482,10,213,3,0,13,52,702,993
2,03/10/2022,0207-Kilpauk,52885,57996,600,616,20050,0,0,74151,460,360,820,0,0,0,1451,694,2145,1592,591,2183,1513,11,99,0,0,0,25,665,800
2,03/10/2022,0209-Pachaiyappas College,42517,41018,0,400,13146,0,0,56063,1680,1220,2900,0,6000,6000,1228,484,1712,1177,376,1553,1163,15,87,1,0,2,18,454,577
2,03/10/2022,0211-Shenoy Nagar,41764,41374,400,776,12694,0,0,55634,970,1300,2270,0,0,0,1068,471,1539,1184,395,1579,1160,7,90,2,0,4,31,423,557
2,03/10/2022,0213-Anna Nagar East,98121,108216,202,3016,32302,0,0,133641,1275,3240,4515,0,0,0,2966,893,3859,3065,842,3907,3011,25,228,2,0,4,81,1070,1410
2,03/10/2022,0215-Anna Nagar Tower,91931,86635,100,1464,28296,0,0,121791,6275,8170,14445,0,1250,1250,2073,992,3065,2411,836,3247,2298,14,203,0,0,2,60,904,1183
2,03/10/2022,0217-Thirumangalam,311390,303866,650,6352,101712,0,0,420104,93290,18310,111600,0,0,0,7338,3206,10544,7625,2871,10496,7505,59,634,4,0,18,236,3118,4069
2,03/10/2022,0219-Koyambedu,221351,218665,700,4776,77824,0,0,304651,10125,8260,18385,250,18250,18500,5346,2710,8056,4786,2178,6964,5140,36,1136,5,0,29,180,2460,3846
2,03/10/2022,0221-Puratchi Thalaivi Dr. J. Jayalalithaa CMBT,82326,195622,100,2832,104488,0,0,189746,0,0,0,0,0,0,2478,3325,5803,4294,3967,8261,3492,27,531,6,0,8,119,3183,3874
2,03/10/2022,0223-Arumbakkam,60042,57566,200,1176,24046,0,0,85464,1435,270,1705,0,15250,15250,1417,919,2336,1651,567,2218,1380,21,4,4,0,12,50,858,949
2,03/10/2022,0225-Vadapalani,191781,248867,250,6128,56254,0,0,254413,36980,6080,43060,0,9000,9000,6723,2040,8763,5329,3256,8585,7136,47,2724,0,0,22,213,1742,4748
2,03/10/2022,0227-Ashok Nagar,109755,147563,664,3760,52826,0,0,167005,7205,5345,12550,0,9500,9500,3658,1924,5582,3528,1558,5086,3647,29,745,2,0,8,145,1717,2646
2,03/10/2022,0229-Ekkattuthangal,122494,120870,1380,2856,31726,0,0,158456,155,1785,1940,0,250,250,3160,1160,4320,3429,870,4299,3470,22,282,2,0,2,109,996,1413
2,03/10/2022,0231-Arignar Anna Alandur,171855,203488,950,6216,77850,0,0,256871,11590,12120,23710,0,3250,3250,4710,2623,7333,4871,1913,6784,4750,58,546,7,0,16,169,2352,3148
2,03/10/2022,0233-St. Thomas Mount,89366,112011,2250,3008,47618,0,0,142242,2830,2875,5705,3000,1425,4425,2381,1611,3992,2758,1149,3907,2491,26,124,2,0,11,113,1458,1734
1,04/10/2022,01ED-Wimco Nagar Depot Metro,49422,60063,422,2904,25626,0,0,78374,110,195,305,0,1500,1500,1217,689,1906,1057,387,1444,1064,9,1,3,0,18,75,621,727
1,04/10/2022,01EF-Wimco Nagar Metro,76719,94784,102,3080,32006,0,0,111907,7855,3625,11480,0,0,0,1998,860,2858,1842,763,2605,1928,34,174,0,0,31,90,784,1113
1,04/10/2022,01F1-Thiruvotriyur Metro,71580,75901,200,2000,27448,0,0,101228,1300,860,2160,0,0,0,1657,765,2422,1625,545,2170,1583,37,7,0,0,24,64,713,845
1,04/10/2022,01F3-Thiruvotriyur Theradi Metro,68691,92096,310,2128,32846,0,0,103975,1720,535,2255,0,0,0,1845,953,2798,1954,916,2870,1996,19,153,1,0,7,57,900,1137
1,04/10/2022,01F5-Kaladipet Metro,56660,65318,0,1384,24056,0,0,82100,830,1085,1915,0,0,0,1554,718,2272,1508,699,2207,1489,17,61,4,0,6,42,692,822
1,04/10/2022,01F7-Tollgate Metro,39060,43040,0,832,16778,0,0,56670,95,250,345,0,0,0,944,557,1501,1044,371,1415,969,18,14,0,0,18,27,520,597
1,04/10/2022,01F9-New Washermenpet Metro,51931,60322,600,776,21582,0,0,74889,990,910,1900,0,250,250,1520,685,2205,1463,636,2099,1485,9,86,0,0,6,29,662,792
1,04/10/2022,01FB-Tondiarpet Metro,53904,67232,600,1720,28590,0,0,84814,1770,1485,3255,0,0,0,1487,902,2389,1556,703,2259,1500,12,1,2,0,10,53,842,920
1,04/10/2022,01FD-Thiagaraya College Metro,75213,82492,0,2968,31320,0,0,109501,4035,1190,5225,0,250,250,2022,1044,3066,1975,858,2833,2013,38,119,7,0,8,94,939,1205
1,04/10/2022,0101-Washermanpet,75833,83995,700,1952,41434,0,0,119919,14570,4225,18795,0,8750,8750,1759,1356,3115,1702,1168,2870,1667,17,136,0,0,13,65,1283,1514
1,04/10/2022,0103-Mannadi,50245,74481,0,832,28056,0,0,79133,17115,4325,21440,0,0,0,1671,936,2607,1768,1153,2921,1839,15,221,2,0,15,29,896,1178
1,04/10/2022,0105-High Court,61869,127906,90,3328,57358,0,0,122645,1855,1080,2935,0,0,0,2599,1912,4511,2840,1522,4362,2867,7,207,1,0,18,63,1834,2130
1,04/10/2022,0109-Government Estate,53424,111833,400,2120,55652,0,0,111596,5410,1710,7120,0,5000,5000,2091,1957,4048,2562,1417,3979,2386,14,116,10,0,16,78,1798,2032
1,04/10/2022,0111-LIC,45722,80901,2040,2320,25244,0,0,75326,535,215,750,0,0,0,1825,912,2737,2289,792,3081,2190,16,0,0,0,14,81,797,908
1,04/10/2022,0113-Thousand Lights,54776,85886,300,1992,32762,0,0,89830,295,135,430,0,0,0,1898,1141,3039,2340,977,3317,2125,16,1,2,0,9,83,1018,1129
1,04/10/2022,0115-AG-DMS,42870,45600,0,1056,13042,0,0,56968,0,0,0,0,0,0,1130,445,1575,1143,393,1536,1225,6,139,1,0,2,32,394,574
1,04/10/2022,0117-Teynampet,24254,50177,0,1152,16374,0,0,41780,0,0,0,0,0,0,1073,590,1663,1458,564,2022,1373,5,22,0,0,5,45,535,612
1,04/10/2022,0119-Nandanam,36119,53971,300,1176,20086,0,0,57681,0,0,0,0,0,0,1250,721,1971,1480,564,2044,1373,13,19,0,0,9,45,664,750
1,04/10/2022,0121-Saidapet,24817,35095,300,1504,16170,0,0,42791,1845,870,2715,0,6000,6000,644,589,1233,800,517,1317,739,11,0,0,0,2,46,538,597
1,04/10/2022,0123-Little Mount,37940,39516,0,1048,16768,0,0,55756,9780,2085,11865,0,0,0,934,577,1511,927,462,1389,878,9,89,3,0,5,44,528,678
1,04/10/2022,0125-Guindy,87367,145361,800,4208,61818,0,0,154193,4180,1260,5440,0,0,0,2919,2090,5009,2967,1904,4871,3022,36,477,2,0,30,154,1866,2565
1,04/10/2022,0129-Nanganallur Road,28462,25984,0,840,10744,0,0,40046,870,1465,2335,0,0,0,462,328,790,607,291,898,549,3,0,0,0,8,21,304,336
1,04/10/2022,0131-Meenambakkam,71146,83143,0,1608,35408,0,0,108162,6315,8650,14965,0,0,0,1730,990,2720,1372,822,2194,1551,14,350,6,0,14,53,952,1389
1,04/10/2022,0133-Chennai International Airport,129966,301551,500,9360,172962,0,0,312788,12330,4345,16675,0,2250,2250,3707,4745,8452,4010,3813,7823,3981,54,1003,16,0,46,258,4273,5650
2,04/10/2022,0201-Puratchi Thalaivar Dr. M.G. Ramachandran Central,265359,344979,890,7616,82540,0,0,356405,15050,1160,16210,0,6050,6050,9419,2684,12103,5589,6335,11924,9495,56,4920,7,0,60,301,2610,7954
2,04/10/2022,0203-Egmore,45749,95390,650,2968,50030,0,0,99397,15765,1490,17255,0,4000,4000,1510,1810,3320,1841,2171,4012,1740,15,420,4,0,16,114,1647,2216
2,04/10/2022,0205-Nehru Park,29390,47738,50,2520,21296,0,0,53256,2340,355,2695,0,0,0,940,757,1697,894,610,1504,1021,12,202,0,0,5,87,686,992
2,04/10/2022,0207-Kilpauk,20385,32901,200,440,13238,0,0,34263,280,125,405,0,0,0,746,479,1225,769,390,1159,772,7,101,0,0,1,18,452,579
2,04/10/2022,0209-Pachaiyappas College,23163,25341,100,512,9928,0,0,33703,490,690,1180,0,6000,6000,622,364,986,660,257,917,635,9,60,0,0,3,18,342,432
2,04/10/2022,0211-Shenoy Nagar,24310,26122,700,440,10654,0,0,36104,690,2090,2780,0,2000,2000,555,372,927,615,323,938,603,6,84,1,0,0,16,347,454
2,04/10/2022,0213-Anna Nagar East,46398,62164,200,1328,22748,0,0,70674,800,1310,2110,0,3000,3000,1551,763,2314,1524,723,2247,1549,15,185,0,0,7,61,737,1005
2,04/10/2022,0215-Anna Nagar Tower,54249,59727,550,1080,22052,0,0,77931,3320,1525,4845,0,250,250,1350,772,2122,1455,741,2196,1437,22,252,7,0,5,37,714,1037
2,04/10/2022,0217-Thirumangalam,125742,193325,2340,6368,84836,0,0,219286,115200,9735,124935,0,0,0,3808,2673,6481,3905,2424,6329,3979,29,610,9,0,12,223,2571,3454
2,04/10/2022,0219-Koyambedu,99585,153999,230,3088,74448,0,0,177351,8635,4820,13455,0,1250,1250,2875,2504,5379,2681,1993,4674,2884,25,702,4,0,22,141,2282,3176
2,04/10/2022,0221-Puratchi Thalaivi Dr. J. Jayalalithaa CMBT,50646,139075,320,1800,78048,0,0,130814,0,0,0,0,0,0,1763,2463,4226,2432,2822,5254,2248,13,637,5,0,10,75,2355,3095
2,04/10/2022,0223-Arumbakkam,29579,37179,600,528,18404,0,0,49111,1650,105,1755,0,4000,4000,766,724,1490,909,529,1438,771,15,19,3,0,12,25,679,753
2,04/10/2022,0225-Vadapalani,169297,214512,600,6752,90624,0,0,267273,46530,6240,52770,0,51500,51500,4216,3228,7444,4163,3075,7238,4598,51,1436,7,0,30,260,2876,4660
2,04/10/2022,0227-Ashok Nagar,64699,92402,75,2816,44224,0,0,111814,7765,3640,11405,0,9000,9000,1857,1574,3431,1756,1331,3087,1892,10,420,1,0,13,99,1420,1963
2,04/10/2022,0229-Ekkattuthangal,51094,69788,500,2056,21178,0,0,74828,595,80,675,0,1000,1000,1730,778,2508,1781,636,2417,1903,21,304,0,0,4,88,669,1086
2,04/10/2022,0231-Arignar Anna Alandur,99930,131319,200,3576,55836,0,0,159542,7005,3840,10845,0,0,0,2654,1842,4496,2703,1628,4331,2761,37,558,12,0,33,118,1639,2397
2,04/10/2022,0233-St. Thomas Mount,49999,77745,400,2368,37418,0,0,90185,2900,1460,4360,3000,2550,5550,1414,1250,2664,1555,982,2537,1483,24,289,8,0,8,88,1139,1556
1,05/10/2022,01ED-Wimco Nagar Depot Metro,73189,66162,0,1648,28178,0,0,103015,280,200,480,0,2000,2000,1306,663,1969,1224,393,1617,1163,12,0,12,0,16,40,671,751
1,05/10/2022,01EF-Wimco Nagar Metro,99256,100851,100,2544,31752,0,0,133652,13635,3745,17380,0,1500,1500,2144,827,2971,2022,704,2726,2069,22,184,0,0,25,68,745,1044
1,05/10/2022,01F1-Thiruvotriyur Metro,109423,87132,0,2256,24474,0,0,136153,1185,1330,2515,0,0,0,1994,688,2682,1945,608,2553,1979,26,137,0,0,12,50,618,843
1,05/10/2022,01F3-Thiruvotriyur Theradi Metro,85954,97957,1574,2112,32502,0,0,122142,2220,2080,4300,0,0,0,2004,947,2951,2256,945,3201,2194,26,96,2,0,14,60,860,1058
1,05/10/2022,01F5-Kaladipet Metro,89478,76203,0,1640,28004,0,0,119122,775,1420,2195,0,0,0,1824,843,2667,1867,655,2522,1745,21,14,6,0,9,58,779,887
1,05/10/2022,01F7-Tollgate Metro,42323,43095,0,648,16840,0,0,59811,110,900,1010,0,0,0,991,515,1506,1064,438,1502,940,13,2,0,0,11,12,493,531
1,05/10/2022,01F9-New Washermenpet Metro,67603,74730,400,1328,24516,0,0,93847,1225,1060,2285,0,250,250,1881,797,2678,1908,721,2629,1896,15,104,1,0,13,44,744,921
1,05/10/2022,01FB-Tondiarpet Metro,60013,74991,850,1184,30734,0,0,92781,1510,2370,3880,0,1250,1250,1708,950,2658,1861,817,2678,1730,16,1,0,0,14,38,897,966
1,05/10/2022,01FD-Thiagaraya College Metro,76244,91004,0,2288,35166,0,0,113698,5845,1460,7305,0,0,0,2143,1167,3310,2212,881,3093,2189,29,74,0,0,6,83,1072,1264
1,05/10/2022,0101-Washermanpet,89862,90534,60,2240,40812,0,0,132974,11310,4520,15830,0,19000,19000,2014,1373,3387,1993,1290,3283,1958,16,130,8,0,9,87,1272,1522
1,05/10/2022,0103-Mannadi,54327,76222,100,1152,34166,0,0,89745,13430,4240,17670,0,1500,1500,1612,1122,2734,1746,1132,2878,1752,11,126,0,0,8,41,1079,1265
1,05/10/2022,0105-High Court,63018,106217,351,1480,44348,0,0,109197,1465,2410,3875,0,0,0,2397,1507,3904,2534,1178,3712,2547,10,147,2,0,9,58,1433,1659
1,05/10/2022,0109-Government Estate,67165,114615,1800,2008,47976,0,0,118949,3690,1675,5365,0,500,500,2462,1700,4162,2967,1380,4347,2857,22,180,3,0,15,88,1570,1878
1,05/10/2022,0111-LIC,39540,71987,700,1488,25930,0,0,67658,2120,305,2425,0,2000,2000,1511,862,2373,1990,723,2713,1809,12,0,0,0,13,47,787,859
1,05/10/2022,0113-Thousand Lights,97754,130246,0,2576,32404,0,0,132734,570,70,640,0,0,0,3411,1145,4556,3889,1116,5005,3825,19,176,0,1,7,103,1000,1306
1,05/10/2022,0115-AG-DMS,50097,53446,0,712,16942,0,0,67751,0,0,0,0,0,0,1311,564,1875,1387,446,1833,1382,6,118,0,0,3,28,517,672
1,05/10/2022,0117-Teynampet,57264,72906,100,1144,21672,0,0,80180,0,0,0,0,1000,1000,1793,796,2589,2236,706,2942,2104,15,21,0,0,6,48,724,814
1,05/10/2022,0119-Nandanam,75641,73957,400,1792,23884,0,0,101717,450,10,460,0,0,0,1792,898,2690,2289,656,2945,2076,25,3,3,0,6,70,783,890
1,05/10/2022,0121-Saidapet,34265,42521,0,960,18662,0,0,53887,1695,1555,3250,0,4250,4250,804,644,1448,1095,571,1666,959,12,0,0,0,2,36,601,651
1,05/10/2022,0123-Little Mount,54237,53255,200,1040,20500,0,0,75977,3275,2775,6050,0,0,0,1386,686,2072,1253,532,1785,1260,19,146,0,0,9,40,633,847
1,05/10/2022,0125-Guindy,109862,161769,600,4856,63294,0,0,178612,6405,4615,11020,0,4000,4000,3671,2110,5781,3781,1949,5730,3725,27,412,0,0,21,164,1891,2515
1,05/10/2022,0129-Nanganallur Road,39655,27681,200,680,10654,0,0,51189,1565,2505,4070,0,0,0,531,337,868,699,322,1021,622,8,0,0,0,1,23,303,335
1,05/10/2022,0131-Meenambakkam,99932,96593,600,3152,39044,0,0,142728,9070,8970,18040,0,0,0,2126,1131,3257,1694,821,2515,1856,14,336,1,0,12,75,1035,1473
1,05/10/2022,0133-Chennai International Airport,139908,302874,300,8576,163696,0,0,312480,10895,5670,16565,0,1500,1500,3961,4518,8479,4679,3572,8251,4405,44,829,10,1,40,279,4088,5291
2,05/10/2022,0201-Puratchi Thalaivar Dr. M.G. Ramachandran Central,315203,370726,1100,12840,57578,0,0,386721,18075,1925,20000,0,3350,3350,11649,2075,13724,6350,6585,12935,11488,57,6069,21,0,33,507,1695,8382
2,05/10/2022,0203-Egmore,61343,115661,174,3752,60464,0,0,125733,12555,1895,14450,0,6250,6250,1998,2066,4064,2150,2003,4153,2189,20,626,13,0,19,140,1981,2799
2,05/10/2022,0205-Nehru Park,35459,48453,150,1744,20640,0,0,57993,1165,550,1715,0,4000,4000,1059,760,1819,1019,634,1653,1110,18,203,0,0,6,66,692,985
2,05/10/2022,0207-Kilpauk,24191,40969,240,1136,13470,0,0,39037,180,45,225,0,0,0,917,505,1422,1038,510,1548,1085,6,136,0,0,2,45,454,643
2,05/10/2022,0209-Pachaiyappas College,36998,30302,0,440,10676,0,0,48114,700,1140,1840,0,6000,6000,781,386,1167,826,341,1167,795,10,91,0,0,6,15,359,481
2,05/10/2022,0211-Shenoy Nagar,24534,28590,0,624,10112,0,0,35270,1330,590,1920,0,3000,3000,688,363,1051,782,352,1134,726,10,63,0,0,3,23,329,428
2,05/10/2022,0213-Anna Nagar East,61779,67848,200,1952,21582,0,0,85513,1315,1425,2740,0,3000,3000,1727,777,2504,1769,728,2497,1798,22,213,1,0,7,67,697,1007
2,05/10/2022,0215-Anna Nagar Tower,53957,63904,800,1552,18278,0,0,74587,2830,3410,6240,0,0,0,1578,693,2271,1526,779,2305,1714,21,408,2,0,2,63,614,1110
2,05/10/2022,0217-Thirumangalam,180439,217013,250,6904,89102,0,0,276695,109580,8290,117870,0,0,0,4417,2759,7176,4639,2565,7204,4723,46,676,3,0,11,250,2647,3633
2,05/10/2022,0219-Koyambedu,139305,171785,0,5072,82860,0,0,227237,9795,4505,14300,0,12750,12750,3333,2901,6234,3065,1997,5062,3255,33,793,9,0,13,225,2632,3705
2,05/10/2022,0221-Puratchi Thalaivi Dr. J. Jayalalithaa CMBT,56525,170138,20,4656,101902,0,0,163103,0,0,0,0,0,0,2242,3344,5586,2751,3233,5984,2532,23,638,2,0,14,181,3117,3975
2,05/10/2022,0223-Arumbakkam,47248,46588,0,888,24138,0,0,72274,4360,105,4465,0,10750,10750,885,868,1753,1106,539,1645,933,11,0,0,0,14,37,813,875
2,05/10/2022,0225-Vadapalani,138026,204560,200,7768,69588,0,0,215582,37570,6530,44100,0,4500,4500,4470,2527,6997,3782,3076,6858,4897,40,1697,0,0,34,300,2182,4253
2,05/10/2022,0227-Ashok Nagar,65763,99820,700,3464,47460,0,0,117387,8875,3270,12145,0,12000,12000,1820,1690,3510,2200,1298,3498,2017,18,307,3,0,9,120,1529,1986
2,05/10/2022,0229-Ekkattuthangal,59776,70519,2000,2184,22582,0,0,86542,80,150,230,0,1250,1250,1684,824,2508,1916,770,2686,1906,14,221,0,0,3,81,711,1030
2,05/10/2022,0231-Arignar Anna Alandur,128380,157479,600,4208,63612,0,0,196800,7940,6620,14560,0,3250,3250,3297,2159,5456,3249,1677,4926,3384,41,567,5,0,20,138,1913,2684
2,05/10/2022,0233-St. Thomas Mount,68420,82766,950,3128,40506,0,0,113004,1835,1365,3200,3000,6100,9100,1478,1332,2810,1670,989,2659,1546,26,155,7,0,9,96,1201,1494
1,06/10/2022,01ED-Wimco Nagar Depot Metro,110667,80117,0,1544,26286,0,0,138497,190,165,355,0,8000,8000,2028,681,2709,1717,416,2133,1661,11,35,5,0,11,44,638,744
1,06/10/2022,01EF-Wimco Nagar Metro,179568,139519,550,3856,25896,0,0,209870,15680,9190,24870,0,1750,1750,3588,722,4310,3283,881,4164,3449,62,322,3,0,12,102,612,1113
1,06/10/2022,01F1-Thiruvotriyur Metro,154596,109655,0,1336,24998,0,0,180930,1230,2020,3250,0,0,0,2815,692,3507,2911,569,3480,2742,53,2,2,0,11,39,656,763
1,06/10/2022,01F3-Thiruvotriyur Theradi Metro,122339,122304,400,2120,25690,0,0,150549,1340,2480,3820,0,0,0,2881,765,3646,3251,748,3999,3233,26,176,2,0,14,61,678,957
1,06/10/2022,01F5-Kaladipet Metro,141077,106153,0,1904,28154,0,0,171135,1390,2405,3795,0,0,0,2857,867,3724,2936,611,3547,2810,17,0,0,0,9,58,802,886
1,06/10/2022,01F7-Tollgate Metro,82283,58245,200,1096,14376,0,0,97955,100,840,940,0,0,0,1609,478,2087,1647,391,2038,1580,19,19,0,0,7,37,439,521
1,06/10/2022,01F9-New Washermenpet Metro,126632,102399,1200,824,26330,0,0,154986,1420,2160,3580,0,250,250,2903,866,3769,3061,639,3700,2904,23,85,2,0,9,34,829,982
1,06/10/2022,01FB-Tondiarpet Metro,121471,103191,150,1560,27880,0,0,151061,2790,4050,6840,0,0,0,2821,890,3711,3108,743,3851,2903,18,12,2,0,8,50,837,927
1,06/10/2022,01FD-Thiagaraya College Metro,149054,125999,450,1760,30262,0,0,181526,7135,3200,10335,0,3250,3250,3667,1030,4697,3790,943,4733,3805,26,185,1,0,2,63,962,1239
1,06/10/2022,0101-Washermanpet,162977,128636,1200,1552,40624,0,0,206353,9135,5755,14890,0,14750,14750,3738,1378,5116,3469,1198,4667,3500,23,313,1,0,13,59,1308,1717
1,06/10/2022,0103-Mannadi,104076,112048,300,880,28862,0,0,134118,11180,7250,18430,0,0,0,3130,962,4092,3377,1086,4463,3417,25,342,0,0,5,39,943,1354
1,06/10/2022,0105-High Court,152579,198974,1000,2760,48382,0,0,204721,875,1520,2395,0,0,0,5893,1723,7616,5843,1569,7412,6120,28,481,0,0,2,109,1598,2218
1,06/10/2022,0109-Government Estate,122705,159811,400,2352,47942,0,0,173399,3620,2910,6530,0,1000,1000,4139,1734,5873,4702,1597,6299,4761,27,405,5,0,16,99,1580,2132
1,06/10/2022,0111-LIC,97491,178542,956,2112,34324,0,0,134883,1750,690,2440,0,500,500,4986,1195,6181,5955,1083,7038,5797,34,51,2,0,3,86,1076,1252
1,06/10/2022,0113-Thousand Lights,193963,242991,3220,3896,35756,0,0,236835,1225,275,1500,0,0,0,7440,1363,8803,8160,1430,9590,8210,45,411,0,0,4,168,1131,1759
1,06/10/2022,0115-AG-DMS,160570,156341,350,1960,27276,0,0,190156,0,0,0,0,3000,3000,4905,965,5870,4953,709,5662,5034,25,296,0,0,4,71,845,1241
1,06/10/2022,0117-Teynampet,128580,152308,3414,1704,29988,0,0,163686,0,0,0,0,3000,3000,4599,1113,5712,5221,930,6151,5066,24,114,2,0,5,63,1014,1222
1,06/10/2022,0119-Nandanam,116490,123377,900,2024,27986,0,0,147400,225,0,225,0,2000,2000,3669,1064,4733,4268,772,5040,4049,40,28,1,0,6,77,950,1102
1,06/10/2022,0121-Saidapet,74195,88012,2300,1240,27234,0,0,104969,3115,1580,4695,0,6500,6500,1995,939,2934,2681,785,3466,2447,26,1,0,0,13,50,870,960
1,06/10/2022,0123-Little Mount,101411,96862,2606,2000,24580,0,0,130597,4535,6015,10550,0,250,250,3325,935,4260,2974,731,3705,2916,26,186,2,0,3,81,821,1119
1,06/10/2022,0125-Guindy,183070,259749,900,5736,58376,0,0,248082,8380,4415,12795,0,2000,2000,8310,2107,10417,7600,2260,9860,7963,47,960,1,0,12,212,1797,3029
1,06/10/2022,0129-Nanganallur Road,55981,47401,0,320,14702,0,0,71003,2995,4910,7905,0,0,0,1197,453,1650,1417,279,1696,1260,14,0,2,0,0,14,435,465
1,06/10/2022,0131-Meenambakkam,166459,142498,4460,2456,38106,0,0,211481,7225,15735,22960,0,0,0,4012,1119,5131,3441,920,4361,3531,30,307,11,0,3,80,1044,1475
1,06/10/2022,0133-Chennai International Airport,218922,358253,1549,9112,152574,0,0,382157,7730,11220,18950,0,8500,8500,6189,4201,10390,6783,3476,10259,6550,79,973,12,0,53,251,3737,5105
2,06/10/2022,0201-Puratchi Thalaivar Dr. M.G. Ramachandran Central,445342,494149,1452,14640,74120,0,0,535554,31265,2825,34090,0,7800,7800,17113,2968,20081,11369,6618,17987,16410,118,6390,8,0,25,544,2238,9323
2,06/10/2022,0203-Egmore,113061,142056,16,3960,55002,0,0,172039,13860,4610,18470,0,20000,20000,3329,1938,5267,3058,2358,5416,3452,31,1130,16,0,6,155,1808,3146
2,06/10/2022,0205-Nehru Park,57436,52437,220,976,17858,0,0,76490,1715,825,2540,0,1000,1000,1446,673,2119,1494,578,2072,1444,14,141,0,1,11,39,612,818
2,06/10/2022,0207-Kilpauk,44202,63772,250,1064,17834,0,0,63350,425,335,760,0,0,0,1683,638,2321,1845,538,2383,1849,14,150,0,0,1,48,580,793
2,06/10/2022,0209-Pachaiyappas College,66803,52060,0,744,13184,0,0,80731,1260,1160,2420,0,4250,4250,1778,513,2291,1674,410,2084,1633,19,116,1,0,4,30,468,638
2,06/10/2022,0211-Shenoy Nagar,53936,49724,50,424,12404,0,0,66814,1290,2170,3460,0,1500,1500,1317,452,1769,1608,328,1936,1533,8,76,0,0,3,18,425,530
2,06/10/2022,0213-Anna Nagar East,105593,113251,0,2168,27792,0,0,135553,1235,3690,4925,0,0,0,3248,1056,4304,3396,810,4206,3399,17,240,0,0,3,93,949,1302
2,06/10/2022,0215-Anna Nagar Tower,110209,103644,900,1744,23472,0,0,136325,5150,6990,12140,0,1000,1000,2917,864,3781,3103,788,3891,3084,27,257,0,0,0,70,778,1132
2,06/10/2022,0217-Thirumangalam,350279,317176,300,8272,75518,0,0,434369,71445,19405,90850,0,1500,1500,8542,2536,11078,8940,2403,11343,9029,62,869,9,0,15,263,2281,3499
2,06/10/2022,0219-Koyambedu,276614,251660,445,4592,82668,0,0,364319,10850,11995,22845,5000,26750,31750,6457,2866,9323,5975,2086,8061,6169,67,1075,3,0,23,195,2613,3976
2,06/10/2022,0221-Puratchi Thalaivi Dr. J. Jayalalithaa CMBT,105527,214526,400,4944,100804,0,0,211675,0,0,0,0,0,0,3781,3328,7109,4185,3329,7514,4274,27,1238,1,0,8,190,3117,4581
2,06/10/2022,0223-Arumbakkam,68843,61369,100,1256,23060,0,0,93259,1880,280,2160,0,2750,2750,1611,891,2502,1783,657,2440,1600,17,7,4,0,6,53,817,904
2,06/10/2022,0225-Vadapalani,157803,233443,0,6096,72228,0,0,236127,34530,5190,39720,0,6500,6500,5556,2590,8146,5943,2590,8533,6162,34,1108,0,0,7,221,2281,3651
2,06/10/2022,0227-Ashok Nagar,129432,143525,120,2664,38684,0,0,170900,6465,6260,12725,0,9500,9500,3914,1368,5282,3994,1390,5384,4078,34,618,2,0,7,99,1219,1979
2,06/10/2022,0229-Ekkattuthangal,98477,132230,950,2064,26804,0,0,128295,50,340,390,0,1000,1000,3750,984,4734,4151,976,5127,4189,26,386,0,0,3,88,854,1357
2,06/10/2022,0231-Arignar Anna Alandur,211605,204558,650,4336,65376,0,0,281967,10290,9915,20205,0,6250,6250,5420,2250,7670,5224,1610,6834,5376,55,577,4,0,12,166,1998,2812
2,06/10/2022,0233-St. Thomas Mount,117916,113122,0,3096,33894,0,0,154906,3470,4070,7540,6000,9000,15000,2986,1164,4150,3035,942,3977,3019,32,268,0,0,7,99,1034,1440
1,07/10/2022,01ED-Wimco Nagar Depot Metro,76976,78668,100,1368,28328,0,0,106772,0,0,0,0,1250,1250,2078,741,2819,1665,412,2077,1556,19,0,4,0,15,36,708,782
1,07/10/2022,01EF-Wimco Nagar Metro,132002,138964,900,3400,35236,0,0,171538,0,0,0,0,250,250,3370,946,4316,3276,840,4116,3221,47,93,3,0,10,99,836,1088
1,07/10/2022,01F1-Thiruvotriyur Metro,126008,110839,275,1632,28860,0,0,156775,0,0,0,0,0,0,2866,783,3649,2760,606,3366,2660,26,5,1,0,10,48,740,830
1,07/10/2022,01F3-Thiruvotriyur Theradi Metro,102797,126369,100,2672,33152,0,0,138721,0,0,0,0,0,0,2993,974,3967,3135,807,3942,3136,21,143,1,0,8,63,887,1123
1,07/10/2022,01F5-Kaladipet Metro,121747,101959,500,1696,26352,0,0,150295,0,0,0,0,0,0,2922,815,3737,2855,648,3503,2742,31,9,1,0,8,59,752,860
1,07/10/2022,01F7-Tollgate Metro,66333,58145,200,584,15538,0,0,82655,0,0,0,0,0,0,1611,471,2082,1650,362,2012,1530,10,0,0,0,13,23,435,481
1,07/10/2022,01F9-New Washermenpet Metro,97486,95975,74,1728,25736,0,0,125024,0,0,0,0,250,250,2843,867,3710,2816,647,3463,2743,12,58,1,0,6,48,821,946
1,07/10/2022,01FB-Tondiarpet Metro,97534,104103,100,1016,32390,0,0,131040,0,0,0,0,500,500,2829,988,3817,2959,778,3737,2785,25,9,3,0,9,39,934,1019
1,07/10/2022,01FD-Thiagaraya College Metro,109777,122910,0,1624,31034,0,0,142435,0,0,0,0,1500,1500,3688,1064,4752,3686,982,4668,3665,40,101,0,0,11,61,1004,1217
1,07/10/2022,0101-Washermanpet,111651,127453,100,2120,45340,0,0,159211,0,0,0,0,16750,16750,3444,1545,4989,3358,1296,4654,3300,18,113,1,0,8,79,1454,1673
1,07/10/2022,0103-Mannadi,72773,113647,200,1504,34306,0,0,108783,0,0,0,0,0,0,2900,1194,4094,3305,1162,4467,3300,11,136,2,0,5,59,1134,1347
1,07/10/2022,0105-High Court,126268,207294,100,2600,61810,0,0,190778,0,0,0,0,0,0,5776,2166,7942,5929,1661,7590,5931,31,225,2,0,10,110,2031,2409
1,07/10/2022,0109-Government Estate,101753,153612,900,2472,44766,0,0,149891,0,0,0,0,5250,5250,4133,1614,5747,4446,1654,6100,4671,24,484,7,0,7,98,1472,2092
1,07/10/2022,0111-LIC,95553,179195,2210,3160,33638,0,0,134561,0,0,0,0,1000,1000,5138,1240,6378,5801,958,6759,5805,34,128,1,0,6,129,1076,1374
1,07/10/2022,0113-Thousand Lights,166962,249833,5100,4168,43904,0,0,220134,0,0,0,0,500,500,7519,1642,9161,8120,1386,9506,8191,45,314,0,0,6,187,1370,1922
1,07/10/2022,0115-AG-DMS,130092,153676,500,2720,32886,0,0,166198,0,0,0,0,1750,1750,4883,1144,6027,4624,767,5391,4755,33,232,0,0,1,89,1007,1362
1,07/10/2022,0117-Teynampet,104281,148940,1100,2256,33822,0,0,141459,0,0,0,0,2000,2000,4575,1261,5836,4993,934,5927,4829,31,0,9,0,3,87,1150,1280
1,07/10/2022,0119-Nandanam,96454,128203,350,1992,32744,0,0,131540,0,0,0,0,500,500,3812,1197,5009,4250,802,5052,4048,35,0,0,0,10,83,1074,1202
1,07/10/2022,0121-Saidapet,54750,83082,500,1400,28252,0,0,84902,0,0,0,0,250,250,1861,964,2825,2403,808,3211,2238,12,0,0,0,5,50,910,977
1,07/10/2022,0123-Little Mount,89147,97666,1600,1800,27886,0,0,120433,0,0,0,0,500,500,3306,1029,4335,2757,681,3438,2817,21,219,0,0,2,69,920,1231
1,07/10/2022,0125-Guindy,211545,274204,400,6904,63768,0,0,282617,0,0,0,0,0,0,8406,2342,10748,7204,2379,9583,8216,297,1273,0,0,7,272,1966,3815
1,07/10/2022,0129-Nanganallur Road,43876,49646,1500,480,13552,0,0,59408,0,0,0,0,0,0,1284,428,1712,1483,322,1805,1379,11,0,0,0,2,19,396,428
1,07/10/2022,0131-Meenambakkam,139773,148453,783,2968,43354,0,0,186878,0,0,0,0,0,0,3994,1276,5270,3442,1015,4457,3558,27,258,0,0,3,91,1182,1561
1,07/10/2022,0133-Chennai International Airport,184632,358432,2950,8760,174306,0,0,370648,0,0,0,0,2250,2250,5681,4776,10457,6280,3722,10002,5983,81,635,7,0,19,260,4317,5319
2,07/10/2022,0201-Puratchi Thalaivar Dr. M.G. Ramachandran Central,392783,500391,1150,11968,72456,0,0,478357,0,0,0,0,2900,2900,15755,2829,18584,11870,7997,19867,16771,85,6181,7,0,18,474,2208,8973
2,07/10/2022,0203-Egmore,92189,142545,300,2504,46902,0,0,141895,0,0,0,0,10500,10500,3190,1619,4809,3146,2672,5818,3703,21,1170,6,0,15,104,1525,2841
2,07/10/2022,0205-Nehru Park,65287,56297,0,912,18198,0,0,84397,0,0,0,0,8750,8750,1550,661,2211,1462,529,1991,1575,11,230,0,0,8,43,608,900
2,07/10/2022,0207-Kilpauk,41771,60627,0,1048,18216,0,0,61035,0,0,0,0,250,250,1557,644,2201,1698,572,2270,1694,21,100,0,0,1,46,579,747
2,07/10/2022,0209-Pachaiyappas College,56952,52313,500,904,15472,0,0,73828,0,0,0,0,4500,4500,1711,612,2323,1581,494,2075,1533,15,84,2,0,3,29,578,711
2,07/10/2022,0211-Shenoy Nagar,56057,49698,50,376,13108,0,0,69591,0,0,0,0,4000,4000,1365,452,1817,1476,401,1877,1465,14,102,0,0,2,15,431,564
2,07/10/2022,0213-Anna Nagar East,89343,113766,0,2112,29748,0,0,121203,0,0,0,0,0,0,3277,1148,4425,3384,910,4294,3373,20,208,0,0,3,88,1043,1362
2,07/10/2022,0215-Anna Nagar Tower,98498,99078,1386,1656,23128,0,0,124668,0,0,0,0,1000,1000,2890,835,3725,2880,760,3640,2928,21,209,1,0,2,60,766,1059
2,07/10/2022,0217-Thirumangalam,290744,317418,1100,7456,92320,0,0,391620,0,0,0,0,1500,1500,8145,3150,11295,8612,2474,11086,8475,66,518,12,0,5,239,2839,3679
2,07/10/2022,0219-Koyambedu,218406,240795,1600,3576,75286,0,0,298868,0,0,0,0,13750,13750,6243,2563,8806,5783,2173,7956,6079,48,1040,3,0,20,146,2352,3609
2,07/10/2022,0221-Puratchi Thalaivi Dr. J. Jayalalithaa CMBT,74960,198334,450,2416,89184,0,0,167010,0,0,0,0,0,0,2789,2901,5690,5080,4465,9545,4248,21,648,7,0,8,104,2755,3543
2,07/10/2022,0223-Arumbakkam,58907,62524,920,1096,24890,0,0,85813,0,0,0,0,3000,3000,1596,916,2512,1780,672,2452,1599,16,0,6,0,8,47,839,916
2,07/10/2022,0225-Vadapalani,134451,252169,0,5088,92374,0,0,231913,0,0,0,0,9000,9000,5703,3239,8942,6343,2633,8976,6140,37,770,1,0,31,199,2916,3954
2,07/10/2022,0227-Ashok Nagar,101024,152134,860,3968,47660,0,0,153512,0,0,0,0,4000,4000,4003,1720,5723,3784,1497,5281,4059,44,604,2,0,4,148,1527,2329
2,07/10/2022,0229-Ekkattuthangal,90524,141222,500,3288,37806,0,0,132118,0,0,0,0,750,750,3972,1378,5350,3926,937,4863,4113,25,379,1,0,5,125,1213,1748
2,07/10/2022,0231-Arignar Anna Alandur,179013,215607,700,5008,72926,0,0,257647,0,0,0,0,2750,2750,5568,2466,8034,5289,1759,7048,5491,54,524,4,0,17,198,2168,2965
2,07/10/2022,0233-St. Thomas Mount,112289,115400,1050,3256,33064,0,0,149659,0,0,0,3000,9725,12725,3092,1159,4251,2988,940,3928,3113,25,327,0,0,11,115,1005,1483
1,08/10/2022,01ED-Wimco Nagar Depot Metro,69308,78505,500,1576,33448,0,0,104832,0,0,0,0,1250,1250,1655,834,2489,1484,414,1898,1373,20,1,0,0,15,52,788,876
1,08/10/2022,01EF-Wimco Nagar Metro,109231,124075,100,3000,39934,0,0,152265,0,0,0,0,250,250,2617,1025,3642,2649,965,3614,2561,28,120,4,1,23,82,932,1190
1,08/10/2022,01F1-Thiruvotriyur Metro,98947,102078,0,3008,35238,0,0,137193,0,0,0,0,0,0,2289,968,3257,2359,695,3054,2206,42,0,2,0,15,88,897,1044
1,08/10/2022,01F3-Thiruvotriyur Theradi Metro,104933,112981,100,1920,37564,0,0,144517,0,0,0,0,0,0,2424,1073,3497,2663,897,3560,2538,21,120,2,0,9,61,978,1191
1,08/10/2022,01F5-Kaladipet Metro,98890,94956,100,2352,35496,0,0,136838,0,0,0,0,0,0,2282,1070,3352,2352,777,3129,2193,16,0,0,0,6,73,989,1084
1,08/10/2022,01F7-Tollgate Metro,54180,54221,400,832,18710,0,0,74122,0,0,0,0,0,0,1389,586,1975,1432,438,1870,1291,15,0,0,0,20,30,549,614
1,08/10/2022,01F9-New Washermenpet Metro,82448,83814,200,1352,24844,0,0,108844,0,0,0,0,0,0,2221,807,3028,2306,737,3043,2260,17,106,3,0,6,50,762,944
1,08/10/2022,01FB-Tondiarpet Metro,79598,88924,100,1728,34658,0,0,116084,0,0,0,0,250,250,2133,1084,3217,2371,805,3176,2147,11,1,4,0,9,51,1025,1101
1,08/10/2022,01FD-Thiagaraya College Metro,97984,120987,0,3328,42730,0,0,144042,0,0,0,0,500,500,2885,1421,4306,3131,1030,4161,3045,29,102,0,0,14,104,1294,1543
1,08/10/2022,0101-Washermanpet,88249,115756,200,2096,54636,0,0,145181,0,0,0,0,14250,14250,2502,1766,4268,2538,1470,4008,2424,26,180,3,0,12,84,1657,1962
1,08/10/2022,0103-Mannadi,80115,100412,602,1136,39288,0,0,121141,0,0,0,0,1500,1500,2320,1237,3557,2569,1212,3781,2529,19,204,2,0,4,39,1269,1537
1,08/10/2022,0105-High Court,113569,166015,631,3744,54618,0,0,172562,0,0,0,0,0,0,4230,1931,6161,3628,2012,5640,4286,26,916,4,0,7,131,1719,2803
1,08/10/2022,0109-Government Estate,74387,154191,950,3256,66358,0,0,144951,0,0,0,0,1000,1000,3298,2388,5686,3684,1851,5535,3676,23,305,0,1,24,134,2153,2640
1,08/10/2022,0111-LIC,53590,99594,1400,1872,24672,0,0,81534,0,0,0,0,0,0,2456,898,3354,2510,1040,3550,2839,22,511,0,0,6,78,777,1394
1,08/10/2022,0113-Thousand Lights,102848,152475,100,3832,40330,0,0,147110,0,0,0,0,0,0,3872,1448,5320,4244,1411,5655,4361,34,402,2,0,9,153,1220,1820
1,08/10/2022,0115-AG-DMS,72473,95990,500,1176,27574,0,0,101723,0,0,0,0,0,0,2644,923,3567,2547,645,3192,2618,23,205,2,0,0,49,856,1135
1,08/10/2022,0117-Teynampet,60411,84634,0,1720,29970,0,0,92101,0,0,0,0,0,0,1880,1079,2959,2401,887,3288,2222,25,0,0,0,9,70,968,1072
1,08/10/2022,0119-Nandanam,62120,86148,650,2096,35324,0,0,100190,0,0,0,0,2500,2500,1992,1236,3228,2244,765,3009,2079,31,1,0,0,3,77,1134,1246
1,08/10/2022,0121-Saidapet,44009,63060,450,1176,26916,0,0,72551,0,0,0,0,8000,8000,1111,913,2024,1566,799,2365,1379,14,0,0,0,10,41,862,927
1,08/10/2022,0123-Little Mount,56007,66141,200,1656,26966,0,0,84829,0,0,0,0,2000,2000,1781,935,2716,1507,620,2127,1533,17,198,1,0,4,60,850,1130
1,08/10/2022,0125-Guindy,100377,221022,250,6728,78232,0,0,185587,0,0,0,0,1500,1500,5110,2706,7816,4532,2708,7240,5199,36,1318,2,0,16,249,2335,3956
1,08/10/2022,0129-Nanganallur Road,29358,35698,0,1304,14130,0,0,44792,0,0,0,0,0,0,676,461,1137,883,396,1279,786,7,1,0,0,3,41,406,458
1,08/10/2022,0131-Meenambakkam,112669,131180,2040,3128,49708,0,0,167545,0,0,0,0,0,0,2976,1435,4411,2504,1120,3624,2657,31,450,8,0,10,97,1337,1933
1,08/10/2022,0133-Chennai International Airport,167864,367376,978,10680,198608,0,0,378130,0,0,0,0,1500,1500,4833,5541,10374,5626,4227,9853,5299,67,1180,16,0,36,331,4803,6433
2,08/10/2022,0201-Puratchi Thalaivar Dr. M.G. Ramachandran Central,309118,456854,470,12800,123014,0,0,445402,0,0,0,0,7000,7000,12048,4288,16336,8712,7686,16398,12466,83,5340,24,0,52,506,3806,9811
2,08/10/2022,0203-Egmore,80692,129276,200,3896,50064,0,0,134852,0,0,0,0,4750,4750,2749,1772,4521,2718,2642,5360,3110,18,1128,7,0,20,143,1634,2950
2,08/10/2022,0205-Nehru Park,36805,54149,0,1248,23656,0,0,61709,0,0,0,0,0,0,1183,831,2014,1236,654,1890,1229,22,145,0,0,7,49,805,1028
2,08/10/2022,0207-Kilpauk,27524,52647,0,1264,20882,0,0,49670,0,0,0,0,0,0,1205,746,1951,1196,574,1770,1258,10,189,0,0,2,48,681,930
2,08/10/2022,0209-Pachaiyappas College,44848,47928,66,552,16952,0,0,62418,0,0,0,0,2000,2000,1364,622,1986,1288,514,1802,1279,13,103,5,0,9,25,576,731
2,08/10/2022,0211-Shenoy Nagar,37596,38656,200,1000,13210,0,0,52006,0,0,0,0,250,250,992,494,1486,1012,431,1443,1029,10,119,0,0,2,32,448,611
2,08/10/2022,0213-Anna Nagar East,71624,100501,500,1984,34286,0,0,108394,0,0,0,0,3000,3000,2469,1225,3694,2580,982,3562,2601,16,297,0,0,6,96,1094,1509
2,08/10/2022,0215-Anna Nagar Tower,68620,91932,100,2216,30484,0,0,101420,0,0,0,0,750,750,2238,1076,3314,2305,964,3269,2346,13,334,7,0,3,79,999,1435
2,08/10/2022,0217-Thirumangalam,195218,280149,650,8608,114996,0,0,319472,0,0,0,0,0,0,5857,3922,9779,6386,3181,9567,6136,75,679,7,0,28,307,3476,4572
2,08/10/2022,0219-Koyambedu,148879,224388,770,6056,91128,0,0,246833,0,0,0,0,5250,5250,4733,3203,7936,4326,2545,6871,4815,51,1249,4,0,19,244,2857,4424
2,08/10/2022,0221-Puratchi Thalaivi Dr. J. Jayalalithaa CMBT,89709,196662,0,4168,82184,0,0,176061,0,0,0,0,0,0,3039,2766,5805,4311,4602,8913,4150,25,1350,3,0,10,130,2565,4083
2,08/10/2022,0223-Arumbakkam,39436,56837,0,680,27806,0,0,67922,0,0,0,0,500,500,1192,1014,2206,1462,705,2167,1203,22,15,0,0,13,30,963,1043
2,08/10/2022,0225-Vadapalani,166252,264506,300,11416,73716,0,0,251684,0,0,0,0,5500,5500,6364,2898,9262,5348,3869,9217,7041,45,2621,4,0,26,405,2193,5294
2,08/10/2022,0227-Ashok Nagar,84465,140257,800,4632,52980,0,0,142877,0,0,0,0,3000,3000,3202,1998,5200,3194,1649,4843,3382,37,746,4,0,12,179,1721,2699
2,08/10/2022,0229-Ekkattuthangal,62220,89673,350,2744,33880,0,0,99194,0,0,0,0,250,250,2193,1270,3463,2190,938,3128,2260,15,354,1,0,6,121,1105,1602
2,08/10/2022,0231-Arignar Anna Alandur,135757,194558,1208,5224,83096,0,0,225285,0,0,0,0,1000,1000,3969,2779,6748,4144,2330,6474,4136,46,782,3,0,28,194,2418,3471
2,08/10/2022,0233-St. Thomas Mount,84822,118489,280,4344,49970,0,0,139416,0,0,0,0,7600,7600,2439,1711,4150,2486,1336,3822,2513,19,542,6,0,11,147,1506,2231
1,09/10/2022,01ED-Wimco Nagar Depot Metro,63228,66197,0,1000,32420,0,0,96648,0,0,0,0,4250,4250,1040,687,1727,1114,439,1553,1002,25,74,2,0,15,31,768,915
1,09/10/2022,01EF-Wimco Nagar Metro,61195,88828,300,2584,37896,0,0,101975,0,0,0,0,0,0,1467,967,2434,1554,854,2408,1491,36,172,1,0,24,71,862,1166
1,09/10/2022,01F1-Thiruvotriyur Metro,75450,84126,0,2168,37072,0,0,114690,0,0,0,0,0,0,1381,979,2360,1699,802,2501,1482,56,0,1,0,17,67,918,1059
1,09/10/2022,01F3-Thiruvotriyur Theradi Metro,67744,103031,300,2664,48754,0,0,119462,0,0,0,0,0,0,1546,1303,2849,1984,1122,3106,1788,36,106,0,0,10,80,1223,1455
1,09/10/2022,01F5-Kaladipet Metro,53600,75650,0,3056,35262,0,0,91918,0,0,0,0,0,0,1347,1031,2378,1567,829,2396,1407,25,0,0,0,17,78,929,1049
1,09/10/2022,01F7-Tollgate Metro,36903,42791,100,800,18528,0,0,56331,0,0,0,0,0,0,794,550,1344,943,447,1390,825,11,0,0,0,18,30,510,569
1,09/10/2022,01F9-New Washermenpet Metro,46447,67877,0,1376,31618,0,0,79441,0,0,0,0,1000,1000,1277,950,2227,1429,801,2230,1353,20,93,0,0,9,48,900,1070
1,09/10/2022,01FB-Tondiarpet Metro,42974,72947,250,1744,36956,0,0,81924,0,0,0,0,0,0,1215,1116,2331,1515,879,2394,1314,13,3,0,0,25,58,1054,1153
1,09/10/2022,01FD-Thiagaraya College Metro,77734,99747,0,3512,46724,0,0,127970,0,0,0,0,500,500,1819,1491,3310,2097,1125,3222,1955,40,83,4,0,19,116,1368,1630
1,09/10/2022,0101-Washermanpet,71090,97818,100,1928,45266,0,0,118384,0,0,0,0,14250,14250,1638,1401,3039,1950,1676,3626,1872,14,415,0,0,21,77,1335,1862
1,09/10/2022,0103-Mannadi,41757,68313,600,1504,34120,0,0,77981,0,0,0,0,1500,1500,1179,1099,2278,1337,1076,2413,1331,13,235,0,0,11,53,1077,1389
1,09/10/2022,0105-High Court,31581,78738,400,1656,42624,0,0,76261,0,0,0,0,0,0,1375,1487,2862,1498,1110,2608,1443,15,214,0,0,11,63,1373,1676
1,09/10/2022,0109-Government Estate,45105,100902,1800,1960,51156,0,0,100021,0,0,0,0,2750,2750,1784,1739,3523,2105,1428,3533,1974,15,309,2,0,22,70,1612,2030
1,09/10/2022,0111-LIC,23569,59893,500,1736,32022,0,0,57827,0,0,0,0,0,0,942,1087,2029,1236,825,2061,1078,10,0,0,0,13,67,986,1076
1,09/10/2022,0113-Thousand Lights,47435,80484,400,3088,29652,0,0,80575,0,0,0,0,0,0,1604,1058,2662,1941,1137,3078,1898,16,345,0,0,15,112,883,1371
1,09/10/2022,0115-AG-DMS,24395,42346,0,1504,18714,0,0,44613,0,0,0,0,0,0,795,640,1435,815,502,1317,847,10,194,0,0,0,52,566,822
1,09/10/2022,0117-Teynampet,24724,49543,200,1176,26430,0,0,52530,0,0,0,0,0,0,761,920,1681,1148,691,1839,908,8,0,4,0,12,37,863,924
1,09/10/2022,0119-Nandanam,25749,47946,100,1320,27786,0,0,54955,0,0,0,0,0,0,773,967,1740,1003,641,1644,784,8,0,1,0,3,50,907,969
1,09/10/2022,0121-Saidapet,20800,50028,600,832,29282,0,0,51514,0,0,0,0,4000,4000,629,932,1561,1038,721,1759,772,8,0,5,0,6,27,884,930
1,09/10/2022,0123-Little Mount,32801,56534,200,1576,28290,0,0,62867,0,0,0,0,0,0,1130,962,2092,1054,655,1709,1065,8,220,4,0,5,56,887,1180
1,09/10/2022,0125-Guindy,111399,176627,400,4696,59228,0,0,175723,0,0,0,0,1500,1500,3838,2001,5839,2944,2323,5267,3960,19,1914,6,0,16,173,1687,3815
1,09/10/2022,0129-Nanganallur Road,9691,26739,200,872,15418,0,0,26181,0,0,0,0,0,0,331,473,804,503,298,801,408,6,0,0,0,3,28,438,475
1,09/10/2022,0131-Meenambakkam,59255,93546,300,2792,45616,0,0,107963,0,0,0,0,0,0,1554,1257,2811,1375,992,2367,1473,17,450,2,0,12,85,1187,1753
1,09/10/2022,0133-Chennai International Airport,127867,344056,420,11424,207992,0,0,347703,0,0,0,0,750,750,3750,5688,9438,4864,4347,9211,4183,66,960,18,0,61,339,5060,6504
2,09/10/2022,0201-Puratchi Thalaivar Dr. M.G. Ramachandran Central,357408,433721,550,15296,65294,0,0,438548,0,0,0,0,5800,5800,12222,2686,14908,5896,7713,13609,12889,63,8665,6,0,58,590,1826,11208
2,09/10/2022,0203-Egmore,65847,130455,650,3560,64594,0,0,134651,0,0,0,0,4500,4500,2280,2184,4464,2510,2434,4944,2490,22,1112,25,0,15,138,2112,3424
2,09/10/2022,0205-Nehru Park,25861,46278,0,1424,23544,0,0,50829,0,0,0,0,2000,2000,899,827,1726,863,683,1546,895,11,212,0,0,11,59,816,1109
2,09/10/2022,0207-Kilpauk,17879,34323,0,736,16196,0,0,34811,0,0,0,0,0,0,624,570,1194,760,511,1271,702,5,92,0,0,8,37,538,680
2,09/10/2022,0209-Pachaiyappas College,34300,65777,0,592,35614,0,0,70506,0,0,0,0,10000,10000,1154,1193,2347,967,729,1696,1166,7,430,8,0,11,29,1304,1789
2,09/10/2022,0211-Shenoy Nagar,19872,28614,0,984,13080,0,0,33936,0,0,0,0,0,0,626,474,1100,620,347,967,621,13,121,4,0,2,28,433,601
2,09/10/2022,0213-Anna Nagar East,35807,68027,150,2056,32254,0,0,70267,0,0,0,0,3000,3000,1414,1159,2573,1486,826,2312,1439,17,249,0,0,5,81,1042,1394
2,09/10/2022,0215-Anna Nagar Tower,40308,66507,550,2256,28770,0,0,71884,0,0,0,0,0,0,1385,1028,2413,1552,813,2365,1439,15,276,0,0,4,83,934,1312
2,09/10/2022,0217-Thirumangalam,146842,228466,100,8136,105444,0,0,260522,0,0,0,0,0,0,4130,3419,7549,4398,2944,7342,4410,57,1137,7,0,19,269,3118,4607
2,09/10/2022,0219-Koyambedu,119619,186859,0,4776,85697,0,0,210092,0,0,0,0,3250,3250,3768,2959,6727,3467,2257,5724,3625,40,1379,3,0,62,218,2606,4308
2,09/10/2022,0221-Puratchi Thalaivi Dr. J. Jayalalithaa CMBT,67712,204804,100,5120,122698,0,0,195630,0,0,0,0,0,0,2485,4042,6527,3651,4205,7856,2965,26,963,4,0,19,219,3715,4946
2,09/10/2022,0223-Arumbakkam,29177,43491,200,1376,26196,0,0,56949,0,0,0,0,8000,8000,682,971,1653,992,619,1611,735,16,2,6,0,12,63,896,995
2,09/10/2022,0225-Vadapalani,130983,226485,350,8368,75934,0,0,215635,0,0,0,0,2500,2500,5029,2840,7869,4264,3609,7873,5496,44,2500,1,0,27,329,2277,5178
2,09/10/2022,0227-Ashok Nagar,71987,109553,1550,3760,47260,0,0,124557,0,0,0,0,6000,6000,2163,1691,3854,2243,1660,3903,2358,28,870,7,0,6,132,1453,2496
2,09/10/2022,0229-Ekkattuthangal,31529,57639,220,1840,26704,0,0,60293,0,0,0,0,0,0,1075,962,2037,1372,776,2148,1245,10,260,0,0,9,84,838,1201
2,09/10/2022,0231-Arignar Anna Alandur,97456,158782,500,4352,84492,0,0,186800,0,0,0,0,1250,1250,2590,2744,5334,2709,2086,4795,2694,32,826,16,0,16,156,2485,3531
2,09/10/2022,0233-St. Thomas Mount,57134,91450,430,3280,46490,0,0,107334,0,0,0,0,5000,5000,1427,1555,2982,1632,1159,2791,1561,20,505,0,0,6,114,1392,2037
1,10/10/2022,01ED-Wimco Nagar Depot Metro,102071,83902,0,1496,26566,0,0,130133,0,0,0,0,3000,3000,2135,683,2818,1858,415,2273,1800,16,6,1,0,11,46,648,728
1,10/10/2022,01EF-Wimco Nagar Metro,163773,145758,750,4280,34110,0,0,202913,0,0,0,0,1750,1750,3708,907,4615,3460,922,4382,3465,41,112,7,0,11,89,809,1069
1,10/10/2022,01F1-Thiruvotriyur Metro,168307,114571,0,1544,24460,0,0,194311,0,0,0,0,0,0,3068,683,3751,3060,577,3637,2976,46,1,0,0,5,49,639,740
1,10/10/2022,01F3-Thiruvotriyur Theradi Metro,137654,124551,250,2392,28192,0,0,168488,0,0,0,0,0,0,2976,846,3822,3402,859,4261,3304,16,53,3,0,7,67,754,900
1,10/10/2022,01F5-Kaladipet Metro,147932,111740,0,1368,27892,0,0,177192,0,0,0,0,0,0,3109,875,3984,3248,758,4006,3132,21,1,0,0,6,47,820,895
1,10/10/2022,01F7-Tollgate Metro,90444,60943,100,1232,15002,0,0,106778,0,0,0,0,0,0,1729,496,2225,1726,419,2145,1679,21,0,0,0,7,34,449,511
1,10/10/2022,01F9-New Washermenpet Metro,142476,102356,550,2320,23326,0,0,168672,0,0,0,0,750,750,3087,790,3877,3097,832,3929,3103,21,76,2,0,3,36,758,896
1,10/10/2022,01FB-Tondiarpet Metro,126966,106696,450,1416,26508,0,0,155340,0,0,0,0,2750,2750,2963,888,3851,3222,878,4100,3120,19,1,1,0,9,42,832,904
1,10/10/2022,01FD-Thiagaraya College Metro,150460,133025,500,1904,34428,0,0,187292,0,0,0,0,2000,2000,3816,1227,5043,4083,1065,5148,4015,25,32,2,0,4,68,1135,1266
1,10/10/2022,0101-Washermanpet,125102,132374,960,2776,44212,0,0,173050,0,0,0,0,12500,12500,3701,1547,5248,3648,1380,5028,3635,26,113,0,0,1,96,1439,1675
1,10/10/2022,0103-Mannadi,122419,119346,500,1568,31028,0,0,155515,0,0,0,0,1500,1500,3282,1084,4366,3665,1210,4875,3678,19,154,1,0,4,60,1041,1279
1,10/10/2022,0105-High Court,176970,243849,300,2944,60642,0,0,240856,0,0,0,0,0,0,7181,2160,9341,7160,1895,9055,7443,44,476,1,0,4,126,2032,2683
1,10/10/2022,0109-Government Estate,113658,157846,1700,2144,49736,0,0,167238,0,0,0,0,3750,3750,4079,1829,5908,4689,1739,6428,4770,30,256,2,0,3,101,1676,2068
1,10/10/2022,0111-LIC,112003,185233,1700,2768,31986,0,0,148457,0,0,0,0,0,0,5298,1181,6479,6249,1046,7295,6159,28,42,1,0,5,106,1031,1213
1,10/10/2022,0113-Thousand Lights,205744,269300,1920,4496,35018,0,0,247178,0,0,0,0,250,250,8392,1329,9721,8956,1750,10706,9291,66,547,0,0,2,189,1089,1893
1,10/10/2022,0115-AG-DMS,146443,166076,2000,2024,31904,0,0,182371,0,0,0,0,1500,1500,5172,1154,6326,5235,875,6110,5274,38,140,0,0,1,79,1000,1258
1,10/10/2022,0117-Teynampet,129899,152214,468,2560,31110,0,0,164037,0,0,0,0,250,250,4681,1208,5889,5242,1068,6310,5098,31,10,0,0,0,88,1095,1224
1,10/10/2022,0119-Nandanam,129112,134957,3276,2200,30024,0,0,164612,0,0,0,0,1000,1000,3871,1145,5016,4602,1005,5607,4455,46,0,0,0,3,87,1015,1151
1,10/10/2022,0121-Saidapet,74813,87514,1800,1296,22872,0,0,100781,0,0,0,0,6250,6250,2083,828,2911,2722,860,3582,2610,26,0,4,0,2,51,752,835
1,10/10/2022,0123-Little Mount,101947,99929,2100,2320,25118,0,0,131485,0,0,0,0,2250,2250,3461,974,4435,3059,734,3793,3049,13,169,1,0,4,77,844,1108
1,10/10/2022,0125-Guindy,191530,276762,760,6120,78290,0,0,276700,0,0,0,0,0,0,8258,2767,11025,7694,2664,10358,7886,57,585,3,0,10,223,2467,3345
1,10/10/2022,0129-Nanganallur Road,70902,51141,30,336,12830,0,0,84098,0,0,0,0,0,0,1373,403,1776,1555,325,1880,1469,11,0,0,0,2,10,386,409
1,10/10/2022,0131-Meenambakkam,192883,149021,500,2736,41526,0,0,237645,0,0,0,0,0,0,4233,1190,5423,3552,927,4479,3662,28,231,1,0,4,74,1114,1452
1,10/10/2022,0133-Chennai International Airport,223505,355934,2164,8864,155022,0,0,389555,0,0,0,0,11500,11500,6077,4293,10370,6595,3957,10552,6495,72,668,4,0,17,253,3848,4862
2,10/10/2022,0201-Puratchi Thalaivar Dr. M.G. Ramachandran Central,419183,535267,1650,16488,136480,0,0,573801,0,0,0,0,10150,10150,17223,5352,22575,11527,7583,19110,16121,168,5226,4,0,24,662,4399,10483
2,10/10/2022,0203-Egmore,113896,138481,550,3712,58532,0,0,176690,0,0,0,0,17500,17500,3190,2011,5201,2966,2837,5803,3239,33,844,0,0,15,156,1886,2934
2,10/10/2022,0205-Nehru Park,52024,50486,100,928,16026,0,0,69078,0,0,0,0,1000,1000,1428,594,2022,1439,540,1979,1451,12,112,0,0,2,41,549,716
2,10/10/2022,0207-Kilpauk,50657,68523,200,856,22706,0,0,74419,0,0,0,0,500,500,1736,776,2512,1875,629,2504,1848,22,119,0,0,1,34,735,911
2,10/10/2022,0209-Pachaiyappas College,59292,55820,400,824,14884,0,0,75400,0,0,0,0,5000,5000,1886,608,2494,1773,528,2301,1739,11,84,3,0,0,34,563,695
2,10/10/2022,0211-Shenoy Nagar,54896,51512,50,720,12860,0,0,68526,0,0,0,0,2250,2250,1421,480,1901,1606,468,2074,1601,12,80,2,0,0,27,438,559
2,10/10/2022,0213-Anna Nagar East,123104,123248,500,1856,30342,0,0,155802,0,0,0,0,6000,6000,3545,1142,4687,3715,942,4657,3727,27,186,0,0,0,81,1029,1323
2,10/10/2022,0215-Anna Nagar Tower,134668,113425,1050,1728,24780,0,0,162226,0,0,0,0,1750,1750,3243,910,4153,3382,916,4298,3430,29,219,1,0,3,71,814,1137
2,10/10/2022,0217-Thirumangalam,365598,326420,2400,8736,85130,0,0,461864,0,0,0,0,1500,1500,8638,2907,11545,9198,2586,11784,9140,73,478,2,0,4,238,2585,3380
2,10/10/2022,0219-Koyambedu,282451,287709,600,5752,93690,0,0,382493,0,0,0,0,23000,23000,7529,3155,10684,6298,2409,8707,7034,61,1319,8,0,11,229,2880,4508
2,10/10/2022,0221-Puratchi Thalaivi Dr. J. Jayalalithaa CMBT,91809,234561,758,4712,133378,0,0,230657,0,0,0,0,0,0,3485,4305,7790,3852,3668,7520,3897,32,706,2,0,11,193,4025,4969
2,10/10/2022,0223-Arumbakkam,73894,68268,450,1376,25348,0,0,101068,0,0,0,0,5750,5750,1709,928,2637,1942,788,2730,1790,25,4,2,0,8,59,855,953
2,10/10/2022,0225-Vadapalani,170134,227012,1800,5032,74104,0,0,251070,0,0,0,0,13000,13000,5337,2629,7966,5814,2570,8384,5929,42,640,2,0,10,220,2307,3221
2,10/10/2022,0227-Ashok Nagar,110842,155190,350,3056,51160,0,0,165408,0,0,0,0,3000,3000,3882,1800,5682,4237,1675,5912,4099,40,248,1,0,2,120,1604,2015
2,10/10/2022,0229-Ekkattuthangal,111110,150095,640,3208,32174,0,0,147132,0,0,0,0,750,750,4145,1207,5352,4650,1223,5873,4706,29,307,1,0,6,137,1003,1483
2,10/10/2022,0231-Arignar Anna Alandur,216372,217456,1700,4056,65792,0,0,287920,0,0,0,0,4500,4500,5905,2253,8158,5732,1858,7590,5904,73,481,8,0,6,158,2012,2738
2,10/10/2022,0233-St. Thomas Mount,122669,110415,550,2960,32164,0,0,158343,0,0,0,12000,6600,18600,3046,1138,4184,3152,963,4115,3069,45,108,0,0,2,106,1020,1281
1,11/10/2022,01ED-Wimco Nagar Depot Metro,103945,80713,0,1880,22208,0,0,128033,0,0,0,0,6500,6500,2163,600,2763,1849,381,2230,1846,27,16,3,0,7,48,546,647
1,11/10/2022,01EF-Wimco Nagar Metro,142084,141572,2780,2392,32758,0,0,180014,0,0,0,0,3500,3500,3662,880,4542,3429,867,4296,3399,32,79,2,0,9,67,815,1004
1,11/10/2022,01F1-Thiruvotriyur Metro,125701,106879,0,1408,19792,0,0,146901,0,0,0,0,0,0,3006,575,3581,2999,476,3475,2902,32,0,1,0,7,44,545,629
1,11/10/2022,01F3-Thiruvotriyur Theradi Metro,113915,121017,100,1896,26828,0,0,142739,0,0,0,0,0,0,2960,795,3755,3297,766,4063,3237,29,42,2,0,8,54,722,857
1,11/10/2022,01F5-Kaladipet Metro,120261,102333,0,2432,19048,0,0,141741,0,0,0,0,0,0,3158,638,3796,3143,590,3733,3097,21,0,0,0,4,54,582,661
1,11/10/2022,01F7-Tollgate Metro,62841,57821,250,528,13250,0,0,76869,0,0,0,0,0,0,1712,418,2130,1715,409,2124,1647,17,0,0,0,4,17,397,435
1,11/10/2022,01F9-New Washermenpet Metro,119096,97944,918,1296,21790,0,0,143100,0,0,0,0,250,250,3016,754,3770,3076,720,3796,3026,14,42,1,1,1,44,708,811
1,11/10/2022,01FB-Tondiarpet Metro,104525,102637,1900,976,25152,0,0,132553,0,0,0,0,1000,1000,2972,826,3798,3140,659,3799,3045,23,0,1,0,3,31,790,848
1,11/10/2022,01FD-Thiagaraya College Metro,114117,125164,500,1904,29820,0,0,146341,0,0,0,0,1250,1250,3772,1082,4854,3982,858,4840,3921,35,42,0,0,1,64,996,1138
1,11/10/2022,0101-Washermanpet,107244,129368,1600,1736,41686,0,0,152266,0,0,0,0,2750,2750,3720,1431,5151,3664,1346,5010,3593,20,101,2,0,3,62,1364,1552
1,11/10/2022,0103-Mannadi,90177,121548,500,1280,32154,0,0,124111,0,0,0,0,3000,3000,3419,1172,4591,3745,1203,4948,3743,21,126,1,0,3,49,1119,1319
1,11/10/2022,0105-High Court,180144,262142,170,2768,59860,0,0,242942,0,0,0,0,0,0,8059,2165,10224,7558,2104,9662,8193,37,843,3,0,4,113,2013,3013
1,11/10/2022,0109-Government Estate,110113,155753,1070,2304,53474,0,0,166961,0,0,0,0,5250,5250,3996,1953,5949,4687,1678,6365,4589,27,80,1,0,2,105,1803,2018
1,11/10/2022,0111-LIC,100944,182713,1000,2600,24462,0,0,129006,0,0,0,0,0,0,5564,943,6507,6048,1051,7099,6314,34,286,1,0,4,98,816,1239
1,11/10/2022,0113-Thousand Lights,167719,269473,3000,5488,39748,0,0,215955,0,0,0,0,0,0,8467,1547,10014,8876,1564,10440,9192,57,365,0,0,3,233,1233,1891
1,11/10/2022,0115-AG-DMS,124542,158916,0,1976,27852,0,0,154370,0,0,0,0,1250,1250,5133,990,6123,5037,805,5842,5164,27,181,0,0,1,81,884,1174
1,11/10/2022,0117-Teynampet,120985,155463,700,2144,30812,0,0,154641,0,0,0,0,0,0,4838,1174,6012,5301,1068,6369,5192,27,1,0,0,4,82,1056,1170
1,11/10/2022,0119-Nandanam,112571,133467,1050,2160,29452,0,0,145233,0,0,0,0,1500,1500,4005,1129,5134,4556,990,5546,4457,41,1,0,0,3,92,1003,1140
1,11/10/2022,0121-Saidapet,72852,87644,200,1760,24850,0,0,99662,0,0,0,0,3250,3250,2099,883,2982,2608,883,3491,2528,23,0,0,0,1,62,814,900
1,11/10/2022,0123-Little Mount,101551,98546,900,1784,25318,0,0,129553,0,0,0,0,0,0,3429,956,4385,2934,714,3648,3006,16,156,2,0,4,75,847,1100
1,11/10/2022,0125-Guindy,169400,267889,2050,6024,74658,0,0,252132,0,0,0,0,1500,1500,8098,2725,10823,7647,2387,10034,7740,48,366,3,0,8,223,2413,3061
1,11/10/2022,0129-Nanganallur Road,56824,49684,0,608,11948,0,0,69380,0,0,0,0,0,0,1382,394,1776,1525,310,1835,1464,10,0,0,0,1,22,365,398
1,11/10/2022,0131-Meenambakkam,148824,139784,1350,2616,32082,0,0,184872,0,0,0,0,0,0,4216,976,5192,3561,824,4385,3696,24,228,2,0,1,78,874,1207
1,11/10/2022,0133-Chennai International Airport,203278,351807,900,9176,151516,0,0,364870,0,0,0,0,6750,6750,6034,4202,10236,6641,3713,10354,6540,74,680,11,0,8,243,3739,4755
2,11/10/2022,0201-Puratchi Thalaivar Dr. M.G. Ramachandran Central,328940,489586,1474,13160,133448,0,0,477022,0,0,0,0,8750,8750,14905,5053,19958,11539,7106,18645,14724,83,3880,6,0,18,497,4371,8855
2,11/10/2022,0203-Egmore,82334,129856,100,2496,61744,0,0,146674,0,0,0,0,14500,14500,2612,2169,4781,2827,2485,5312,2802,26,501,4,0,7,103,2050,2691
2,11/10/2022,0205-Nehru Park,53661,51104,200,808,16262,0,0,70931,0,0,0,0,4250,4250,1491,612,2103,1442,511,1953,1471,22,122,0,0,2,35,576,757
2,11/10/2022,0207-Kilpauk,44688,63424,100,1000,20500,0,0,66288,0,0,0,0,250,250,1633,750,2383,1757,599,2356,1739,13,76,1,0,2,39,700,831
2,11/10/2022,0209-Pachaiyappas College,70077,55893,0,792,14416,0,0,85285,0,0,0,0,12000,12000,1911,572,2483,1790,499,2289,1763,25,70,2,0,2,33,523,655
2,11/10/2022,0211-Shenoy Nagar,49445,50440,0,992,11286,0,0,61723,0,0,0,0,4250,4250,1509,425,1934,1531,461,1992,1602,14,126,0,0,1,33,376,550
2,11/10/2022,0213-Anna Nagar East,107488,120157,1200,1512,28200,0,0,138400,0,0,0,0,0,0,3646,1061,4707,3683,835,4518,3689,24,178,3,1,2,71,965,1244
2,11/10/2022,0215-Anna Nagar Tower,114032,111525,30,2440,25122,0,0,141624,0,0,0,0,1750,1750,3272,916,4188,3298,798,4096,3348,21,209,0,0,1,64,827,1122
2,11/10/2022,0217-Thirumangalam,301590,320131,1510,7136,75308,0,0,385544,0,0,0,0,0,0,8882,2594,11476,9202,2446,11648,9246,75,447,0,0,7,234,2338,3101
2,11/10/2022,0219-Koyambedu,221375,259853,840,4056,82662,0,0,308933,0,0,0,0,18500,18500,6778,2812,9590,6158,2220,8378,6465,69,783,4,0,11,157,2578,3602
2,11/10/2022,0221-Puratchi Thalaivi Dr. J. Jayalalithaa CMBT,71740,176107,850,2928,84696,0,0,160214,0,0,0,0,0,0,2825,2761,5586,3803,3028,6831,3584,19,534,7,0,6,113,2596,3275
2,11/10/2022,0223-Arumbakkam,63853,67138,100,1624,24300,0,0,89877,0,0,0,0,5250,5250,1699,894,2593,1899,710,2609,1785,26,5,2,0,8,64,821,926
2,11/10/2022,0225-Vadapalani,167917,234788,200,5704,69428,0,0,243249,0,0,0,0,6500,6500,5948,2467,8415,5774,2748,8522,6342,46,1029,1,0,8,224,2181,3489
2,11/10/2022,0227-Ashok Nagar,104096,145646,1800,2824,44122,0,0,152842,0,0,0,0,6500,6500,3914,1584,5498,3969,1476,5445,4002,35,252,0,0,1,117,1383,1788
2,11/10/2022,0229-Ekkattuthangal,102241,152941,474,3408,33016,0,0,139139,0,0,0,0,500,500,4410,1236,5646,4619,1090,5709,4816,33,314,1,0,7,137,1015,1507
2,11/10/2022,0231-Arignar Anna Alandur,191370,207582,1640,6144,57062,0,0,256216,0,0,0,0,6250,6250,5851,2004,7855,5652,1811,7463,5888,56,395,4,0,4,189,1736,2384
2,11/10/2022,0233-St. Thomas Mount,99919,109413,200,2328,26828,0,0,129275,0,0,0,3000,5200,8200,3140,958,4098,3130,858,3988,3206,33,212,0,0,1,94,820,1160
1,12/10/2022,01ED-Wimco Nagar Depot Metro,81047,77972,100,1208,22158,0,0,104513,0,0,0,0,2500,2500,2145,575,2720,1856,329,2185,1753,16,1,3,0,6,34,542,602
1,12/10/2022,01EF-Wimco Nagar Metro,134282,143412,400,3496,30332,0,0,168510,0,0,0,0,750,750,3690,863,4553,3348,816,4164,3498,32,196,3,1,7,88,737,1064
1,12/10/2022,01F1-Thiruvotriyur Metro,122219,109719,100,928,23630,0,0,146877,0,0,0,0,0,0,3042,631,3673,2967,515,3482,2852,20,0,1,0,5,30,632,688
1,12/10/2022,01F3-Thiruvotriyur Theradi Metro,103424,122732,461,1888,25356,0,0,131129,0,0,0,0,0,0,3020,746,3766,3298,730,4028,3316,24,97,2,0,3,67,666,859
1,12/10/2022,01F5-Kaladipet Metro,120550,108846,190,1088,24572,0,0,146400,0,0,0,0,0,0,3182,780,3962,3221,642,3863,3145,17,0,1,0,1,37,736,792
1,12/10/2022,01F7-Tollgate Metro,60517,59237,160,696,13100,0,0,74473,0,0,0,0,0,0,1753,416,2169,1682,369,2051,1679,17,41,0,0,3,25,388,474
1,12/10/2022,01F9-New Washermenpet Metro,105296,103104,200,1008,24580,0,0,131084,0,0,0,0,500,500,3038,840,3878,3143,715,3858,3101,18,52,1,0,4,40,796,911
1,12/10/2022,01FB-Tondiarpet Metro,104242,104855,500,1088,24916,0,0,130746,0,0,0,0,250,250,3067,830,3897,3263,686,3949,3149,16,0,1,0,3,40,782,842
1,12/10/2022,01FD-Thiagaraya College Metro,113192,132516,200,1928,34708,0,0,150028,0,0,0,0,750,750,3852,1195,5047,4092,905,4997,3974,44,44,0,0,0,62,1124,1274
1,12/10/2022,0101-Washermanpet,107447,140366,1100,2424,47764,0,0,158735,0,0,0,0,10250,10250,3898,1677,5575,3844,1461,5305,3768,20,131,0,0,5,102,1551,1809
1,12/10/2022,0103-Mannadi,104752,122228,200,1224,30890,0,0,137066,0,0,0,0,3000,3000,3537,1053,4590,3757,1209,4966,3853,24,237,2,0,3,51,1046,1363
1,12/10/2022,0105-High Court,177580,256125,750,2808,56380,0,0,237518,0,0,0,0,0,0,7849,2043,9892,7348,2059,9407,8065,51,916,4,0,1,113,1875,2960
1,12/10/2022,0109-Government Estate,109093,154462,1750,2464,48072,0,0,161379,0,0,0,0,2750,2750,4064,1758,5822,4731,1526,6257,4745,42,220,1,0,3,116,1604,1986
1,12/10/2022,0111-LIC,101438,184123,1200,2280,34702,0,0,139620,0,0,0,0,250,250,5289,1247,6536,6057,1049,7106,6005,35,0,0,0,4,94,1119,1252
1,12/10/2022,0113-Thousand Lights,177057,268380,1750,4976,23548,0,0,207331,0,0,0,0,1250,1250,8867,1025,9892,8978,1495,10473,9683,45,830,1,0,4,210,702,1792
1,12/10/2022,0115-AG-DMS,118360,162414,500,1728,28714,0,0,149302,0,0,0,0,0,0,5319,1012,6331,5096,796,5892,5278,27,268,4,0,0,70,879,1248
1,12/10/2022,0117-Teynampet,103706,157632,979,2352,32842,0,0,139879,0,0,0,0,0,0,4915,1263,6178,5341,987,6328,5223,27,0,0,0,1,99,1130,1257
1,12/10/2022,0119-Nandanam,87942,131980,2840,1832,28874,0,0,121488,0,0,0,0,1000,1000,4037,1096,5133,4513,863,5376,4421,30,29,1,0,1,82,978,1121
1,12/10/2022,0121-Saidapet,48939,88291,500,1152,25980,0,0,76571,0,0,0,0,4000,4000,2112,912,3024,2657,780,3437,2528,19,0,0,0,2,46,852,919
1,12/10/2022,0123-Little Mount,93787,100652,1350,2216,25104,0,0,122457,0,0,0,0,4500,4500,3612,954,4566,3009,670,3679,3080,19,168,1,0,1,86,842,1117
1,12/10/2022,0125-Guindy,158773,279148,4371,7760,73664,0,0,244568,0,0,0,0,1000,1000,8452,2664,11116,7789,2355,10144,8158,45,661,9,0,11,247,2285,3258
1,12/10/2022,0129-Nanganallur Road,58408,50781,1050,656,12308,0,0,72422,0,0,0,0,0,0,1392,395,1787,1568,306,1874,1479,8,2,0,0,0,22,365,397
1,12/10/2022,0131-Meenambakkam,139608,143907,400,2864,36514,0,0,179386,0,0,0,0,0,0,4240,1092,5332,3574,900,4474,3673,25,210,0,0,4,85,993,1317
1,12/10/2022,0133-Chennai International Airport,206770,343776,4100,11288,148724,0,0,370882,0,0,0,0,10000,10000,5921,4096,10017,6447,3580,10027,6342,61,606,9,0,8,241,3679,4604
2,12/10/2022,0201-Puratchi Thalaivar Dr. M.G. Ramachandran Central,307386,501796,1078,12512,153060,0,0,474036,0,0,0,0,3550,3550,14762,5568,20330,12222,7425,19647,14574,84,3311,11,0,44,450,4955,8855
2,12/10/2022,0203-Egmore,81923,130720,0,2640,50404,0,0,134967,0,0,0,0,9500,9500,2977,1772,4749,2839,2516,5355,3266,26,879,4,0,7,112,1635,2663
2,12/10/2022,0205-Nehru Park,46516,55089,200,1376,17058,0,0,65150,0,0,0,0,0,0,1624,649,2273,1532,512,2044,1626,14,183,0,0,3,42,595,837
2,12/10/2022,0207-Kilpauk,40099,66127,700,1432,18248,0,0,60479,0,0,0,0,250,250,1868,677,2545,1816,612,2428,1903,18,169,0,0,1,43,627,858
2,12/10/2022,0209-Pachaiyappas College,60975,55804,200,824,13362,0,0,75361,0,0,0,0,10500,10500,1965,549,2514,1795,491,2286,1791,18,78,1,0,0,30,507,634
2,12/10/2022,0211-Shenoy Nagar,39180,51936,0,448,12594,0,0,52222,0,0,0,0,0,0,1478,472,1950,1664,444,2108,1639,17,79,1,0,0,18,442,557
2,12/10/2022,0213-Anna Nagar East,87997,116710,1250,2400,27432,0,0,119079,0,0,0,0,0,0,3388,1064,4452,3543,887,4430,3547,26,193,0,0,2,96,949,1266
2,12/10/2022,0215-Anna Nagar Tower,106384,113382,1000,2392,24080,0,0,133856,0,0,0,0,6000,6000,3379,879,4258,3402,784,4186,3444,26,208,0,0,1,76,781,1092
2,12/10/2022,0217-Thirumangalam,299602,328509,2170,6520,83652,0,0,391944,0,0,0,0,0,0,8895,2898,11793,9302,2560,11862,9215,55,423,2,0,6,228,2557,3271
2,12/10/2022,0219-Koyambedu,210825,255240,1100,5800,91856,0,0,309581,0,0,0,0,14250,14250,6246,3108,9354,6048,2335,8383,6022,68,493,5,1,6,164,2861,3598
2,12/10/2022,0221-Puratchi Thalaivi Dr. J. Jayalalithaa CMBT,71016,175004,100,2616,83006,0,0,156738,0,0,0,0,0,0,2547,2762,5309,3948,3658,7606,3637,29,427,4,1,6,104,2610,3181
2,12/10/2022,0223-Arumbakkam,72371,64900,1120,1104,22564,0,0,97159,0,0,0,0,10250,10250,1744,830,2574,1935,683,2618,1785,26,2,1,0,4,45,768,846
2,12/10/2022,0225-Vadapalani,147392,229216,1100,4448,74308,0,0,227248,0,0,0,0,8000,8000,5654,2535,8189,5810,2569,8379,6042,44,812,1,0,8,160,2280,3305
2,12/10/2022,0227-Ashok Nagar,106873,153746,3060,4272,44228,0,0,158433,0,0,0,0,3500,3500,4122,1571,5693,4117,1526,5643,4291,40,472,0,0,2,118,1374,2006
2,12/10/2022,0229-Ekkattuthangal,125460,160384,1000,3192,34506,0,0,164158,0,0,0,0,0,0,4822,1270,6092,4673,1105,5778,5049,47,514,2,0,6,129,1074,1772
2,12/10/2022,0231-Arignar Anna Alandur,187215,211910,100,3960,55700,0,0,246975,0,0,0,0,5750,5750,6131,1923,8054,5779,1634,7413,6063,55,575,2,0,5,134,1713,2484
2,12/10/2022,0233-St. Thomas Mount,100981,115604,100,3232,27946,0,0,132259,0,0,0,0,3200,3200,3401,949,4350,3139,882,4021,3349,32,362,2,0,2,109,852,1359
1,13/10/2022,01ED-Wimco Nagar Depot Metro,74508,76600,100,1616,21972,0,0,98196,0,0,0,0,750,750,2094,592,2686,1754,341,2095,1726,17,0,3,0,4,40,538,602
1,13/10/2022,01EF-Wimco Nagar Metro,134135,137426,2950,3640,29570,0,0,170295,0,0,0,0,0,0,3533,838,4371,3308,756,4064,3392,31,117,1,0,3,89,740,981
1,13/10/2022,01F1-Thiruvotriyur Metro,120563,108901,20,1488,21382,0,0,143453,0,0,0,0,0,0,3072,601,3673,2959,490,3449,2929,23,0,2,0,2,44,578,649
1,13/10/2022,01F3-Thiruvotriyur Theradi Metro,112842,118615,150,1872,21130,0,0,135994,0,0,0,0,0,0,3078,638,3716,3316,757,4073,3324,25,117,5,0,5,47,583,782
1,13/10/2022,01F5-Kaladipet Metro,112554,101807,0,1680,20292,0,0,134526,0,0,0,0,0,0,3160,671,3831,3118,559,3677,3062,18,0,1,0,2,42,620,683
1,13/10/2022,01F7-Tollgate Metro,59348,58758,1010,592,13904,0,0,74854,0,0,0,0,0,0,1725,437,2162,1717,319,2036,1651,18,0,1,0,4,19,417,459
1,13/10/2022,01F9-New Washermenpet Metro,111530,101034,0,928,20714,0,0,133172,0,0,0,0,750,750,3142,716,3858,3230,778,4008,3197,16,73,1,0,4,37,675,806
1,13/10/2022,01FB-Tondiarpet Metro,101824,105220,2280,1320,24716,0,0,130140,0,0,0,0,1000,1000,3058,827,3885,3257,734,3991,3194,25,1,3,0,2,37,788,856
1,13/10/2022,01FD-Thiagaraya College Metro,118255,125292,400,1248,29738,0,0,149641,0,0,0,0,1000,1000,3839,1060,4899,3960,835,4795,3931,29,38,4,0,1,46,1008,1126
1,13/10/2022,0101-Washermanpet,117983,139851,50,3128,41394,0,0,162555,0,0,0,0,16750,16750,4149,1481,5630,3799,1331,5130,3996,34,285,0,0,5,114,1340,1778
1,13/10/2022,0103-Mannadi,95708,121512,200,1392,32124,0,0,129424,0,0,0,0,1500,1500,3381,1150,4531,3727,1070,4797,3722,11,118,3,0,3,55,1081,1271
1,13/10/2022,0105-High Court,167744,256026,1650,2496,67152,0,0,239042,0,0,0,0,0,0,7572,2404,9976,7355,2092,9447,7698,43,494,1,0,4,104,2253,2899
1,13/10/2022,0109-Government Estate,90355,153809,300,1952,50614,0,0,143221,0,0,0,0,750,750,4177,1825,6002,4616,1589,6205,4635,26,211,3,0,4,91,1683,2018
1,13/10/2022,0111-LIC,102973,183388,450,2248,32656,0,0,138327,0,0,0,0,5500,5500,5298,1209,6507,6156,1013,7169,6080,24,0,0,0,6,89,1079,1198
1,13/10/2022,0113-Thousand Lights,184096,265348,2400,5088,24810,0,0,216394,0,0,0,0,0,0,8862,1061,9923,8897,1491,10388,9560,52,729,0,0,6,214,774,1775
1,13/10/2022,0115-AG-DMS,111292,158587,1300,2224,26884,0,0,141700,0,0,0,0,1000,1000,5275,951,6226,5098,753,5851,5239,24,197,4,0,0,81,813,1119
1,13/10/2022,0117-Teynampet,103571,154335,140,1624,30338,0,0,135673,0,0,0,0,0,0,4930,1145,6075,5276,1003,6279,5194,34,20,2,0,3,66,1049,1174
1,13/10/2022,0119-Nandanam,99213,134049,1664,2456,30170,0,0,133503,0,0,0,0,2250,2250,4082,1139,5221,4578,792,5370,4443,29,1,0,0,1,83,1010,1124
1,13/10/2022,0121-Saidapet,52420,85503,0,1264,23592,0,0,77276,0,0,0,0,4250,4250,2104,849,2953,2620,803,3423,2524,11,0,0,0,2,48,786,847
1,13/10/2022,0123-Little Mount,102732,99188,1500,2088,23134,0,0,129454,0,0,0,0,3250,3250,3540,909,4449,2990,624,3614,3108,34,189,2,0,2,86,783,1096
1,13/10/2022,0125-Guindy,157492,272087,1250,7456,68172,0,0,234370,0,0,0,0,1500,1500,8333,2473,10806,7756,2287,10043,8066,51,505,3,0,16,242,2159,2976
1,13/10/2022,0129-Nanganallur Road,46960,51614,100,616,11712,0,0,59388,0,0,0,0,0,0,1447,374,1821,1596,318,1914,1539,11,0,1,0,1,22,337,372
1,13/10/2022,0131-Meenambakkam,150260,146966,1800,2872,35204,0,0,190136,0,0,0,0,0,0,4354,1049,5403,3629,927,4556,3798,22,239,3,0,3,83,967,1317
1,13/10/2022,0133-Chennai International Airport,163170,349029,500,9240,150728,0,0,323638,0,0,0,0,6750,6750,5919,4143,10062,6555,3742,10297,6454,56,660,9,0,18,207,3829,4779
2,13/10/2022,0201-Puratchi Thalaivar Dr. M.G. Ramachandran Central,298654,478857,1850,11040,134596,0,0,446140,0,0,0,0,8200,8200,14374,5000,19374,11974,7468,19442,14385,96,3287,11,0,28,481,4419,8322
2,13/10/2022,0203-Egmore,83912,129484,300,2816,55132,0,0,142160,0,0,0,0,15250,15250,2656,1965,4621,2885,2592,5477,3100,23,595,13,0,7,117,1812,2567
2,13/10/2022,0205-Nehru Park,47826,60379,500,2120,19060,0,0,69506,0,0,0,0,3250,3250,1869,791,2660,1777,685,2462,1837,9,226,0,0,17,96,675,1023
2,13/10/2022,0207-Kilpauk,42445,66562,0,1216,21862,0,0,65523,0,0,0,0,0,0,1733,815,2548,1815,672,2487,1830,21,85,0,0,4,58,739,907
2,13/10/2022,0209-Pachaiyappas College,52072,58133,0,664,14950,0,0,67686,0,0,0,0,3000,3000,2079,596,2675,1877,505,2382,1853,13,64,2,0,12,25,550,666
2,13/10/2022,0211-Shenoy Nagar,38550,51982,0,872,11916,0,0,51338,0,0,0,0,2000,2000,1478,443,1921,1627,432,2059,1634,8,70,1,0,2,28,403,512
2,13/10/2022,0213-Anna Nagar East,104505,121827,700,2104,29552,0,0,136861,0,0,0,0,3000,3000,3627,1107,4734,3626,952,4578,3682,18,181,2,0,2,84,1002,1289
2,13/10/2022,0215-Anna Nagar Tower,107513,110348,200,2160,23394,0,0,133267,0,0,0,0,1500,1500,3290,853,4143,3305,797,4102,3351,26,178,2,0,1,75,763,1045
2,13/10/2022,0217-Thirumangalam,293889,325743,1640,7176,76936,0,0,379641,0,0,0,0,0,0,9141,2663,11804,9231,2381,11612,9364,83,508,3,0,7,226,2354,3181
2,13/10/2022,0219-Koyambedu,212231,253723,914,4608,79810,0,0,297563,0,0,0,5000,4000,9000,6589,2698,9287,6068,2226,8294,6382,76,669,5,0,10,165,2486,3411
2,13/10/2022,0221-Puratchi Thalaivi Dr. J. Jayalalithaa CMBT,65562,167555,790,2360,78020,0,0,146732,0,0,0,0,0,0,2482,2584,5066,3867,3357,7224,3545,27,340,1,0,4,91,2421,2884
2,13/10/2022,0223-Arumbakkam,54646,67211,750,1352,25306,0,0,82054,0,0,0,0,6500,6500,1763,907,2670,1918,671,2589,1793,23,4,2,0,2,59,841,931
2,13/10/2022,0225-Vadapalani,132780,233082,100,5728,75830,0,0,214438,0,0,0,0,10000,10000,5738,2690,8428,5928,2595,8523,6163,51,721,3,0,7,211,2364,3357
2,13/10/2022,0227-Ashok Nagar,97531,155807,2700,3240,48770,0,0,152241,0,0,0,0,3500,3500,4053,1686,5739,4138,1339,5477,4186,32,337,4,0,5,109,1529,2016
2,13/10/2022,0229-Ekkattuthangal,111660,154301,1000,3200,34232,0,0,150092,0,0,0,0,0,0,4589,1291,5880,4579,1025,5604,4854,31,388,1,0,5,136,1073,1634
2,13/10/2022,0231-Arignar Anna Alandur,193229,208638,300,4472,56802,0,0,254803,0,0,0,0,4500,4500,5994,1985,7979,5632,1658,7290,5903,59,459,2,0,5,155,1737,2417
2,13/10/2022,0233-St. Thomas Mount,96617,110743,100,3232,30412,0,0,130361,0,0,0,0,6175,6175,3130,1064,4194,3006,828,3834,3125,25,181,1,0,2,113,918,1240
1,14/10/2022,01ED-Wimco Nagar Depot Metro,84311,77928,100,1432,22280,0,0,108123,0,0,0,0,2500,2500,2116,600,2716,1806,328,2134,1775,13,6,5,0,4,43,558,629
1,14/10/2022,01EF-Wimco Nagar Metro,119335,135979,188,2760,29494,0,0,151777,0,0,0,0,0,0,3579,815,4394,3378,795,4173,3327,38,92,4,0,4,74,722,934
1,14/10/2022,01F1-Thiruvotriyur Metro,103118,111343,300,1312,23438,0,0,128168,0,0,0,0,0,0,3098,670,3768,3004,573,3577,2951,31,0,0,0,2,42,628,703
1,14/10/2022,01F3-Thiruvotriyur Theradi Metro,104150,123005,600,1776,27366,0,0,133892,0,0,0,0,0,0,3124,805,3929,3331,806,4137,3265,30,55,5,0,7,57,740,894
1,14/10/2022,01F5-Kaladipet Metro,109004,100871,0,1432,21626,0,0,132062,0,0,0,0,0,0,3111,690,3801,3054,619,3673,2950,15,0,3,0,3,50,635,706
1,14/10/2022,01F7-Tollgate Metro,65239,57673,0,752,15160,0,0,81151,0,0,0,0,0,0,1697,510,2207,1633,388,2021,1580,15,0,4,0,4,26,471,520
1,14/10/2022,01F9-New Washermenpet Metro,97129,96864,100,1008,19546,0,0,117783,0,0,0,0,500,500,3079,702,3781,3133,668,3801,3091,17,44,1,0,4,40,661,767
1,14/10/2022,01FB-Tondiarpet Metro,92732,107312,232,1184,26518,0,0,120666,0,0,0,0,0,0,3120,883,4003,3307,765,4072,3207,16,0,3,0,7,42,827,895
1,14/10/2022,01FD-Thiagaraya College Metro,116532,128327,0,2104,30848,0,0,149484,0,0,0,0,750,750,3835,1113,4948,4016,893,4909,3987,22,68,3,0,6,74,1023,1196
1,14/10/2022,0101-Washermanpet,111966,138877,824,2416,44518,0,0,159724,0,0,0,0,15000,15000,4017,1548,5565,3868,1385,5253,3854,20,178,5,0,10,95,1439,1747
1,14/10/2022,0103-Mannadi,91015,121140,400,1696,32936,0,0,126047,0,0,0,0,1500,1500,3340,1205,4545,3703,1185,4888,3713,21,159,2,0,0,64,1124,1370
1,14/10/2022,0105-High Court,151122,264658,1300,3064,69314,0,0,224800,0,0,0,0,0,0,7688,2529,10217,7589,2196,9785,7925,34,538,1,0,6,137,2326,3042
1,14/10/2022,0109-Government Estate,82042,158771,780,2416,54274,0,0,139512,0,0,0,0,2000,2000,4127,1946,6073,4728,1494,6222,4639,31,185,5,0,14,114,1768,2117
1,14/10/2022,0111-LIC,81041,185061,1700,2968,34478,0,0,120187,0,0,0,0,0,0,5259,1294,6553,6147,958,7105,6077,26,1,1,0,8,116,1134,1286
1,14/10/2022,0113-Thousand Lights,159051,257356,1600,5352,24084,0,0,190087,0,0,0,0,0,0,8407,1044,9451,8390,1434,9824,9193,36,939,0,0,6,233,741,1955
1,14/10/2022,0115-AG-DMS,120832,164126,0,2512,30960,0,0,154304,0,0,0,0,0,0,5321,1108,6429,5104,722,5826,5252,21,236,2,0,1,98,955,1313
1,14/10/2022,0117-Teynampet,114022,158376,1300,1976,17958,0,0,135256,0,0,0,0,6750,6750,5438,740,6178,5373,966,6339,5727,28,553,1,0,3,83,625,1293
1,14/10/2022,0119-Nandanam,92869,142152,250,2640,37212,0,0,132971,0,0,0,0,1500,1500,4148,1349,5497,4608,925,5533,4494,38,0,5,0,7,104,1214,1368
1,14/10/2022,0121-Saidapet,46697,87849,0,1520,26554,0,0,74771,0,0,0,0,4500,4500,2101,929,3030,2614,737,3351,2493,8,0,4,0,1,59,852,924
1,14/10/2022,0123-Little Mount,100849,106847,600,2864,28024,0,0,132337,0,0,0,0,1000,1000,3648,1086,4734,3127,704,3831,3207,34,214,2,0,6,106,921,1283
1,14/10/2022,0125-Guindy,167158,286299,520,6976,64668,0,0,239322,0,0,0,0,5000,5000,8996,2404,11400,7757,2419,10176,8623,42,1293,11,0,12,271,1995,3624
1,14/10/2022,0129-Nanganallur Road,48592,50633,0,1016,13552,0,0,63160,0,0,0,0,0,0,1417,433,1850,1495,345,1840,1439,12,0,1,0,0,28,399,440
1,14/10/2022,0131-Meenambakkam,120644,148643,1700,2552,37614,0,0,162510,0,0,0,0,0,0,4361,1112,5473,3655,872,4527,3800,31,274,7,0,1,87,1016,1416
1,14/10/2022,0133-Chennai International Airport,198841,365846,3573,11632,161406,0,0,375452,0,0,0,0,7500,7500,6190,4595,10785,6804,3671,10475,6650,78,756,30,0,23,355,3938,5180
2,14/10/2022,0201-Puratchi Thalaivar Dr. M.G. Ramachandran Central,334459,576844,700,15016,141616,0,0,491791,0,0,0,0,10450,10450,16569,5355,21924,14402,8770,23172,17689,83,5047,12,0,43,634,4358,10177
2,14/10/2022,0203-Egmore,75036,142369,100,2880,61530,0,0,139546,0,0,0,0,9750,9750,2782,2170,4952,3280,2600,5880,3343,26,612,13,0,10,100,2068,2829
2,14/10/2022,0205-Nehru Park,55336,63224,150,1560,21366,0,0,78412,0,0,0,0,500,500,1911,858,2769,1881,644,2525,1885,12,243,0,0,20,83,730,1088
2,14/10/2022,0207-Kilpauk,51131,69265,0,1328,17820,0,0,70279,0,0,0,0,0,0,2000,678,2678,1856,730,2586,2075,16,298,0,0,1,65,601,981
2,14/10/2022,0209-Pachaiyappas College,50099,63096,50,944,15990,0,0,67083,0,0,0,0,2000,2000,2166,630,2796,2023,474,2497,2028,18,85,1,0,15,42,572,733
2,14/10/2022,0211-Shenoy Nagar,39107,51147,0,688,12816,0,0,52611,0,0,0,0,0,0,1472,469,1941,1623,459,2082,1595,11,80,0,0,1,28,424,544
2,14/10/2022,0213-Anna Nagar East,84172,123511,1100,3128,30804,0,0,119204,0,0,0,0,4500,4500,3584,1157,4741,3719,906,4625,3709,27,195,0,0,4,95,1034,1355
2,14/10/2022,0215-Anna Nagar Tower,94419,115076,600,1592,26100,0,0,122711,0,0,0,0,500,500,3429,941,4370,3398,764,4162,3444,27,241,0,1,5,62,857,1193
2,14/10/2022,0217-Thirumangalam,260072,341646,2020,7664,84548,0,0,354304,0,0,0,0,0,0,9443,2991,12434,9338,2639,11977,9587,63,837,4,0,7,285,2586,3782
2,14/10/2022,0219-Koyambedu,202866,260997,700,5336,86386,0,0,295288,0,0,0,5000,6500,11500,6646,2969,9615,6334,2332,8666,6437,54,752,8,0,9,191,2679,3693
2,14/10/2022,0221-Puratchi Thalaivi Dr. J. Jayalalithaa CMBT,66649,182194,300,3616,77580,0,0,148145,0,0,0,0,0,0,2678,2549,5227,4998,4437,9435,4153,22,477,5,0,5,99,2371,2979
2,14/10/2022,0223-Arumbakkam,57957,67958,200,1280,24490,0,0,83927,0,0,0,0,3000,3000,1802,880,2682,2008,677,2685,1808,18,4,0,0,6,49,811,888
2,14/10/2022,0225-Vadapalani,125947,244171,400,6832,82178,0,0,215357,0,0,0,0,5500,5500,5874,2950,8824,5999,2674,8673,6282,35,938,3,0,7,262,2506,3751
2,14/10/2022,0227-Ashok Nagar,103103,169665,290,4488,51742,0,0,159623,0,0,0,0,7500,7500,4471,1834,6305,4389,1555,5944,4606,31,536,6,0,6,185,1532,2296
2,14/10/2022,0229-Ekkattuthangal,100126,160118,1000,4064,36442,0,0,141632,0,0,0,0,0,0,4743,1389,6132,4355,1001,5356,4903,28,689,2,0,7,168,1155,2049
2,14/10/2022,0231-Arignar Anna Alandur,174890,227595,852,5896,69348,0,0,250986,0,0,0,0,4250,4250,6311,2393,8704,5702,1868,7570,6118,45,692,7,0,5,214,2057,3020
2,14/10/2022,0233-St. Thomas Mount,77527,119092,1030,3120,37090,0,0,118767,0,0,0,400,1200,1600,3246,1270,4516,3159,933,4092,3188,34,201,8,0,6,113,1142,1504
1,15/10/2022,01ED-Wimco Nagar Depot Metro,73045,78251,50,2416,29982,0,0,105493,0,0,0,0,5250,5250,1904,770,2674,1658,463,2121,1519,12,1,1,0,6,36,734,790
1,15/10/2022,01EF-Wimco Nagar Metro,102521,131095,1200,2768,40342,0,0,146831,0,0,0,0,500,500,2892,1067,3959,2884,964,3848,2828,38,167,2,0,6,81,969,1263
1,15/10/2022,01F1-Thiruvotriyur Metro,110298,107475,0,2240,31996,0,0,144534,0,0,0,0,0,0,2632,910,3542,2687,719,3406,2535,44,0,4,0,6,68,831,953
1,15/10/2022,01F3-Thiruvotriyur Theradi Metro,95740,121341,747,2952,34402,0,0,133841,0,0,0,0,0,0,2877,1046,3923,3037,1002,4039,2972,39,128,10,0,5,90,926,1198
1,15/10/2022,01F5-Kaladipet Metro,91380,101974,0,1936,33098,0,0,126414,0,0,0,0,0,0,2690,1010,3700,2727,789,3516,2558,23,8,2,0,5,63,959,1060
1,15/10/2022,01F7-Tollgate Metro,52321,58479,500,1080,19986,0,0,73887,0,0,0,0,0,0,1477,646,2123,1533,465,1998,1405,17,0,1,0,8,37,601,664
1,15/10/2022,01F9-New Washermenpet Metro,83674,92360,0,1408,27438,0,0,112520,0,0,0,0,250,250,2550,948,3498,2687,804,3491,2588,18,81,0,0,7,45,892,1043
1,15/10/2022,01FB-Tondiarpet Metro,92547,100481,200,1960,32182,0,0,126889,0,0,0,0,0,0,2518,1062,3580,2878,877,3755,2713,24,1,3,0,9,63,991,1091
1,15/10/2022,01FD-Thiagaraya College Metro,107551,131314,0,3368,43154,0,0,154073,0,0,0,0,4500,4500,3449,1504,4953,3659,1085,4744,3555,53,57,0,0,7,117,1349,1583
1,15/10/2022,0101-Washermanpet,111211,140173,750,3256,51488,0,0,166705,0,0,0,0,17000,17000,3606,1719,5325,3310,1729,5039,3478,25,602,6,0,8,126,1555,2322
1,15/10/2022,0103-Mannadi,84926,116476,750,1792,40366,0,0,127834,0,0,0,0,0,0,2873,1382,4255,3187,1276,4463,3183,21,244,1,0,1,66,1288,1621
1,15/10/2022,0105-High Court,123314,233387,50,5152,88160,0,0,216676,0,0,0,0,0,0,5531,3107,8638,5661,2448,8109,5825,27,482,0,0,9,196,2784,3498
1,15/10/2022,0109-Government Estate,88202,175724,350,3560,64990,0,0,157102,0,0,0,0,500,500,4013,2372,6385,4676,2003,6679,4607,25,465,4,0,20,147,2124,2785
1,15/10/2022,0111-LIC,62689,152173,810,3320,47860,0,0,114679,0,0,0,0,0,0,3567,1680,5247,4458,1237,5695,4195,18,0,2,0,9,114,1516,1659
1,15/10/2022,0113-Thousand Lights,140419,233699,1400,6848,32966,0,0,181633,0,0,0,0,0,0,6852,1361,8213,6362,2156,8518,7608,21,1696,0,0,19,270,960,2966
1,15/10/2022,0115-AG-DMS,78926,119014,1200,1936,34356,0,0,116418,0,0,0,0,0,0,3192,1207,4399,3194,742,3936,3259,26,217,0,0,0,73,1070,1386
1,15/10/2022,0117-Teynampet,65820,123092,460,2424,35892,0,0,104596,0,0,0,0,0,0,3442,1313,4755,3814,963,4777,3573,28,13,0,0,2,94,1186,1323
1,15/10/2022,0119-Nandanam,66406,101047,260,2512,41360,0,0,110538,0,0,0,0,3000,3000,2440,1452,3892,2654,972,3626,2472,29,0,6,0,10,99,1286,1430
1,15/10/2022,0121-Saidapet,38451,73914,250,1760,32974,0,0,73435,0,0,0,0,4500,4500,1423,1139,2562,1802,880,2682,1625,16,0,0,0,3,66,1067,1152
1,15/10/2022,0123-Little Mount,68817,86483,1350,4120,31666,0,0,105953,0,0,0,0,3000,3000,2358,1115,3473,2047,782,2829,2143,24,299,4,0,5,86,983,1401
1,15/10/2022,0125-Guindy,183312,279365,350,9032,69044,0,0,261738,0,0,0,0,7500,7500,7568,2560,10128,6010,3200,9210,7686,40,2531,2,0,25,319,2053,4970
1,15/10/2022,0129-Nanganallur Road,39912,50820,200,1152,19712,0,0,60976,0,0,0,0,0,0,1032,608,1640,1274,444,1718,1156,6,0,2,0,4,41,559,612
1,15/10/2022,0131-Meenambakkam,120117,147702,800,3592,49576,0,0,174085,0,0,0,0,0,0,3595,1423,5018,3033,1231,4264,3234,20,496,5,0,6,122,1327,1976
1,15/10/2022,0133-Chennai International Airport,171880,388105,4385,13632,193848,0,0,383745,0,0,0,0,750,750,5461,5485,10946,6356,4486,10842,6100,79,1148,29,0,38,405,4516,6215
2,15/10/2022,0201-Puratchi Thalaivar Dr. M.G. Ramachandran Central,321691,518962,1430,15640,141674,0,0,480435,0,0,0,0,6900,6900,14094,5439,19533,11107,8544,19651,14714,71,5919,13,0,47,625,4447,11122
2,15/10/2022,0203-Egmore,74932,145569,100,3560,69962,0,0,148554,0,0,0,0,4750,4750,2562,2460,5022,3241,2723,5964,3034,15,827,13,0,10,134,2231,3230
2,15/10/2022,0205-Nehru Park,44561,61001,0,2104,24632,0,0,71297,0,0,0,0,2000,2000,1508,934,2442,1428,712,2140,1543,19,294,0,0,4,94,837,1248
2,15/10/2022,0207-Kilpauk,49263,59480,200,1456,8696,0,0,59615,0,0,0,0,1000,1000,1960,372,2332,1483,699,2182,1974,18,631,5,0,0,63,292,1009
2,15/10/2022,0209-Pachaiyappas College,41928,62009,0,1280,24822,0,0,68030,0,0,0,0,6000,6000,1652,951,2603,1559,665,2224,1539,15,131,9,0,5,49,880,1089
2,15/10/2022,0211-Shenoy Nagar,37710,46750,1300,1032,15286,0,0,55328,0,0,0,0,3500,3500,1195,27,1222,1364,215,1579,1308,10,75,0,0,3,38,522,648
2,15/10/2022,0213-Anna Nagar East,90696,133647,300,3800,43352,0,0,138148,0,0,0,0,0,0,3468,1620,5088,3250,1205,4455,3549,34,585,0,0,8,157,1434,2218
2,15/10/2022,0215-Anna Nagar Tower,87840,121284,120,3296,40416,0,0,131672,0,0,0,0,9500,9500,2849,1495,4344,2989,1263,4252,3051,19,399,0,0,4,116,1313,1851
2,15/10/2022,0217-Thirumangalam,227353,324919,2400,11200,116650,0,0,357603,0,0,0,0,0,0,7427,3963,11390,7641,3606,11247,7703,58,1149,17,0,17,343,3462,5046
2,15/10/2022,0219-Koyambedu,156061,234522,800,6568,90018,0,0,253447,0,0,0,5000,3750,8750,5368,3199,8567,4905,2739,7644,5338,48,1327,11,0,19,264,2762,4431
2,15/10/2022,0221-Puratchi Thalaivi Dr. J. Jayalalithaa CMBT,67979,198644,1200,2856,97292,0,0,169327,0,0,0,0,0,0,2654,3292,5946,4728,4635,9363,3894,32,834,5,0,6,126,3074,4077
2,15/10/2022,0223-Arumbakkam,57469,69801,500,2080,33126,0,0,93175,0,0,0,0,9750,9750,1518,1254,2772,1784,888,2672,1528,24,2,9,0,11,79,1140,1265
2,15/10/2022,0225-Vadapalani,189813,292403,300,11336,80080,0,0,281529,0,0,0,0,4000,4000,7184,3207,10391,5917,4216,10133,7872,31,2971,6,0,18,472,2175,5673
2,15/10/2022,0227-Ashok Nagar,98183,158757,2000,5504,58224,0,0,163911,0,0,0,0,0,0,3748,2170,5918,3647,1926,5573,3965,30,838,2,0,2,229,1832,2933
2,15/10/2022,0229-Ekkattuthangal,74621,113751,850,4248,41788,0,0,121507,0,0,0,0,0,0,2835,1552,4387,2721,1016,3737,2907,27,483,2,0,13,168,1308,2001
2,15/10/2022,0231-Arignar Anna Alandur,148160,219228,700,6784,85564,0,0,241208,0,0,0,0,1000,1000,4908,2925,7833,4867,2432,7299,4982,61,849,13,0,16,248,2512,3699
2,15/10/2022,0233-St. Thomas Mount,79544,132230,700,5864,62156,0,0,148264,0,0,0,0,1850,1850,2577,2100,4677,2792,1469,4261,2621,34,223,4,0,6,200,1793,2260
1,16/10/2022,01ED-Wimco Nagar Depot Metro,52869,65582,0,1376,32980,0,0,87225,0,0,0,0,2000,2000,1071,825,1896,1116,489,1605,1023,21,1,8,0,10,36,802,878
1,16/10/2022,01EF-Wimco Nagar Metro,61624,93486,0,2432,43454,0,0,107510,0,0,0,0,0,0,1578,1115,2693,1497,798,2295,1502,45,150,2,0,21,68,1036,1322
1,16/10/2022,01F1-Thiruvotriyur Metro,67236,86799,50,2464,37862,0,0,107612,0,0,0,0,0,0,1528,982,2510,1696,903,2599,1576,38,0,4,0,10,66,950,1068
1,16/10/2022,01F3-Thiruvotriyur Theradi Metro,74741,109050,0,3176,47016,0,0,124933,0,0,0,0,0,0,1764,1297,3061,2068,1186,3254,2031,25,151,6,0,12,104,1157,1455
1,16/10/2022,01F5-Kaladipet Metro,58888,76597,0,2056,36524,0,0,97468,0,0,0,0,0,0,1419,1098,2517,1580,866,2446,1470,22,0,1,0,9,72,1018,1122
1,16/10/2022,01F7-Tollgate Metro,33306,45415,200,1008,21778,0,0,56292,0,0,0,0,0,0,771,684,1455,958,492,1450,823,11,0,0,0,16,37,629,693
1,16/10/2022,01F9-New Washermenpet Metro,58214,68892,1200,1080,29694,0,0,90188,0,0,0,0,0,0,1396,936,2332,1516,753,2269,1458,15,120,0,0,9,45,894,1083
1,16/10/2022,01FB-Tondiarpet Metro,46209,69821,100,1192,35560,0,0,83061,0,0,0,0,0,0,1302,1069,2371,1495,936,2431,1313,18,1,0,0,10,35,1031,1095
1,16/10/2022,01FD-Thiagaraya College Metro,75462,118141,940,3552,57294,0,0,137248,0,0,0,0,1000,1000,2184,1833,4017,2282,1305,3587,2263,47,158,0,0,26,107,1691,2029
1,16/10/2022,0101-Washermanpet,79547,130448,250,2568,72900,0,0,155265,0,0,0,0,14000,14000,1976,2244,4220,2089,2240,4329,2057,19,442,3,0,23,100,2114,2701
1,16/10/2022,0103-Mannadi,46223,80302,1000,1120,38426,0,0,86769,0,0,0,0,0,0,1388,1249,2637,1500,1320,2820,1575,15,292,0,0,10,41,1218,1576
1,16/10/2022,0105-High Court,40933,99765,600,2648,50824,0,0,95005,0,0,0,0,0,0,1735,1789,3524,1841,1439,3280,1938,11,285,3,0,17,87,1649,2052
1,16/10/2022,0109-Government Estate,46414,102929,450,2808,50432,0,0,100104,0,0,0,0,0,0,1897,1818,3715,2175,1602,3777,2112,24,232,5,0,25,95,1660,2041
1,16/10/2022,0111-LIC,24920,68313,350,1672,37482,0,0,64424,0,0,0,0,0,0,1035,1248,2283,1351,954,2305,1187,11,0,0,0,14,67,1153,1245
1,16/10/2022,0113-Thousand Lights,44351,94566,200,2736,44750,0,0,92037,0,0,0,0,0,0,1636,1509,3145,2114,1403,3517,1928,18,116,0,0,18,95,1339,1586
1,16/10/2022,0115-AG-DMS,28339,48243,0,2144,20414,0,0,50897,0,0,0,0,0,0,983,736,1719,927,591,1518,1035,16,151,3,0,3,78,600,851
1,16/10/2022,0117-Teynampet,28809,52206,100,1136,19696,0,0,49741,0,0,0,0,0,0,1038,699,1737,1221,837,2058,1226,10,185,0,0,12,45,624,876
1,16/10/2022,0119-Nandanam,26537,60500,100,1752,35324,0,0,63713,0,0,0,0,0,0,932,1241,2173,1149,817,1966,994,21,0,14,0,8,69,1126,1238
1,16/10/2022,0121-Saidapet,18571,55253,0,1896,34126,0,0,54593,0,0,0,0,0,0,670,1136,1806,927,955,1882,809,16,21,2,0,2,76,1057,1174
1,16/10/2022,0123-Little Mount,37063,55803,710,1832,24412,0,0,64017,0,0,0,0,500,500,1280,891,2171,1121,719,1840,1218,16,229,0,0,8,79,768,1100
1,16/10/2022,0125-Guindy,103639,195050,500,7976,83538,0,0,195653,0,0,0,0,0,0,3577,2866,6443,2861,3315,6176,3805,31,1479,18,0,19,273,2384,4204
1,16/10/2022,0129-Nanganallur Road,15556,26222,100,800,13556,0,0,30012,0,0,0,0,0,0,379,423,802,582,369,951,453,13,0,2,0,3,27,376,421
1,16/10/2022,0131-Meenambakkam,61152,101836,220,3472,53160,0,0,118004,0,0,0,0,0,0,1589,1458,3047,1429,1238,2667,1528,16,355,12,0,15,111,1393,1902
1,16/10/2022,0133-Chennai International Airport,124061,351259,686,12624,218246,0,0,355617,0,0,0,0,750,750,3591,6018,9609,4405,4906,9311,4158,59,877,50,0,29,376,5252,6643
2,16/10/2022,0201-Puratchi Thalaivar Dr. M.G. Ramachandran Central,234030,419115,1400,13776,166606,0,0,415812,0,0,0,0,2100,2100,8957,5893,14850,5682,8194,13876,9232,61,4877,31,0,32,535,5138,10674
2,16/10/2022,0203-Egmore,65546,126143,214,3760,67540,0,0,137060,0,0,0,0,9750,9750,2096,2405,4501,2073,2796,4869,2308,20,865,14,0,8,141,2219,3267
2,16/10/2022,0205-Nehru Park,18932,39744,100,1416,19782,0,0,40230,0,0,0,0,2000,2000,787,702,1489,754,590,1344,782,10,128,0,0,7,55,673,873
2,16/10/2022,0207-Kilpauk,20245,34504,0,1016,15546,0,0,36807,0,0,0,0,0,0,646,557,1203,627,532,1159,723,12,206,0,0,2,32,504,756
2,16/10/2022,0209-Pachaiyappas College,41816,54718,0,1704,25342,0,0,68862,0,0,0,0,10000,10000,1167,946,2113,1148,811,1959,1186,21,162,2,0,20,47,844,1096
2,16/10/2022,0211-Shenoy Nagar,17064,26823,0,944,12102,0,0,30110,0,0,0,0,0,0,518,414,932,624,359,983,606,7,76,0,0,1,38,395,517
2,16/10/2022,0213-Anna Nagar East,49604,76762,0,2632,32560,0,0,84796,0,0,0,0,0,0,1666,1216,2882,1690,1062,2752,1750,19,304,2,0,5,108,1082,1520
2,16/10/2022,0215-Anna Nagar Tower,47403,76901,450,2688,32754,0,0,83295,0,0,0,0,0,0,1619,1187,2806,1637,1075,2712,1686,28,328,0,0,5,108,1052,1521
2,16/10/2022,0217-Thirumangalam,130941,243041,980,10208,121556,0,0,263685,0,0,0,0,0,0,4052,4087,8139,4403,3652,8055,4467,46,837,8,0,20,366,3583,4860
2,16/10/2022,0219-Koyambedu,110109,199225,350,6920,99864,0,0,217243,0,0,0,0,2750,2750,3509,3388,6897,3147,2887,6034,3622,44,1079,11,0,30,278,3007,4449
2,16/10/2022,0221-Puratchi Thalaivi Dr. J. Jayalalithaa CMBT,56222,173828,774,4600,103308,0,0,164904,0,0,0,0,0,0,2152,3482,5634,2805,4096,6901,2579,20,810,13,0,13,189,3198,4243
2,16/10/2022,0223-Arumbakkam,29523,51827,0,1360,31500,0,0,62383,0,0,0,0,0,0,829,1149,1978,1072,830,1902,865,16,3,6,0,10,62,1070,1167
2,16/10/2022,0225-Vadapalani,131110,242016,300,11560,82860,0,0,225830,0,0,0,0,2500,2500,5322,3218,8540,4047,4238,8285,5866,43,2540,3,0,21,462,2345,5414
2,16/10/2022,0227-Ashok Nagar,60311,102364,1088,3232,51518,0,0,116149,0,0,0,0,0,0,1868,1832,3700,1870,1645,3515,2005,35,516,5,0,2,142,1619,2319
2,16/10/2022,0229-Ekkattuthangal,40949,65681,500,2624,27658,0,0,71731,0,0,0,0,0,0,1375,1044,2419,1448,916,2364,1556,20,364,0,0,11,115,871,1381
2,16/10/2022,0231-Arignar Anna Alandur,103121,167345,150,6240,86152,0,0,195663,0,0,0,0,1250,1250,2673,2825,5498,2696,2342,5038,2900,51,715,25,0,22,198,2508,3519
2,16/10/2022,0233-St. Thomas Mount,64197,96819,300,3872,47432,0,0,115801,0,0,0,0,2150,2150,1619,1587,3206,1706,1380,3086,1737,26,467,4,0,12,144,1394,2047
1,17/10/2022,01ED-Wimco Nagar Depot Metro,96050,80952,580,1552,25198,0,0,123380,0,0,0,0,2000,2000,2164,677,2841,1847,417,2264,1787,21,3,3,0,5,46,624,702
1,17/10/2022,01EF-Wimco Nagar Metro,145602,142569,700,2792,32040,0,0,181134,0,0,0,0,250,250,3690,863,4553,3433,846,4279,3442,62,105,5,0,3,80,786,1041
1,17/10/2022,01F1-Thiruvotriyur Metro,144579,115845,0,1464,25978,0,0,172021,0,0,0,0,0,0,3115,714,3829,3073,562,3635,2998,24,8,17,0,5,47,678,779
1,17/10/2022,01F3-Thiruvotriyur Theradi Metro,134671,125966,0,1680,23306,0,0,159657,0,0,0,0,0,0,3075,693,3768,3387,862,4249,3479,17,212,1,0,4,49,626,909
1,17/10/2022,01F5-Kaladipet Metro,124987,103336,500,1664,21940,0,0,149091,0,0,0,0,0,0,3135,752,3887,3124,647,3771,3050,21,6,0,0,1,55,694,777
1,17/10/2022,01F7-Tollgate Metro,76213,60508,0,1376,14884,0,0,92473,0,0,0,0,0,0,1774,479,2253,1703,386,2089,1667,21,1,0,0,4,35,452,513
1,17/10/2022,01F9-New Washermenpet Metro,124096,101589,500,752,23514,0,0,148862,0,0,0,0,1500,1500,3143,811,3954,3171,747,3918,3095,23,41,3,0,4,31,777,879
1,17/10/2022,01FB-Tondiarpet Metro,120715,105924,700,1272,25958,0,0,148645,0,0,0,0,750,750,3038,872,3910,3229,742,3971,3159,30,10,1,0,2,40,818,901
1,17/10/2022,01FD-Thiagaraya College Metro,142552,139591,0,2856,35242,0,0,180650,0,0,0,0,250,250,3949,1238,5187,4244,1072,5316,4216,26,76,4,0,3,93,1130,1332
1,17/10/2022,0101-Washermanpet,114843,140148,1600,2072,46034,0,0,164549,0,0,0,0,9000,9000,4032,1577,5609,3774,1597,5371,3839,22,266,1,0,2,65,1493,1849
1,17/10/2022,0103-Mannadi,113467,119934,150,2008,31556,0,0,147181,0,0,0,0,1500,1500,3357,1103,4460,3813,1202,5015,3762,21,106,1,0,3,55,1043,1229
1,17/10/2022,0105-High Court,177673,259070,1200,2384,66516,0,0,247773,0,0,0,0,0,0,7667,2343,10010,7469,2094,9563,7842,44,601,3,0,2,99,2201,2950
1,17/10/2022,0109-Government Estate,120075,163697,2180,2112,53502,0,0,177869,0,0,0,0,4000,4000,4373,1902,6275,4868,1685,6553,4866,51,293,9,0,4,97,1749,2203
1,17/10/2022,0111-LIC,107602,191566,1300,2160,38260,0,0,149322,0,0,0,0,0,0,5452,1385,6837,6322,1079,7401,6187,23,5,0,0,4,91,1251,1374
1,17/10/2022,0113-Thousand Lights,173369,272974,1270,6672,41302,0,0,222613,0,0,0,0,1250,1250,8288,1607,9895,9072,1599,10671,9292,43,333,5,0,4,246,1293,1924
1,17/10/2022,0115-AG-DMS,146640,162668,770,1960,30018,0,0,179388,0,0,0,0,1250,1250,5205,1063,6268,5128,848,5976,5241,33,194,0,0,1,82,954,1264
1,17/10/2022,0117-Teynampet,123277,162831,600,2344,23822,0,0,150043,0,0,0,0,4000,4000,5317,922,6239,5539,1115,6654,5743,26,354,2,0,3,79,801,1265
1,17/10/2022,0119-Nandanam,113972,134624,2300,1912,29066,0,0,147250,0,0,0,0,1000,1000,3983,1088,5071,4625,993,5618,4506,40,5,0,0,3,81,954,1083
1,17/10/2022,0121-Saidapet,53316,92713,200,1424,26508,0,0,81448,0,0,0,0,6750,6750,2108,942,3050,2838,857,3695,2675,13,0,2,0,3,56,867,941
1,17/10/2022,0123-Little Mount,93887,101662,1300,1872,25580,0,0,122639,0,0,0,0,0,0,3599,960,4559,3084,683,3767,3132,31,170,0,0,2,80,837,1120
1,17/10/2022,0125-Guindy,176083,279003,1200,7472,76510,0,0,261265,0,0,0,0,4500,4500,8446,2745,11191,7832,2431,10263,8046,39,484,1,0,9,242,2395,3170
1,17/10/2022,0129-Nanganallur Road,61225,50392,2250,696,12024,0,0,76195,0,0,0,0,0,0,1388,395,1783,1536,323,1859,1483,9,8,0,1,0,26,358,402
1,17/10/2022,0131-Meenambakkam,170080,150581,800,2840,38114,0,0,211834,0,0,0,0,0,0,4329,1120,5449,3725,987,4712,3828,29,256,3,0,0,76,1027,1391
1,17/10/2022,0133-Chennai International Airport,198432,354444,1400,8072,151816,0,0,359720,0,0,0,0,9750,9750,6195,4165,10360,6772,3782,10554,6624,67,677,13,1,13,242,3752,4765
2,17/10/2022,0201-Puratchi Thalaivar Dr. M.G. Ramachandran Central,377351,542182,1200,18472,149096,0,0,546119,0,0,0,0,6800,6800,16751,5458,22209,11834,7620,19454,15861,123,4718,26,0,23,663,4511,10064
2,17/10/2022,0203-Egmore,89298,133473,288,2496,61604,0,0,153686,0,0,0,0,16250,16250,2882,2144,5026,2926,2477,5403,2972,20,575,7,0,3,96,1969,2670
2,17/10/2022,0205-Nehru Park,43883,49072,0,1256,14268,0,0,59407,0,0,0,0,0,0,1464,580,2044,1425,461,1886,1464,16,135,1,0,1,50,521,724
2,17/10/2022,0207-Kilpauk,50995,64570,300,1800,17134,0,0,70229,0,0,0,0,0,0,1749,669,2418,1837,613,2450,1905,18,149,1,0,0,51,596,815
2,17/10/2022,0209-Pachaiyappas College,61559,62605,0,904,16286,0,0,78749,0,0,0,0,3000,3000,2028,652,2680,1962,538,2500,1951,17,87,1,0,9,39,593,746
2,17/10/2022,0211-Shenoy Nagar,49139,53489,24,360,13874,0,0,63397,0,0,0,0,0,0,1520,488,2008,1651,473,2124,1644,16,101,0,0,0,14,451,582
2,17/10/2022,0213-Anna Nagar East,107382,120303,708,2352,28636,0,0,139078,0,0,0,0,1500,1500,3575,1076,4651,3626,947,4573,3664,19,172,1,0,0,86,954,1232
2,17/10/2022,0215-Anna Nagar Tower,111747,115088,100,1608,25698,0,0,139153,0,0,0,0,1500,1500,3247,946,4193,3419,838,4257,3465,27,195,2,0,0,68,859,1151
2,17/10/2022,0217-Thirumangalam,339872,338434,3075,8944,85694,0,0,437585,0,0,0,0,3000,3000,9015,2969,11984,9452,2784,12236,9504,84,498,5,0,4,279,2603,3473
2,17/10/2022,0219-Koyambedu,258003,270080,2440,5232,86388,0,0,352063,0,0,0,5250,20000,25250,6994,2921,9915,6303,2193,8496,6705,60,899,3,0,13,200,2656,3831
2,17/10/2022,0221-Puratchi Thalaivi Dr. J. Jayalalithaa CMBT,92042,197790,1100,3240,98316,0,0,194698,0,0,0,0,0,0,3228,3173,6401,4021,3395,7416,3919,33,630,7,0,7,134,2979,3790
2,17/10/2022,0223-Arumbakkam,72694,67981,0,1384,23024,0,0,97102,0,0,0,0,2500,2500,1810,858,2668,2002,683,2685,1875,19,20,1,0,3,57,779,879
2,17/10/2022,0225-Vadapalani,156475,240342,700,5352,76282,0,0,238809,0,0,0,0,5000,5000,5736,2658,8394,6249,2720,8969,6277,50,758,1,0,17,199,2334,3359
2,17/10/2022,0227-Ashok Nagar,110162,163606,2950,3048,47944,0,0,164104,0,0,0,0,0,0,4394,1644,6038,4485,1563,6048,4538,36,456,5,0,6,103,1467,2073
2,17/10/2022,0229-Ekkattuthangal,101892,150744,1706,3632,30372,0,0,137602,0,0,0,0,1500,1500,4316,1164,5480,4619,1220,5839,4839,33,350,6,0,5,137,954,1485
2,17/10/2022,0231-Arignar Anna Alandur,216337,216290,600,5192,60686,0,0,282815,0,0,0,0,7250,7250,6007,2119,8126,5844,1867,7711,6057,64,473,2,0,2,181,1823,2545
2,17/10/2022,0233-St. Thomas Mount,107874,113774,300,2848,33252,0,0,144274,0,0,0,3000,3200,6200,3146,1138,4284,3220,906,4126,3164,33,85,3,1,1,103,1021,1247
1,18/10/2022,01ED-Wimco Nagar Depot Metro,85138,74585,200,1240,21076,0,0,107654,0,0,0,0,3250,3250,2124,565,2689,1723,425,2148,1708,10,0,0,0,6,36,537,589
1,18/10/2022,01EF-Wimco Nagar Metro,127852,135617,1600,2832,25798,0,0,158082,0,0,0,0,250,250,3640,710,4350,3358,741,4099,3436,22,131,3,0,4,80,631,871
1,18/10/2022,01F1-Thiruvotriyur Metro,115928,107384,100,1056,19944,0,0,137028,0,0,0,0,0,0,3013,570,3583,2989,475,3464,2930,25,0,3,0,2,31,544,605
1,18/10/2022,01F3-Thiruvotriyur Theradi Metro,110897,116974,200,1448,25430,0,0,137975,0,0,0,0,0,0,2923,749,3672,3220,771,3991,3174,19,22,3,0,0,39,694,777
1,18/10/2022,01F5-Kaladipet Metro,107199,103794,600,1376,21548,0,0,130723,0,0,0,0,0,0,3188,716,3904,3140,610,3750,3096,23,0,2,0,4,40,663,732
1,18/10/2022,01F7-Tollgate Metro,61413,56781,500,440,13328,0,0,75681,0,0,0,0,0,0,1687,415,2102,1636,356,1992,1598,11,0,0,0,3,14,396,424
1,18/10/2022,01F9-New Washermenpet Metro,91215,96526,0,984,19976,0,0,112175,0,0,0,0,250,250,2984,701,3685,3050,722,3772,3054,13,61,1,0,0,29,658,762
1,18/10/2022,01FB-Tondiarpet Metro,86948,105255,364,1904,24972,0,0,114188,0,0,0,0,1250,1250,3053,837,3890,3232,817,4049,3177,17,4,3,0,1,46,783,854
1,18/10/2022,01FD-Thiagaraya College Metro,119763,130257,1000,2056,31326,0,0,154145,0,0,0,0,1250,1250,3886,1156,5042,4053,1020,5073,4071,31,49,1,0,5,73,1064,1223
1,18/10/2022,0101-Washermanpet,104085,135068,1000,2200,43390,0,0,150675,0,0,0,0,2750,2750,3919,1504,5423,3728,1409,5137,3769,28,146,0,0,4,76,1418,1672
1,18/10/2022,0103-Mannadi,88123,120200,494,1336,30904,0,0,120857,0,0,0,0,1500,1500,3466,1107,4573,3751,1108,4859,3770,14,106,3,0,5,55,1033,1216
1,18/10/2022,0105-High Court,162911,269058,650,2816,75328,0,0,241705,0,0,0,0,0,0,7784,2688,10472,7751,2291,10042,7919,55,331,3,0,4,114,2511,3018
1,18/10/2022,0109-Government Estate,98885,157118,722,2096,50042,0,0,151745,0,0,0,0,7000,7000,4139,1810,5949,4646,1545,6191,4793,40,268,6,0,2,100,1654,2070
1,18/10/2022,0111-LIC,103781,187940,1250,2752,32388,0,0,140171,0,0,0,0,0,0,5550,1202,6752,6214,997,7211,6243,28,49,0,0,4,112,1058,1251
1,18/10/2022,0113-Thousand Lights,176297,271245,1020,6136,42708,0,0,226161,0,0,0,0,0,0,8282,1712,9994,9090,1569,10659,9222,47,169,2,0,5,254,1367,1844
1,18/10/2022,0115-AG-DMS,122657,151827,730,2072,24816,0,0,150275,0,0,0,0,1000,1000,5163,880,6043,4939,765,5704,5043,27,140,4,0,2,79,760,1012
1,18/10/2022,0117-Teynampet,105352,160724,500,1856,31792,0,0,139500,0,0,0,0,1000,1000,4973,1193,6166,5443,1108,6551,5379,26,27,0,0,1,79,1075,1208
1,18/10/2022,0119-Nandanam,102181,134336,2150,2072,29690,0,0,136093,0,0,0,0,1000,1000,4069,1147,5216,4557,864,5421,4483,32,0,8,0,1,88,1004,1133
1,18/10/2022,0121-Saidapet,45254,83870,900,1360,22246,0,0,69760,0,0,0,0,250,250,2060,793,2853,2521,779,3300,2483,12,10,0,0,0,51,731,804
1,18/10/2022,0123-Little Mount,90426,97940,800,2408,23438,0,0,117072,0,0,0,0,1000,1000,3552,921,4473,2981,676,3657,3061,34,131,0,0,1,84,781,1031
1,18/10/2022,0125-Guindy,173355,264012,700,6424,68134,0,0,248613,0,0,0,0,3000,3000,8075,2511,10586,7433,2217,9650,7848,46,532,7,0,5,254,2142,2986
1,18/10/2022,0129-Nanganallur Road,64936,50839,450,328,12042,0,0,77756,0,0,0,0,0,0,1405,374,1779,1535,306,1841,1488,20,0,0,0,2,11,350,383
1,18/10/2022,0131-Meenambakkam,134930,144756,1000,2440,33590,0,0,171960,0,0,0,0,0,0,4395,994,5389,3610,899,4509,3809,26,251,6,0,1,81,900,1265
1,18/10/2022,0133-Chennai International Airport,172683,326247,6461,7432,130496,0,0,317072,0,0,0,0,3000,3000,5856,3630,9486,6343,3754,10097,6406,50,620,14,0,9,220,3217,4130
2,18/10/2022,0201-Puratchi Thalaivar Dr. M.G. Ramachandran Central,261281,464627,450,11728,152174,0,0,425633,0,0,0,0,7050,7050,13598,5468,19066,11172,6863,18035,13184,86,2547,11,0,11,450,4893,7998
2,18/10/2022,0203-Egmore,85283,127027,1400,2040,50894,0,0,139617,0,0,0,0,5250,5250,2795,1790,4585,2856,2263,5119,3074,15,579,11,0,11,81,1714,2411
2,18/10/2022,0205-Nehru Park,52652,51926,0,816,16260,0,0,69728,0,0,0,0,4000,4000,1551,595,2146,1427,497,1924,1505,11,124,0,0,3,37,537,712
2,18/10/2022,0207-Kilpauk,41067,62691,0,1040,18088,0,0,60195,0,0,0,0,0,0,1692,662,2354,1762,588,2350,1810,15,110,0,0,2,42,596,765
2,18/10/2022,0209-Pachaiyappas College,65313,65183,700,1160,17084,0,0,84257,0,0,0,0,12000,12000,2135,687,2822,2052,514,2566,2024,18,65,1,0,13,50,620,767
2,18/10/2022,0211-Shenoy Nagar,44567,50166,200,512,11404,0,0,56683,0,0,0,0,0,0,1489,412,1901,1594,422,2016,1605,2,61,0,0,0,21,380,464
2,18/10/2022,0213-Anna Nagar East,90839,119985,700,2472,26714,0,0,120725,0,0,0,0,0,0,3611,1035,4646,3665,951,4616,3760,21,212,0,0,2,92,907,1234
2,18/10/2022,0215-Anna Nagar Tower,95973,114006,700,2232,26812,0,0,125717,0,0,0,0,750,750,3328,991,4319,3337,857,4194,3382,17,203,0,0,2,85,890,1197
2,18/10/2022,0217-Thirumangalam,298007,326734,3800,7432,79048,0,0,388287,0,0,0,0,0,0,9032,2704,11736,9017,2559,11576,9297,62,572,4,0,2,253,2407,3300
2,18/10/2022,0219-Koyambedu,183401,247306,300,5672,77816,0,0,267189,0,0,0,0,10750,10750,6497,2646,9143,5930,2144,8074,6233,56,581,2,0,7,183,2401,3230
2,18/10/2022,0221-Puratchi Thalaivi Dr. J. Jayalalithaa CMBT,56727,158854,1050,2176,73990,0,0,133943,0,0,0,0,0,0,2526,2456,4982,3640,3227,6867,3439,18,333,2,0,1,94,2295,2743
2,18/10/2022,0223-Arumbakkam,67698,70294,0,1368,24736,0,0,93802,0,0,0,0,7500,7500,1826,898,2724,1982,732,2714,1882,18,15,3,0,4,52,834,926
2,18/10/2022,0225-Vadapalani,139378,230959,280,5488,75208,0,0,220354,0,0,0,0,5500,5500,5616,2628,8244,5736,2777,8513,6105,40,738,3,0,6,217,2319,3323
2,18/10/2022,0227-Ashok Nagar,99918,155558,1800,2936,47434,0,0,152088,0,0,0,0,5000,5000,4171,1674,5845,4102,1539,5641,4274,29,349,5,0,2,118,1470,1973
2,18/10/2022,0229-Ekkattuthangal,121073,150159,1650,3312,27710,0,0,153745,0,0,0,0,250,250,4553,1080,5633,4599,1057,5656,4931,31,405,1,0,8,141,879,1465
2,18/10/2022,0231-Arignar Anna Alandur,177362,205242,3964,3696,57194,0,0,242216,0,0,0,0,1250,1250,5940,1979,7919,5558,1758,7316,5822,60,415,2,0,3,139,1717,2336
2,18/10/2022,0233-St. Thomas Mount,93679,113160,1588,2912,34480,0,0,132659,0,0,0,0,4450,4450,3103,1202,4305,3134,907,4041,3098,29,45,1,0,3,106,1057,1241
1,19/10/2022,01ED-Wimco Nagar Depot Metro,83882,83791,100,1560,27624,0,0,113166,0,0,0,0,5750,5750,2192,738,2930,1806,406,2212,1776,14,1,0,0,7,35,688,745
1,19/10/2022,01EF-Wimco Nagar Metro,122455,145827,200,3528,34052,0,0,160235,0,0,0,0,500,500,3697,938,4635,3397,809,4206,3477,45,123,1,0,6,96,831,1102
1,19/10/2022,01F1-Thiruvotriyur Metro,121891,109045,0,1392,22124,0,0,145407,0,0,0,0,0,0,3106,622,3728,2974,574,3548,2918,20,0,0,0,3,49,585,657
1,19/10/2022,01F3-Thiruvotriyur Theradi Metro,101465,124958,0,2096,26994,0,0,130555,0,0,0,0,0,0,3037,795,3832,3343,837,4180,3376,22,105,2,0,2,52,730,913
1,19/10/2022,01F5-Kaladipet Metro,114172,106272,50,1760,22496,0,0,138478,0,0,0,0,0,0,3207,731,3938,3163,679,3842,3136,28,0,3,0,0,55,673,759
1,19/10/2022,01F7-Tollgate Metro,69350,58198,100,736,13416,0,0,83602,0,0,0,0,0,0,1746,423,2169,1701,376,2077,1664,23,0,0,0,4,25,390,442
1,19/10/2022,01F9-New Washermenpet Metro,102830,99510,2199,976,24274,0,0,130279,0,0,0,0,750,750,1860,843,2703,2986,801,3787,2965,20,63,1,0,4,39,799,926
1,19/10/2022,01FB-Tondiarpet Metro,90934,105453,800,936,27290,0,0,119960,0,0,0,0,0,0,3079,889,3968,3218,797,4015,3118,17,1,4,0,1,34,846,903
1,19/10/2022,01FD-Thiagaraya College Metro,114692,136500,100,2208,33866,0,0,150866,0,0,0,0,1500,1500,4015,1220,5235,4216,1049,5265,4201,34,60,1,0,4,78,1124,1301
1,19/10/2022,0101-Washermanpet,112837,145683,2100,2040,49292,0,0,166269,0,0,0,0,7500,7500,4159,1687,5846,3907,1609,5516,3947,28,175,3,0,4,76,1596,1882
1,19/10/2022,0103-Mannadi,91170,125323,100,1088,36990,0,0,129348,0,0,0,0,1500,1500,3542,1372,4914,3767,1204,4971,3779,23,132,0,0,2,45,1308,1510
1,19/10/2022,0105-High Court,156613,256393,500,3200,66784,0,0,227097,0,0,0,0,0,0,7673,2400,10073,7407,2139,9546,7786,39,496,2,0,3,123,2233,2896
1,19/10/2022,0109-Government Estate,82799,158260,300,2816,54620,0,0,140535,0,0,0,0,3500,3500,4038,1983,6021,4659,1652,6311,4615,23,99,2,0,6,109,1797,2036
1,19/10/2022,0111-LIC,94055,190686,380,2568,35402,0,0,132405,0,0,0,0,0,0,5427,1291,6718,6210,1119,7329,6213,25,61,0,0,3,103,1139,1331
1,19/10/2022,0113-Thousand Lights,169759,282940,2081,6376,44240,0,0,222456,0,0,0,0,0,0,8789,1700,10489,9151,1722,10873,9514,39,435,3,0,9,232,1365,2083
1,19/10/2022,0115-AG-DMS,104256,159544,500,2808,28738,0,0,136302,0,0,0,0,0,0,5243,1009,6252,5055,779,5834,5165,30,150,0,0,0,91,872,1143
1,19/10/2022,0117-Teynampet,105649,158703,1500,1904,31238,0,0,140291,0,0,0,0,0,0,4858,1164,6022,5338,1132,6470,5341,28,125,0,0,1,83,1033,1270
1,19/10/2022,0119-Nandanam,106597,137303,1170,2344,32526,0,0,142637,0,0,0,0,3500,3500,4042,1213,5255,4573,876,5449,4490,26,0,1,0,2,88,1082,1199
1,19/10/2022,0121-Saidapet,50845,89750,0,1672,27448,0,0,79965,0,0,0,0,2250,2250,2121,966,3087,2600,824,3424,2517,11,0,6,0,2,70,869,958
1,19/10/2022,0123-Little Mount,84871,106426,1200,3200,26270,0,0,115541,0,0,0,0,0,0,3808,1025,4833,3122,714,3836,3260,26,202,1,0,5,97,890,1221
1,19/10/2022,0125-Guindy,145420,281298,1572,7712,76270,0,0,230974,0,0,0,0,1500,1500,8404,2773,11177,7632,2278,9910,8154,36,678,5,0,6,272,2331,3328
1,19/10/2022,0129-Nanganallur Road,42137,52909,950,1184,13308,0,0,57579,0,0,0,0,0,0,1389,420,1809,1553,328,1881,1523,8,0,1,0,2,35,377,423
1,19/10/2022,0131-Meenambakkam,150523,153269,1400,2624,36750,0,0,191297,0,0,0,0,0,0,4514,1086,5600,3692,927,4619,3964,33,368,5,0,2,81,973,1462
1,19/10/2022,0133-Chennai International Airport,186147,347098,3500,9088,145850,0,0,344585,0,0,0,0,9000,9000,6057,4075,10132,6520,3677,10197,6539,55,737,19,0,8,260,3619,4698
2,19/10/2022,0201-Puratchi Thalaivar Dr. M.G. Ramachandran Central,285810,492599,780,12536,146692,0,0,445818,0,0,0,0,8950,8950,14362,5420,19782,12163,7606,19769,14476,97,3254,6,0,16,474,4720,8567
2,19/10/2022,0203-Egmore,82786,142510,550,2872,59344,0,0,145552,0,0,0,0,18750,18750,2890,2165,5055,3489,2795,6284,3329,27,540,4,0,12,118,1989,2690
2,19/10/2022,0205-Nehru Park,39713,52946,0,1408,16854,0,0,57975,0,0,0,0,3000,3000,1617,672,2289,1529,547,2076,1572,9,98,0,0,5,59,586,757
2,19/10/2022,0207-Kilpauk,41625,69027,0,1344,20506,0,0,63475,0,0,0,0,0,0,1868,789,2657,1960,650,2610,2012,6,149,4,0,6,65,702,932
2,19/10/2022,0209-Pachaiyappas College,62262,59226,0,1072,16600,0,0,79934,0,0,0,0,14000,14000,1981,680,2661,1774,513,2287,1803,29,93,1,0,3,44,618,788
2,19/10/2022,0211-Shenoy Nagar,46108,55673,0,552,13266,0,0,59926,0,0,0,0,500,500,1598,482,2080,1743,483,2226,1742,7,86,0,0,7,23,452,575
2,19/10/2022,0213-Anna Nagar East,79050,125711,600,3280,31472,0,0,114402,0,0,0,0,1500,1500,3637,1216,4853,3606,981,4587,3723,22,272,0,0,5,136,1056,1491
2,19/10/2022,0215-Anna Nagar Tower,101465,125385,600,2728,29340,0,0,134133,0,0,0,0,0,0,3507,1109,4616,3500,925,4425,3692,16,364,2,0,3,105,983,1473
2,19/10/2022,0217-Thirumangalam,270578,346628,1150,10480,87796,0,0,370004,0,0,0,0,0,0,9481,3081,12562,9351,2667,12018,9714,56,712,8,0,2,320,2675,3773
2,19/10/2022,0219-Koyambedu,231052,261854,500,6312,87022,0,0,324886,0,0,0,0,15000,15000,6663,2993,9656,6206,2253,8459,6462,80,643,9,7,8,192,2683,3622
2,19/10/2022,0221-Puratchi Thalaivi Dr. J. Jayalalithaa CMBT,70126,175371,840,2696,70502,0,0,144164,0,0,0,0,0,0,2908,2357,5265,4624,4380,9004,4132,23,608,5,0,7,104,2189,2936
2,19/10/2022,0223-Arumbakkam,57488,70019,500,1288,25072,0,0,84348,0,0,0,0,6250,6250,1837,925,2762,2010,777,2787,1853,23,2,0,0,5,52,855,937
2,19/10/2022,0225-Vadapalani,126301,233780,0,5856,72626,0,0,204783,0,0,0,0,4000,4000,5853,2622,8475,5806,2559,8365,6312,33,937,4,0,5,237,2264,3480
2,19/10/2022,0227-Ashok Nagar,100457,163190,558,3768,49250,0,0,154033,0,0,0,0,0,0,4379,1757,6136,4226,1597,5823,4510,33,518,5,0,3,142,1520,2221
2,19/10/2022,0229-Ekkattuthangal,105494,163594,1700,4080,32460,0,0,143734,0,0,0,0,0,0,4933,1250,6183,4742,1115,5857,5231,34,595,1,0,8,158,1012,1808
2,19/10/2022,0231-Arignar Anna Alandur,164895,218641,1470,4896,62314,0,0,233575,0,0,0,0,3250,3250,6154,2181,8335,5768,1782,7550,6080,48,512,4,0,9,184,1852,2609
2,19/10/2022,0233-St. Thomas Mount,94660,121351,1307,3992,36295,0,0,136254,0,0,0,3000,6725,9725,3335,1250,4585,3308,956,4264,3296,28,161,4,0,2,111,1083,1389
1,20/10/2022,01ED-Wimco Nagar Depot Metro,80776,80467,200,936,24620,0,0,106532,0,0,0,0,250,250,2241,642,2883,1843,380,2223,1788,19,1,1,0,7,29,607,664
1,20/10/2022,01EF-Wimco Nagar Metro,128532,151432,220,2760,39068,0,0,170580,0,0,0,0,2000,2000,3828,1031,4859,3498,922,4420,3503,46,97,1,0,10,79,929,1162
1,20/10/2022,01F1-Thiruvotriyur Metro,114922,109852,0,1360,21870,0,0,138152,0,0,0,0,0,0,3174,612,3786,3025,520,3545,2946,41,0,3,0,5,46,569,664
1,20/10/2022,01F3-Thiruvotriyur Theradi Metro,103855,131263,1000,1584,27690,0,0,134129,0,0,0,0,0,0,3136,807,3943,3584,829,4413,3559,24,111,3,0,3,48,746,935
1,20/10/2022,01F5-Kaladipet Metro,110055,106142,0,1584,23030,0,0,134669,0,0,0,0,0,0,3186,718,3904,3216,684,3900,3118,17,2,3,1,1,46,673,743
1,20/10/2022,01F7-Tollgate Metro,67056,59363,0,544,15310,0,0,82910,0,0,0,0,0,0,1727,492,2219,1670,385,2055,1626,21,3,0,0,4,19,470,517
1,20/10/2022,01F9-New Washermenpet Metro,100297,105373,0,784,24988,0,0,126069,0,0,0,0,250,250,3166,821,3987,3279,815,4094,3225,24,52,1,0,2,32,786,897
1,20/10/2022,01FB-Tondiarpet Metro,88090,109513,1850,960,27996,0,0,118896,0,0,0,0,750,750,3136,930,4066,3310,754,4064,3223,14,1,2,0,5,32,887,941
1,20/10/2022,01FD-Thiagaraya College Metro,114549,144446,500,1712,41598,0,0,158359,0,0,0,0,2000,2000,4077,1427,5504,4324,1108,5432,4231,28,32,2,0,2,63,1343,1470
1,20/10/2022,0101-Washermanpet,128768,145263,500,2312,44120,0,0,175700,0,0,0,0,20250,20250,4367,1545,5912,3888,1497,5385,4083,30,341,2,0,8,99,1439,1919
1,20/10/2022,0103-Mannadi,94085,123917,200,1136,35958,0,0,131379,0,0,0,0,0,0,3359,1243,4602,3804,1109,4913,3737,19,76,1,0,4,47,1186,1333
1,20/10/2022,0105-High Court,138183,261026,2000,3208,77232,0,0,220623,0,0,0,0,0,0,7335,2729,10064,7470,2030,9500,7536,36,214,1,0,4,137,2550,2942
1,20/10/2022,0109-Government Estate,86973,171315,1300,1960,61852,0,0,152085,0,0,0,0,250,250,4252,2160,6412,4737,1670,6407,4794,30,281,2,0,5,89,2014,2421
1,20/10/2022,0111-LIC,82129,193832,2820,2624,40474,0,0,128047,0,0,0,0,2000,2000,5442,1430,6872,6251,1016,7267,6163,26,3,1,0,4,109,1288,1431
1,20/10/2022,0113-Thousand Lights,164330,288236,1200,6624,48012,0,0,220166,0,0,0,0,0,0,8888,1866,10754,9244,1603,10847,9600,37,435,0,0,9,277,1463,2221
1,20/10/2022,0115-AG-DMS,108922,162864,250,2424,29038,0,0,140634,0,0,0,0,1000,1000,5440,1039,6479,5043,792,5835,5264,19,240,0,0,1,94,887,1241
1,20/10/2022,0117-Teynampet,103578,163998,2000,2160,38022,0,0,145760,0,0,0,0,0,0,4919,1406,6325,5389,1012,6401,5270,23,0,1,0,2,93,1260,1379
1,20/10/2022,0119-Nandanam,87662,143763,750,3056,37494,0,0,128962,0,0,0,0,0,0,4172,1401,5573,4565,896,5461,4519,22,30,2,0,1,120,1230,1405
1,20/10/2022,0121-Saidapet,40182,96678,150,1408,34324,0,0,76064,0,0,0,0,0,0,2174,1169,3343,2606,835,3441,2525,12,0,0,0,5,56,1104,1177
1,20/10/2022,0123-Little Mount,84212,113848,300,3120,33504,0,0,121136,0,0,0,0,1250,1250,3888,1261,5149,3013,738,3751,3282,24,306,1,0,4,131,1049,1515
1,20/10/2022,0125-Guindy,168140,311645,1000,7504,86744,0,0,263388,0,0,0,0,1500,1500,9108,3140,12248,7672,2564,10236,8716,33,1239,11,0,10,301,2663,4257
1,20/10/2022,0129-Nanganallur Road,49209,52612,0,952,13274,0,0,63435,0,0,0,0,0,0,1377,445,1822,1580,375,1955,1513,9,0,0,0,1,30,402,442
1,20/10/2022,0131-Meenambakkam,128222,159168,1550,3296,42712,0,0,175780,0,0,0,0,0,0,4471,1285,5756,3811,979,4790,3970,24,255,11,0,2,98,1168,1558
1,20/10/2022,0133-Chennai International Airport,180932,374068,550,12320,166490,0,0,360292,0,0,0,0,4500,4500,6237,4681,10918,7093,4091,11184,6751,61,787,20,0,6,317,4036,5227
2,20/10/2022,0201-Puratchi Thalaivar Dr. M.G. Ramachandran Central,317858,547120,4532,11880,138806,0,0,473076,0,0,0,0,5600,5600,15804,5028,20832,13182,8746,21928,16515,92,4618,12,0,14,496,4262,9494
2,20/10/2022,0203-Egmore,71028,147628,500,3136,57718,0,0,132382,0,0,0,0,8250,8250,2912,2128,5040,3930,3373,7303,3714,21,677,5,0,7,133,1927,2770
2,20/10/2022,0205-Nehru Park,39214,51806,100,840,16676,0,0,56830,0,0,0,0,2000,2000,1613,651,2264,1546,517,2063,1563,14,122,0,0,8,43,582,769
2,20/10/2022,0207-Kilpauk,43030,68270,100,1416,19824,0,0,64370,0,0,0,0,0,0,1961,811,2772,1997,704,2701,2032,9,150,0,0,13,66,696,934
2,20/10/2022,0209-Pachaiyappas College,53799,64093,0,1088,18230,0,0,73117,0,0,0,0,2000,2000,2107,724,2831,1945,548,2493,1951,11,117,2,0,12,45,655,842
2,20/10/2022,0211-Shenoy Nagar,49833,55052,0,840,13032,0,0,63705,0,0,0,0,500,500,1555,481,2036,1689,477,2166,1704,8,85,0,1,6,36,435,571
2,20/10/2022,0213-Anna Nagar East,86119,129756,300,2712,32882,0,0,122013,0,0,0,0,0,0,3826,1321,5147,3752,1007,4759,3856,20,259,0,0,0,116,1161,1556
2,20/10/2022,0215-Anna Nagar Tower,99355,122637,150,2184,32678,0,0,134367,0,0,0,0,0,0,3351,1186,4537,3331,879,4210,3473,20,302,2,0,1,74,1088,1487
2,20/10/2022,0217-Thirumangalam,266777,368374,820,10416,99462,0,0,377475,0,0,0,0,0,0,9826,3560,13386,9468,2818,12286,10010,56,1015,3,0,3,349,3080,4506
2,20/10/2022,0219-Koyambedu,208544,279893,400,4848,88902,0,0,302694,0,0,0,0,6500,6500,7261,3048,10309,6382,2461,8843,6983,54,1151,3,0,10,197,2750,4165
2,20/10/2022,0221-Puratchi Thalaivi Dr. J. Jayalalithaa CMBT,70042,203774,1954,3024,81458,0,0,156478,0,0,0,0,0,0,2972,2732,5704,6463,6715,13178,4928,25,615,4,0,5,113,2550,3312
2,20/10/2022,0223-Arumbakkam,43252,67959,1100,1208,25006,0,0,70566,0,0,0,0,1250,1250,1815,924,2739,1961,702,2663,1792,25,4,2,0,1,54,859,945
2,20/10/2022,0225-Vadapalani,125096,242898,1200,7176,82286,0,0,215758,0,0,0,0,3000,3000,5877,2914,8791,5979,2719,8698,6266,34,900,0,0,7,250,2570,3761
2,20/10/2022,0227-Ashok Nagar,109955,176393,1260,4184,54200,0,0,169599,0,0,0,0,0,0,4654,1968,6622,4411,1682,6093,4791,37,710,1,0,2,161,1696,2607
2,20/10/2022,0229-Ekkattuthangal,113746,177158,528,5264,39776,0,0,159314,0,0,0,0,250,250,5213,1527,6740,4521,1103,5624,5365,19,924,0,0,1,219,1170,2333
2,20/10/2022,0231-Arignar Anna Alandur,180248,234548,1000,6000,67450,0,0,254698,0,0,0,0,2750,2750,6675,2338,9013,5853,1755,7608,6431,73,843,9,0,7,203,1971,3106
2,20/10/2022,0233-St. Thomas Mount,83291,127532,1346,4272,47496,0,0,136405,0,0,0,0,10800,10800,3249,1609,4858,3269,993,4262,3142,26,82,0,0,2,112,1463,1685
1,21/10/2022,01ED-Wimco Nagar Depot Metro,90241,79734,0,1664,25922,0,0,117827,0,0,0,0,3500,3500,2178,685,2863,1778,342,2120,1696,18,72,2,0,2,48,640,782
1,21/10/2022,01EF-Wimco Nagar Metro,146367,157847,0,3336,22572,0,0,172275,0,0,0,0,1250,1250,4340,648,4988,3706,774,4480,4040,38,670,2,0,8,93,537,1348
1,21/10/2022,01F1-Thiruvotriyur Metro,110861,108819,100,2216,22940,0,0,136117,0,0,0,0,0,0,3132,673,3805,3053,455,3508,2893,31,22,1,0,2,64,611,731
1,21/10/2022,01F3-Thiruvotriyur Theradi Metro,104810,122779,100,1904,19118,0,0,125932,0,0,0,0,0,0,3381,579,3960,3517,654,4171,3516,26,334,6,0,5,64,516,951
1,21/10/2022,01F5-Kaladipet Metro,111626,105212,0,1104,20136,0,0,132866,0,0,0,0,0,0,3309,657,3966,3242,527,3769,3154,20,181,0,0,2,38,612,853
1,21/10/2022,01F7-Tollgate Metro,58621,57567,200,896,11354,0,0,71071,0,0,0,0,0,0,1785,365,2150,1744,304,2048,1691,16,104,0,0,2,26,341,489
1,21/10/2022,01F9-New Washermenpet Metro,99574,100801,0,1160,21120,0,0,121854,0,0,0,0,500,500,3170,737,3907,3310,612,3922,3174,20,129,2,0,4,44,698,897
1,21/10/2022,01FB-Tondiarpet Metro,90433,108344,450,1328,28746,0,0,120957,0,0,0,0,500,500,3086,946,4032,3467,618,4085,3162,24,20,2,0,3,42,901,992
1,21/10/2022,01FD-Thiagaraya College Metro,109425,137333,850,1480,34168,0,0,145923,0,0,0,0,1500,1500,4103,1213,5316,4417,872,5289,4194,33,169,5,0,2,59,1134,1402
1,21/10/2022,0101-Washermanpet,109118,151322,620,3200,47810,0,0,160748,0,0,0,0,14250,14250,4388,1686,6074,4118,1218,5336,4164,23,508,1,0,4,142,1529,2207
1,21/10/2022,0103-Mannadi,81812,126478,1550,1056,30622,0,0,115040,0,0,0,0,0,0,3697,1103,4800,4009,1034,5043,3985,20,486,0,0,3,44,1031,1584
1,21/10/2022,0105-High Court,141380,213925,250,2304,50646,0,0,194580,0,0,0,0,0,0,6380,1879,8259,6171,1500,7671,6626,25,868,0,0,8,109,1752,2762
1,21/10/2022,0109-Government Estate,104820,159281,2120,2320,43408,0,0,152668,0,0,0,0,3750,3750,4562,1569,6131,4802,1212,6014,4975,21,608,3,0,4,109,1428,2173
1,21/10/2022,0111-LIC,101933,197297,1400,2760,28554,0,0,134647,0,0,0,0,250,250,6067,1042,7109,6214,1036,7250,6624,31,636,0,0,6,111,914,1698
1,21/10/2022,0113-Thousand Lights,150597,288660,983,7344,42252,0,0,201176,0,0,0,0,0,0,9213,1685,10898,9051,1400,10451,9688,28,939,0,0,10,309,1332,2618
1,21/10/2022,0115-AG-DMS,111711,170892,250,2928,29668,0,0,144557,0,0,0,0,500,500,5794,1060,6854,5052,686,5738,5466,26,588,0,0,1,126,906,1647
1,21/10/2022,0117-Teynampet,100341,169918,232,3144,29776,0,0,133493,0,0,0,0,0,0,5446,1134,6580,5435,909,6344,5725,21,575,2,0,2,140,988,1728
1,21/10/2022,0119-Nandanam,102808,157346,650,3280,44364,0,0,151102,0,0,0,0,0,0,4502,1563,6065,4602,904,5506,4695,21,362,2,0,2,144,1411,1942
1,21/10/2022,0121-Saidapet,52749,87255,100,1664,24062,0,0,78575,0,0,0,0,9750,9750,2185,886,3071,2491,604,3095,2486,19,251,1,0,2,68,804,1145
1,21/10/2022,0123-Little Mount,86845,118980,337,4152,32798,0,0,124132,0,0,0,0,0,0,4066,1273,5339,2981,571,3552,3395,25,581,0,0,2,166,1097,1871
1,21/10/2022,0125-Guindy,223959,365690,130,11192,66682,0,0,301963,0,0,0,0,1500,1500,11511,2631,14142,8026,1949,9975,11173,30,3844,4,0,9,441,1986,6314
1,21/10/2022,0129-Nanganallur Road,39653,48674,0,904,14854,0,0,55411,0,0,0,0,0,0,1286,486,1772,1460,291,1751,1305,15,0,0,0,0,34,446,495
1,21/10/2022,0131-Meenambakkam,142916,168892,1204,3520,42472,0,0,190112,0,0,0,0,0,0,4819,1304,6123,4038,898,4936,4277,32,732,5,0,3,117,1176,2065
1,21/10/2022,0133-Chennai International Airport,263348,435797,1500,12576,139618,0,0,417042,0,0,0,0,6000,6000,8545,4032,12577,8398,3408,11806,9028,92,3044,13,0,6,402,3333,6890
2,21/10/2022,0201-Puratchi Thalaivar Dr. M.G. Ramachandran Central,398893,657913,200,18368,120352,0,0,537813,0,0,0,0,5200,5200,18426,4615,23041,18946,8529,27475,20910,89,7457,14,0,15,730,3458,11763
2,21/10/2022,0203-Egmore,102784,170863,300,2968,40796,0,0,146848,0,0,0,0,4750,4750,3918,1481,5399,5804,2633,8437,5136,21,1692,12,0,4,125,1320,3174
2,21/10/2022,0205-Nehru Park,48367,57594,0,1688,15000,0,0,65055,0,0,0,0,4000,4000,1817,599,2416,1747,424,2171,1805,8,312,2,0,2,73,518,915
2,21/10/2022,0207-Kilpauk,42768,73558,100,1336,20530,0,0,64734,0,0,0,0,0,0,2181,794,2975,1976,556,2532,2136,14,349,0,0,7,60,719,1149
2,21/10/2022,0209-Pachaiyappas College,52601,63463,150,848,14938,0,0,68537,0,0,0,0,6000,6000,2218,581,2799,1928,465,2393,2024,10,334,3,0,9,41,534,931
2,21/10/2022,0211-Shenoy Nagar,49553,60385,0,1344,14658,0,0,65555,0,0,0,0,4000,4000,1686,546,2232,1778,377,2155,1833,19,250,0,0,3,56,487,815
2,21/10/2022,0213-Anna Nagar East,97172,125548,13,2296,31226,0,0,130707,0,0,0,0,0,0,3719,1187,4906,3565,766,4331,3696,19,492,1,0,2,98,1058,1670
2,21/10/2022,0215-Anna Nagar Tower,103633,119504,250,2384,21588,0,0,127855,0,0,0,0,1250,1250,3660,849,4509,3367,693,4060,3705,20,708,0,0,0,95,729,1552
2,21/10/2022,0217-Thirumangalam,290727,383407,805,10616,93938,0,0,396086,0,0,0,0,1500,1500,10689,3417,14106,10091,2361,12452,10589,71,1990,8,0,5,421,2909,5404
2,21/10/2022,0219-Koyambedu,246634,309405,220,6864,61908,0,0,315626,0,0,0,0,12750,12750,8850,2333,11183,8142,2445,10587,9025,57,3271,8,0,14,306,1939,5595
2,21/10/2022,0221-Puratchi Thalaivi Dr. J. Jayalalithaa CMBT,114453,272526,1980,3640,64956,0,0,185029,0,0,0,0,0,0,4596,2246,6842,13765,6169,19934,7961,21,2245,2,0,2,160,1987,4417
2,21/10/2022,0223-Arumbakkam,59182,72238,100,2032,25458,0,0,86772,0,0,0,0,4000,4000,1990,952,2942,2176,589,2765,1908,19,183,1,0,3,67,874,1147
2,21/10/2022,0225-Vadapalani,176463,272458,352,8576,65226,0,0,250617,0,0,0,0,2500,2500,7445,2467,9912,6725,2255,8980,7845,33,2406,1,0,8,349,1977,4774
2,21/10/2022,0227-Ashok Nagar,143051,209974,1101,9320,37916,0,0,191388,0,0,0,0,0,0,6372,1596,7968,4971,1365,6336,6588,26,2422,3,0,1,334,1166,3952
2,21/10/2022,0229-Ekkattuthangal,146073,191232,1220,7240,28916,0,0,183449,0,0,0,0,1000,1000,6232,1202,7434,4226,821,5047,6070,22,2105,2,0,3,282,859,3273
2,21/10/2022,0231-Arignar Anna Alandur,176945,271610,1350,10496,83378,0,0,272169,0,0,0,0,3250,3250,7220,2963,10183,6089,1517,7606,7098,64,1691,3,0,4,350,2512,4624
2,21/10/2022,0233-St. Thomas Mount,117855,163605,1110,5008,46286,0,0,170259,0,0,0,6000,6200,12200,4365,1653,6018,3737,800,4537,4323,23,1225,3,0,8,198,1427,2884
1,22/10/2022,01ED-Wimco Nagar Depot Metro,57555,72453,250,1624,32816,0,0,92245,0,0,0,0,1250,1250,1654,815,2469,1290,422,1712,1241,11,44,10,0,8,47,791,911
1,22/10/2022,01EF-Wimco Nagar Metro,108004,139870,400,4152,45086,0,0,157642,0,0,0,0,2250,2250,3040,1150,4190,2433,1020,3453,2791,37,550,4,0,16,122,1055,1784
1,22/10/2022,01F1-Thiruvotriyur Metro,86689,98768,0,2168,36168,0,0,125025,0,0,0,0,0,0,2320,538,2858,2245,601,2846,2117,32,0,3,0,10,63,903,1011
1,22/10/2022,01F3-Thiruvotriyur Theradi Metro,79951,116005,24,2880,38190,0,0,121045,0,0,0,0,0,0,2498,1105,3603,2695,944,3639,2667,22,185,0,0,2,97,998,1304
1,22/10/2022,01F5-Kaladipet Metro,78015,83675,0,1728,28938,0,0,108681,0,0,0,0,0,0,2150,874,3024,2169,611,2780,1999,13,0,1,0,4,61,814,893
1,22/10/2022,01F7-Tollgate Metro,47953,51274,150,1448,18922,0,0,68473,0,0,0,0,0,0,1240,584,1824,1257,383,1640,1169,22,0,0,0,6,44,524,596
1,22/10/2022,01F9-New Washermenpet Metro,74874,81217,400,1704,27608,0,0,104586,0,0,0,0,1000,1000,2258,904,3162,2198,649,2847,2126,19,84,2,0,4,58,836,1003
1,22/10/2022,01FB-Tondiarpet Metro,62875,84798,200,1296,32002,0,0,96373,0,0,0,0,250,250,2099,1017,3116,2265,679,2944,2068,16,0,2,0,3,46,963,1030
1,22/10/2022,01FD-Thiagaraya College Metro,95842,120710,200,3248,42000,0,0,141290,0,0,0,0,4500,4500,3118,1457,4575,3116,1060,4176,3119,39,226,0,0,4,110,1320,1699
1,22/10/2022,0101-Washermanpet,80309,124391,140,2576,62146,0,0,145171,0,0,0,0,12250,12250,2714,2047,4761,2663,1439,4102,2512,21,182,1,0,9,100,1934,2247
1,22/10/2022,0103-Mannadi,70525,101823,40,1680,37350,0,0,109595,0,0,0,0,0,0,2454,1284,3738,2644,1113,3757,2635,14,251,1,0,5,65,1188,1524
1,22/10/2022,0105-High Court,73443,165336,200,2960,72578,0,0,149181,0,0,0,0,0,0,3575,2481,6056,3830,1900,5730,3786,28,252,1,0,5,115,2298,2699
1,22/10/2022,0109-Government Estate,71388,137337,700,2680,53860,0,0,128628,0,0,0,0,2750,2750,3207,1966,5173,3663,1415,5078,3571,26,305,2,0,12,113,1765,2223
1,22/10/2022,0111-LIC,45784,94104,108,1984,34342,0,0,82218,0,0,0,0,250,250,2091,962,3053,2301,933,3234,2317,13,188,5,0,9,78,1053,1346
1,22/10/2022,0113-Thousand Lights,96334,162974,0,3992,41700,0,0,142026,0,0,0,0,0,0,4187,1512,5699,4496,1377,5873,4699,19,466,0,0,15,166,1254,1920
1,22/10/2022,0115-AG-DMS,45591,70806,0,1776,19644,0,0,67011,0,0,0,0,0,0,1795,675,2470,1721,507,2228,1930,10,292,0,0,0,70,582,954
1,22/10/2022,0117-Teynampet,68672,100842,0,1784,17696,0,0,88152,0,0,0,0,0,0,3059,683,3742,2805,783,3588,3226,13,567,0,0,7,73,574,1234
1,22/10/2022,0119-Nandanam,56394,75304,248,1704,30134,0,0,88480,0,0,0,0,2000,2000,1796,1029,2825,1861,594,2455,1781,22,103,4,0,5,69,933,1136
1,22/10/2022,0121-Saidapet,27710,52081,0,1856,25730,0,0,55296,0,0,0,0,0,0,845,923,1768,1163,562,1725,1006,9,0,2,0,0,71,834,916
1,22/10/2022,0123-Little Mount,45194,65088,150,2704,26942,0,0,74990,0,0,0,0,1000,1000,1548,988,2536,1336,530,1866,1478,21,219,2,0,1,102,845,1190
1,22/10/2022,0125-Guindy,126127,216803,600,5864,73364,0,0,205955,0,0,0,0,0,0,5017,2529,7546,3942,2154,6096,5148,31,1793,12,0,5,239,2196,4276
1,22/10/2022,0129-Nanganallur Road,33746,37724,1000,824,16208,0,0,51778,0,0,0,0,0,0,718,506,1224,950,318,1268,776,10,3,1,0,2,26,471,513
1,22/10/2022,0131-Meenambakkam,103063,136399,300,3248,45074,0,0,151685,0,0,0,0,0,0,3137,1322,4459,2640,1156,3796,2945,25,730,3,0,7,103,1207,2075
1,22/10/2022,0133-Chennai International Airport,199288,392713,240,13920,181432,0,0,394880,0,0,0,0,7000,7000,5640,5127,10767,6455,4380,10835,6385,62,2150,24,0,30,400,4267,6933
2,22/10/2022,0201-Puratchi Thalaivar Dr. M.G. Ramachandran Central,315735,505926,242,12648,137848,0,0,466473,0,0,0,0,8850,8850,12394,4932,17326,10074,7832,17906,13588,79,6094,15,0,25,503,4009,10725
2,22/10/2022,0203-Egmore,62633,134738,0,2952,58584,0,0,124169,0,0,0,0,6750,6750,2091,2061,4152,3846,2902,6748,3009,12,758,11,0,7,135,1890,2813
2,22/10/2022,0205-Nehru Park,29380,49169,100,1544,22290,0,0,53314,0,0,0,0,0,0,1143,810,1953,1085,531,1616,1104,10,142,0,0,10,61,738,961
2,22/10/2022,0207-Kilpauk,26515,49639,0,1384,18860,0,0,46759,0,0,0,0,0,0,1206,688,1894,1169,523,1692,1192,10,168,0,0,2,53,624,857
2,22/10/2022,0209-Pachaiyappas College,32160,41402,0,456,15456,0,0,48072,0,0,0,0,2500,2500,1197,565,1762,1164,387,1551,1085,11,91,5,0,4,26,534,671
2,22/10/2022,0211-Shenoy Nagar,28864,37728,550,864,13884,0,0,44162,0,0,0,0,0,0,972,503,1475,995,363,1358,973,7,104,0,0,2,38,463,614
2,22/10/2022,0213-Anna Nagar East,70110,94756,100,1832,33190,0,0,105232,0,0,0,0,3000,3000,2366,1183,3549,2327,790,3117,2342,19,403,1,0,2,82,1078,1585
2,22/10/2022,0215-Anna Nagar Tower,58663,92000,750,2344,32364,0,0,94121,0,0,0,0,1250,1250,2212,1143,3355,2140,842,2982,2221,11,390,1,0,1,72,1048,1523
2,22/10/2022,0217-Thirumangalam,193546,293146,300,10696,113202,0,0,317744,0,0,0,0,0,0,6361,3938,10299,5931,2746,8677,6478,54,1524,10,0,5,404,3405,5402
2,22/10/2022,0219-Koyambedu,149005,219302,300,6072,77426,0,0,232803,0,0,0,0,4000,4000,4989,2810,7799,4526,2745,7271,5146,45,1873,12,0,15,243,2396,4584
2,22/10/2022,0221-Puratchi Thalaivi Dr. J. Jayalalithaa CMBT,78285,220688,230,3496,85336,0,0,167347,0,0,0,0,0,0,2930,2875,5805,8535,6563,15098,5118,29,1403,9,0,3,152,2633,4229
2,22/10/2022,0223-Arumbakkam,38987,57663,0,1608,30532,0,0,71127,0,0,0,0,6000,6000,1206,1159,2365,1396,636,2032,1118,13,7,0,0,7,66,1075,1168
2,22/10/2022,0225-Vadapalani,166860,252978,332,9584,67412,0,0,244188,0,0,0,0,4500,4500,6493,2603,9096,5103,3248,8351,6865,53,2915,2,0,12,387,1937,5306
2,22/10/2022,0227-Ashok Nagar,111583,157198,302,5272,39716,0,0,156873,0,0,0,0,500,500,4364,1557,5921,3091,1595,4686,4421,36,2005,2,0,1,203,1220,3467
2,22/10/2022,0229-Ekkattuthangal,70345,95099,300,3248,28736,0,0,102629,0,0,0,0,2000,2000,2547,1044,3591,1729,620,2349,2451,13,922,1,0,5,129,874,1944
2,22/10/2022,0231-Arignar Anna Alandur,127938,187177,732,5576,78672,0,0,212918,0,0,0,0,1750,1750,4060,2669,6729,3620,1836,5456,3940,61,1086,7,0,12,200,2316,3682
2,22/10/2022,0233-St. Thomas Mount,103202,136298,100,5152,43668,0,0,152122,0,0,0,6000,7575,13575,3171,1539,4710,2574,1104,3678,3256,27,1273,4,0,16,187,1274,2781
1,23/10/2022,01ED-Wimco Nagar Depot Metro,41946,53373,0,2032,27962,0,0,71940,0,0,0,0,250,250,897,705,1602,838,432,1270,798,17,0,6,0,10,53,688,774
1,23/10/2022,01EF-Wimco Nagar Metro,65249,76956,0,1496,29182,0,0,95927,0,0,0,0,0,0,1461,755,2216,1239,899,2138,1393,31,242,0,0,27,40,708,1048
1,23/10/2022,01F1-Thiruvotriyur Metro,54632,63184,0,1208,28406,0,0,84246,0,0,0,0,0,0,1274,742,2016,1190,614,1804,1137,33,0,2,0,11,38,721,805
1,23/10/2022,01F3-Thiruvotriyur Theradi Metro,44862,76771,0,2264,33928,0,0,81054,0,0,0,0,0,0,1336,974,2310,1472,935,2407,1463,19,95,0,0,15,62,887,1078
1,23/10/2022,01F5-Kaladipet Metro,41140,53318,0,1944,25178,0,0,68262,0,0,0,0,0,0,1035,782,1817,1104,654,1758,1022,15,0,0,0,3,56,724,798
1,23/10/2022,01F7-Tollgate Metro,21764,36644,0,736,19404,0,0,41904,0,0,0,0,0,0,684,587,1271,713,474,1187,643,9,1,0,0,9,25,544,588
1,23/10/2022,01F9-New Washermenpet Metro,39782,55015,200,1344,25154,0,0,66480,0,0,0,0,0,0,1170,828,1998,1081,700,1781,1143,5,124,0,0,9,39,792,969
1,23/10/2022,01FB-Tondiarpet Metro,37522,57333,100,968,28762,0,0,67352,0,0,0,0,0,0,1059,896,1955,1207,686,1893,1093,15,14,1,0,7,32,854,923
1,23/10/2022,01FD-Thiagaraya College Metro,45368,82064,0,1968,41400,0,0,88736,0,0,0,0,1250,1250,1606,1405,3011,1689,925,2614,1629,13,36,0,0,8,73,1321,1451
1,23/10/2022,0101-Washermanpet,51216,78168,200,1392,44914,0,0,97722,0,0,0,0,12250,12250,1260,1454,2714,1246,1388,2634,1234,18,179,6,0,10,52,1387,1652
1,23/10/2022,0103-Mannadi,40159,58504,0,920,29342,0,0,70421,0,0,0,0,0,0,1097,1002,2099,1140,923,2063,1153,16,185,0,0,6,39,951,1197
1,23/10/2022,0105-High Court,33482,70821,200,840,34592,0,0,69114,0,0,0,0,0,0,1347,1243,2590,1485,1175,2660,1485,13,144,3,0,5,44,1179,1388
1,23/10/2022,0109-Government Estate,31958,75039,0,1832,39816,0,0,73606,0,0,0,0,2750,2750,1253,1436,2689,1491,965,2456,1426,11,98,0,0,11,72,1328,1520
1,23/10/2022,0111-LIC,14027,52451,0,1424,27302,0,0,42753,0,0,0,0,2250,2250,844,732,1576,1083,751,1834,976,9,0,0,0,8,50,842,909
1,23/10/2022,0113-Thousand Lights,19690,62515,0,2168,31384,0,0,53242,0,0,0,0,0,0,1063,1098,2161,1365,943,2308,1188,7,1,0,0,13,77,975,1073
1,23/10/2022,0115-AG-DMS,17613,31317,0,648,13004,0,0,31265,0,0,0,0,0,0,624,425,1049,597,355,952,660,1,144,0,0,1,23,374,543
1,23/10/2022,0117-Teynampet,17688,32494,100,912,16232,0,0,34932,0,0,0,0,0,0,603,574,1177,723,541,1264,645,8,0,0,0,6,39,509,562
1,23/10/2022,0119-Nandanam,19210,33568,0,760,19016,0,0,38986,0,0,0,0,3000,3000,567,710,1277,651,456,1107,570,13,0,4,0,5,29,665,716
1,23/10/2022,0121-Saidapet,19616,33014,0,800,20480,0,0,40896,0,0,0,0,5250,5250,427,676,1103,576,529,1105,464,7,1,0,0,5,28,645,686
1,23/10/2022,0123-Little Mount,24155,36048,0,928,17164,0,0,42247,0,0,0,0,0,0,786,599,1385,666,431,1097,702,10,151,0,0,4,28,545,738
1,23/10/2022,0125-Guindy,50457,106835,0,2896,50858,0,0,104211,0,0,0,0,0,0,1802,1630,3432,1659,1622,3281,1947,14,576,3,0,12,102,1443,2150
1,23/10/2022,0129-Nanganallur Road,9550,18402,0,696,9618,0,0,19864,0,0,0,0,0,0,261,306,567,384,252,636,319,3,0,0,0,3,24,279,309
1,23/10/2022,0131-Meenambakkam,36330,62794,0,1624,30346,0,0,68300,0,0,0,0,0,0,1043,828,1871,877,798,1675,1009,10,303,4,0,1,48,781,1147
1,23/10/2022,0133-Chennai International Airport,93194,254466,0,6624,150516,0,0,250334,0,0,0,0,2500,2500,2789,4044,6833,3417,3494,6911,3171,33,983,15,0,27,196,3655,4909
2,23/10/2022,0201-Puratchi Thalaivar Dr. M.G. Ramachandran Central,173122,307769,100,5880,119794,0,0,298896,0,0,0,0,5100,5100,5993,4179,10172,4319,5812,10131,6564,42,3568,18,0,23,256,3722,7629
2,23/10/2022,0203-Egmore,43208,80062,0,1936,41608,0,0,86752,0,0,0,0,12250,12250,1064,1484,2548,1702,2119,3821,1465,7,416,3,0,8,65,1380,1879
2,23/10/2022,0205-Nehru Park,19276,31385,0,960,15014,0,0,35250,0,0,0,0,2000,2000,617,530,1147,594,452,1046,630,10,120,0,0,8,27,464,629
2,23/10/2022,0207-Kilpauk,11509,23355,0,312,10616,0,0,22437,0,0,0,0,0,0,453,358,811,463,314,777,469,7,73,0,0,8,13,340,441
2,23/10/2022,0209-Pachaiyappas College,19956,24936,0,280,11042,0,0,31278,0,0,0,0,8500,8500,534,401,935,551,318,869,542,7,70,1,0,7,12,387,484
2,23/10/2022,0211-Shenoy Nagar,14690,23042,0,432,9974,0,0,25096,0,0,0,0,0,0,506,345,851,448,284,732,485,3,103,0,0,3,18,315,442
2,23/10/2022,0213-Anna Nagar East,37018,50605,0,1192,21552,0,0,59762,0,0,0,0,3000,3000,1019,741,1760,1021,559,1580,1088,8,198,0,0,3,49,684,942
2,23/10/2022,0215-Anna Nagar Tower,28589,47904,0,840,20748,0,0,50177,0,0,0,0,0,0,1000,715,1715,1000,585,1585,992,16,151,0,0,4,36,668,875
2,23/10/2022,0217-Thirumangalam,96199,158288,0,5576,71436,0,0,173211,0,0,0,0,0,0,2990,2362,5352,2573,2176,4749,3048,34,918,3,1,9,203,2106,3274
2,23/10/2022,0219-Koyambedu,82246,121476,500,2944,54562,0,0,140252,0,0,0,0,4750,4750,2361,1818,4179,1806,1588,3394,2329,31,990,4,0,7,108,1666,2806
2,23/10/2022,0221-Puratchi Thalaivi Dr. J. Jayalalithaa CMBT,35507,100199,50,1512,56952,0,0,94021,0,0,0,0,0,0,1117,1831,2948,1893,2810,4703,1576,14,470,4,0,1,63,1738,2290
2,23/10/2022,0223-Arumbakkam,17336,27802,0,432,18106,0,0,35874,0,0,0,0,2000,2000,441,661,1102,555,473,1028,413,5,0,1,0,3,20,627,656
2,23/10/2022,0225-Vadapalani,96334,165043,30,5856,62184,0,0,164404,0,0,0,0,3000,3000,3346,2263,5609,2942,2552,5494,3653,32,1357,2,0,29,221,1909,3550
2,23/10/2022,0227-Ashok Nagar,36018,71904,250,2096,38194,0,0,76558,0,0,0,0,3000,3000,1252,1351,2603,1285,1125,2410,1290,26,303,3,0,6,89,1222,1649
2,23/10/2022,0229-Ekkattuthangal,23174,34648,100,1072,13830,0,0,38176,0,0,0,0,0,0,787,475,1262,650,399,1049,779,12,242,2,0,7,42,420,725
2,23/10/2022,0231-Arignar Anna Alandur,61585,97461,20,3424,47368,0,0,112397,0,0,0,0,0,0,1707,1531,3238,1603,1236,2839,1758,28,517,14,0,9,102,1320,1990
2,23/10/2022,0233-St. Thomas Mount,38140,62669,0,2120,31460,0,0,71720,0,0,0,0,2000,2000,996,1005,2001,1056,906,1962,1080,16,315,2,0,11,72,910,1326
1,24/10/2022,01ED-Wimco Nagar Depot Metro,30733,53531,0,912,29380,0,0,61025,0,0,0,0,0,0,739,720,1459,813,494,1307,742,7,0,0,0,24,31,706,768
1,24/10/2022,01EF-Wimco Nagar Metro,45890,63790,0,1496,27692,0,0,75078,0,0,0,0,2000,2000,1115,708,1823,1111,750,1861,1084,10,149,17,0,25,42,670,913
1,24/10/2022,01F1-Thiruvotriyur Metro,37329,54710,0,2048,26652,0,0,66029,0,0,0,0,0,0,926,742,1668,926,654,1580,892,11,2,5,0,20,56,695,789
1,24/10/2022,01F3-Thiruvotriyur Theradi Metro,36586,62622,0,2224,28232,0,0,67042,0,0,0,0,0,0,1055,840,1895,1074,897,1971,1165,10,127,10,0,6,72,764,989
1,24/10/2022,01F5-Kaladipet Metro,25047,47032,0,1272,24614,0,0,50933,0,0,0,0,0,0,801,741,1542,902,670,1572,831,9,0,0,0,7,44,689,749
1,24/10/2022,01F7-Tollgate Metro,17484,29611,0,664,16514,0,0,34662,0,0,0,0,0,0,524,509,1033,538,357,895,487,12,0,1,0,16,17,476,522
1,24/10/2022,01F9-New Washermenpet Metro,28722,50241,0,2040,22936,0,0,53698,0,0,0,0,0,0,951,776,1727,1062,668,1730,1015,9,71,0,0,18,54,719,871
1,24/10/2022,01FB-Tondiarpet Metro,26283,46874,200,824,26000,0,0,53307,0,0,0,0,0,0,764,811,1575,838,691,1529,780,13,0,2,0,11,23,784,833
1,24/10/2022,01FD-Thiagaraya College Metro,31063,58005,0,1816,30556,0,0,63435,0,0,0,0,500,500,1032,1061,2093,1094,831,1925,1088,11,31,0,0,9,64,980,1095
1,24/10/2022,0101-Washermanpet,37390,62960,0,1424,38746,0,0,77560,0,0,0,0,8000,8000,979,1306,2285,1028,1010,2038,961,9,82,0,0,12,50,1253,1406
1,24/10/2022,0103-Mannadi,33384,46271,120,912,25376,0,0,59792,0,0,0,0,0,0,742,863,1605,866,931,1797,849,17,79,2,0,5,32,825,960
1,24/10/2022,0105-High Court,28882,62406,0,928,33746,0,0,63556,0,0,0,0,0,0,1099,1201,2300,1145,914,2059,1179,8,147,0,0,14,33,1151,1353
1,24/10/2022,0109-Government Estate,33259,74454,100,1568,38698,0,0,73625,20,0,20,0,250,250,1350,1392,2742,1342,1126,2468,1419,10,276,5,0,13,50,1319,1673
1,24/10/2022,0111-LIC,14528,44594,0,768,23364,0,0,38660,0,0,0,0,0,0,666,761,1427,923,579,1502,834,2,0,0,0,20,36,721,779
1,24/10/2022,0113-Thousand Lights,19659,43703,0,560,21934,0,0,42153,0,0,0,0,0,0,668,740,1408,1010,674,1684,822,7,0,0,0,11,21,687,726
1,24/10/2022,0115-AG-DMS,13714,25480,0,776,10734,0,0,25224,0,0,0,0,0,0,487,369,856,467,320,787,540,3,141,2,0,3,24,310,483
1,24/10/2022,0117-Teynampet,14800,24305,0,856,11642,0,0,27298,0,0,0,0,0,0,414,412,826,530,431,961,489,6,20,1,0,7,25,381,440
1,24/10/2022,0119-Nandanam,13752,28635,0,584,15120,0,0,29456,0,0,0,0,2000,2000,444,540,984,609,404,1013,542,6,0,4,0,5,22,508,545
1,24/10/2022,0121-Saidapet,5700,22180,0,608,13416,0,0,19724,0,0,0,0,2000,2000,248,445,693,373,486,859,329,6,0,0,0,0,25,417,448
1,24/10/2022,0123-Little Mount,18749,27965,0,1248,11980,0,0,31977,0,0,0,0,0,0,543,410,953,554,363,917,577,3,113,5,0,13,37,371,542
1,24/10/2022,0125-Guindy,46338,91124,200,2912,40500,0,0,89950,0,0,0,0,0,0,1612,1278,2890,1309,1484,2793,1709,13,648,2,0,11,107,1173,1954
1,24/10/2022,0129-Nanganallur Road,8729,12823,0,56,7422,0,0,16207,0,0,0,0,0,0,163,208,371,226,177,403,183,2,0,0,0,2,2,194,200
1,24/10/2022,0131-Meenambakkam,29093,51731,0,1656,22674,0,0,53423,0,0,0,0,0,0,854,640,1494,657,645,1302,871,10,301,3,0,9,54,582,959
1,24/10/2022,0133-Chennai International Airport,75826,212061,0,6288,125974,0,0,208088,0,0,0,0,750,750,2358,3430,5788,2467,3021,5488,2630,27,836,23,0,22,178,3125,4211
2,24/10/2022,0201-Puratchi Thalaivar Dr. M.G. Ramachandran Central,142679,281607,300,6288,138614,0,0,287881,0,0,0,0,2100,2100,5114,4662,9776,3153,5667,8820,5084,35,2974,47,0,13,250,4306,7625
2,24/10/2022,0203-Egmore,33915,66619,0,1800,39264,0,0,74979,0,0,0,0,8250,8250,968,1450,2418,1211,1685,2896,1096,8,351,2,0,11,69,1346,1787
2,24/10/2022,0205-Nehru Park,9887,22858,0,1056,12054,0,0,22997,0,0,0,0,0,0,440,475,915,389,385,774,432,11,92,0,0,9,40,428,580
2,24/10/2022,0207-Kilpauk,8317,20241,0,416,9614,0,0,18347,0,0,0,0,0,0,410,318,728,420,306,726,427,3,60,0,0,8,13,307,391
2,24/10/2022,0209-Pachaiyappas College,13044,14676,0,184,7436,0,0,20664,0,0,0,0,4000,4000,286,271,557,296,255,551,304,6,64,0,0,3,10,252,335
2,24/10/2022,0211-Shenoy Nagar,17504,19523,50,216,8118,0,0,25888,0,0,0,0,2000,2000,450,283,733,484,271,755,450,6,70,0,0,17,9,271,373
2,24/10/2022,0213-Anna Nagar East,14843,32442,0,872,16064,0,0,31779,0,0,0,0,0,0,566,544,1110,613,477,1090,617,8,90,0,0,6,31,495,630
2,24/10/2022,0215-Anna Nagar Tower,19411,31391,0,1000,13280,0,0,33691,0,0,0,0,0,0,618,467,1085,648,403,1051,658,5,140,4,0,8,29,422,608
2,24/10/2022,0217-Thirumangalam,60894,120342,0,3640,61658,0,0,126192,0,0,0,0,0,0,1964,2020,3984,2046,1718,3764,2091,14,460,23,0,17,124,1837,2475
2,24/10/2022,0219-Koyambedu,52836,99232,0,4712,53518,0,0,111066,0,0,0,0,2750,2750,1568,1803,3371,1382,1527,2909,1573,20,581,7,0,11,108,1646,2373
2,24/10/2022,0221-Puratchi Thalaivi Dr. J. Jayalalithaa CMBT,27871,84272,100,1344,52546,0,0,81861,0,0,0,0,0,0,995,1671,2666,1062,1780,2842,1130,9,506,11,0,4,60,1598,2188
2,24/10/2022,0223-Arumbakkam,12970,22227,0,672,12916,0,0,26558,0,0,0,0,4000,4000,341,511,852,520,453,973,380,2,0,3,0,7,28,479,519
2,24/10/2022,0225-Vadapalani,61421,142577,0,4160,73360,0,0,138941,0,0,0,0,2000,2000,2282,2529,4811,2195,2455,4650,2500,15,770,8,0,35,167,2284,3279
2,24/10/2022,0227-Ashok Nagar,33014,56058,0,1552,31134,0,0,65700,0,0,0,0,0,0,830,1079,1909,846,984,1830,917,5,267,2,0,4,56,991,1325
2,24/10/2022,0229-Ekkattuthangal,17358,30260,0,976,12754,0,0,31088,0,0,0,0,0,0,579,438,1017,609,444,1053,671,8,217,0,0,7,39,394,665
2,24/10/2022,0231-Arignar Anna Alandur,43050,80299,0,2536,41144,0,0,86730,0,0,0,0,0,0,1248,1293,2541,1212,1188,2400,1348,17,352,4,0,18,87,1162,1640
2,24/10/2022,0233-St. Thomas Mount,20669,40917,0,1640,20802,0,0,43111,0,0,0,0,0,0,667,697,1364,721,761,1482,730,12,175,6,0,12,55,626,886
1,25/10/2022,01ED-Wimco Nagar Depot Metro,60404,67060,200,1672,29276,0,0,91552,0,0,0,0,4750,4750,1301,731,2032,1163,384,1547,1148,13,0,0,0,21,47,694,775
1,25/10/2022,01EF-Wimco Nagar Metro,107087,107733,0,2376,27442,0,0,136905,0,0,0,0,0,0,2480,715,3195,2163,814,2977,2394,36,309,2,0,30,71,655,1103
1,25/10/2022,01F1-Thiruvotriyur Metro,79578,79587,0,1000,28998,0,0,109576,0,0,0,0,0,0,1621,762,2383,1727,596,2323,1657,20,0,1,0,6,29,737,793
1,25/10/2022,01F3-Thiruvotriyur Theradi Metro,74639,85684,0,2424,28746,0,0,105809,0,0,0,0,0,0,1720,843,2563,1881,861,2742,1920,14,76,1,0,10,72,750,923
1,25/10/2022,01F5-Kaladipet Metro,77615,68413,200,2480,23532,0,0,103827,0,0,0,0,0,0,1604,734,2338,1664,649,2313,1615,3,0,1,0,9,62,669,744
1,25/10/2022,01F7-Tollgate Metro,41347,43170,0,1208,14844,0,0,57399,0,0,0,0,0,0,1020,479,1499,1017,372,1389,1004,5,0,0,0,12,36,433,486
1,25/10/2022,01F9-New Washermenpet Metro,65284,67744,0,1112,20692,0,0,87088,0,0,0,0,750,750,1707,672,2379,1752,658,2410,1775,10,95,0,0,10,45,612,772
1,25/10/2022,01FB-Tondiarpet Metro,56725,65653,0,1160,25594,0,0,83479,0,0,0,0,2250,2250,1582,812,2394,1622,810,2432,1554,12,1,1,0,4,31,769,818
1,25/10/2022,01FD-Thiagaraya College Metro,71639,84245,0,1840,29854,0,0,103333,0,0,0,0,250,250,2062,1012,3074,2104,841,2945,2102,17,86,1,0,20,65,924,1113
1,25/10/2022,0101-Washermanpet,66900,87414,0,744,37572,0,0,105216,0,0,0,0,4750,4750,2095,1231,3326,1993,1082,3075,1965,13,104,0,0,15,31,1181,1344
1,25/10/2022,0103-Mannadi,53732,69787,0,1592,27526,0,0,82850,0,0,0,0,3000,3000,1595,934,2529,1746,966,2712,1751,16,79,1,0,5,49,896,1046
1,25/10/2022,0105-High Court,75019,122029,0,1464,43794,0,0,120277,0,0,0,0,0,0,2969,1554,4523,3085,1216,4301,3145,15,157,1,0,10,62,1468,1713
1,25/10/2022,0109-Government Estate,64595,102483,0,1960,42492,0,0,109047,0,0,0,0,4250,4250,2219,1508,3727,2525,1403,3928,2553,14,140,0,0,12,86,1391,1643
1,25/10/2022,0111-LIC,66146,104517,200,1424,23548,0,0,91318,0,0,0,0,0,0,2776,802,3578,3329,764,4093,3228,5,0,2,0,11,41,727,786
1,25/10/2022,0113-Thousand Lights,104607,146244,0,2592,27962,0,0,135161,0,0,0,0,0,0,4002,1021,5023,4768,1181,5949,4679,13,3,0,0,3,106,878,1003
1,25/10/2022,0115-AG-DMS,67745,67663,500,1240,12220,0,0,81705,0,0,0,0,2250,2250,1914,436,2350,2109,464,2573,2159,8,86,1,0,3,43,374,515
1,25/10/2022,0117-Teynampet,56638,65132,1200,624,16718,0,0,75180,0,0,0,0,2000,2000,1732,611,2343,2152,663,2815,2032,20,1,0,0,4,28,564,617
1,25/10/2022,0119-Nandanam,57581,72430,0,856,16356,0,0,74793,0,0,0,0,0,0,2003,601,2604,2426,681,3107,2337,6,0,0,0,7,36,544,593
1,25/10/2022,0121-Saidapet,26156,39170,0,624,14658,0,0,41438,0,0,0,0,2500,2500,827,504,1331,1051,530,1581,994,8,0,0,0,1,22,471,502
1,25/10/2022,0123-Little Mount,62364,51832,0,760,16494,0,0,79618,0,0,0,0,1000,1000,1449,562,2011,1386,542,1928,1377,6,96,6,0,2,31,510,651
1,25/10/2022,0125-Guindy,102343,153030,1600,3400,55590,0,0,162933,0,0,0,0,0,0,3934,1885,5819,3904,1727,5631,3814,34,204,8,0,9,140,1677,2072
1,25/10/2022,0129-Nanganallur Road,33997,30677,0,528,9656,0,0,44181,0,0,0,0,0,0,713,287,1000,823,206,1029,777,5,0,4,0,3,17,269,298
1,25/10/2022,0131-Meenambakkam,97309,98276,100,2512,33880,0,0,133801,0,0,0,0,0,0,2349,958,3307,1945,722,2667,2123,14,268,12,0,6,74,889,1263
1,25/10/2022,0133-Chennai International Airport,136514,276494,200,7464,146742,0,0,290920,0,0,0,0,4500,4500,4039,4029,8068,4025,3394,7419,4077,50,726,19,0,30,226,3569,4620
2,25/10/2022,0201-Puratchi Thalaivar Dr. M.G. Ramachandran Central,238300,365227,600,12456,134686,0,0,386042,0,0,0,0,3300,3300,9922,4938,14860,6211,5716,11927,8898,73,3298,23,0,23,511,4181,8109
2,25/10/2022,0203-Egmore,68305,103957,0,4576,52024,0,0,124905,0,0,0,0,10750,10750,1987,1927,3914,1917,2132,4049,2025,20,552,4,0,5,175,1690,2446
2,25/10/2022,0205-Nehru Park,34577,35732,0,664,13122,0,0,48363,0,0,0,0,250,250,853,497,1350,882,426,1308,899,8,88,0,0,12,26,457,591
2,25/10/2022,0207-Kilpauk,28333,38312,0,696,14188,0,0,43217,0,0,0,0,0,0,816,494,1310,967,477,1444,968,11,67,0,0,4,29,457,568
2,25/10/2022,0209-Pachaiyappas College,26760,23694,0,312,7856,0,0,34928,0,0,0,0,6500,6500,602,287,889,701,267,968,656,5,35,1,0,0,12,274,327
2,25/10/2022,0211-Shenoy Nagar,32636,27582,0,536,8614,0,0,41786,0,0,0,0,4000,4000,658,304,962,776,318,1094,764,10,68,0,0,1,21,277,377
2,25/10/2022,0213-Anna Nagar East,58921,59077,0,928,18452,0,0,78301,0,0,0,0,3000,3000,1424,624,2048,1599,599,2198,1539,15,132,0,0,4,38,578,767
2,25/10/2022,0215-Anna Nagar Tower,52646,48988,0,664,8796,0,0,62106,0,0,0,0,750,750,1330,309,1639,1371,516,1887,1526,9,255,6,0,0,25,282,577
2,25/10/2022,0217-Thirumangalam,164420,201464,100,4584,70096,0,0,239200,0,0,0,0,0,0,4459,2277,6736,4749,2334,7083,4779,42,442,3,0,21,151,2068,2727
2,25/10/2022,0219-Koyambedu,116461,147324,200,3664,66604,0,0,186929,0,0,0,0,9750,9750,3098,2265,5363,2702,1744,4446,2897,18,590,6,0,14,149,2076,2853
2,25/10/2022,0221-Puratchi Thalaivi Dr. J. Jayalalithaa CMBT,75823,150309,200,3944,75526,0,0,155493,0,0,0,0,0,0,2683,2500,5183,2039,2535,4574,2668,31,1009,4,0,8,160,2285,3497
2,25/10/2022,0223-Arumbakkam,33468,37724,0,704,17646,0,0,51818,0,0,0,0,6500,6500,742,625,1367,881,460,1341,804,7,0,7,0,2,28,589,633
2,25/10/2022,0225-Vadapalani,93654,157864,0,5128,60728,0,0,159510,0,0,0,0,500,500,3064,2148,5212,3148,2325,5473,3491,39,785,0,0,24,191,1879,2918
2,25/10/2022,0227-Ashok Nagar,56313,90857,880,1912,36376,0,0,95481,0,0,0,0,0,0,1751,1235,2986,2104,1248,3352,2057,15,238,4,0,10,82,1099,1448
2,25/10/2022,0229-Ekkattuthangal,55551,63959,1260,1336,13388,0,0,71535,0,0,0,0,250,250,1614,487,2101,2000,661,2661,1946,10,165,0,0,2,51,423,651
2,25/10/2022,0231-Arignar Anna Alandur,113578,124118,200,3472,47050,0,0,164300,0,0,0,0,2750,2750,2829,1557,4386,2796,1312,4108,2889,30,350,11,0,10,110,1356,1867
2,25/10/2022,0233-St. Thomas Mount,64583,68308,0,2584,27858,0,0,95025,0,0,0,12400,7500,19900,1465,947,2412,1575,782,2357,1534,28,125,3,0,8,86,841,1091
1,26/10/2022,01ED-Wimco Nagar Depot Metro,93276,76261,0,1008,25284,0,0,119568,0,0,0,0,4000,4000,2043,639,2682,1680,431,2111,1613,9,1,1,0,8,29,610,658
1,26/10/2022,01EF-Wimco Nagar Metro,146153,139261,0,2824,34162,0,0,183139,0,0,0,0,500,500,3435,904,4339,3367,862,4229,3287,32,78,8,0,8,73,824,1023
1,26/10/2022,01F1-Thiruvotriyur Metro,146075,109748,0,960,23790,0,0,170825,0,0,0,0,0,0,2845,652,3497,2960,568,3528,2864,24,0,2,0,4,32,627,689
1,26/10/2022,01F3-Thiruvotriyur Theradi Metro,115496,120049,100,1704,26160,0,0,143460,0,0,0,0,0,0,2913,766,3679,3228,793,4021,3198,23,94,1,0,10,58,697,883
1,26/10/2022,01F5-Kaladipet Metro,128906,108384,0,1480,29522,0,0,159908,0,0,0,0,0,0,3005,923,3928,3055,686,3741,2929,22,7,0,0,0,50,870,949
1,26/10/2022,01F7-Tollgate Metro,73977,56983,0,1776,14056,0,0,89809,0,0,0,0,0,0,1671,451,2122,1621,340,1961,1577,14,3,0,0,10,22,426,475
1,26/10/2022,01F9-New Washermenpet Metro,128230,100108,600,1192,21604,0,0,151626,0,0,0,0,0,0,3044,735,3779,3088,741,3829,3113,25,132,1,0,2,45,683,888
1,26/10/2022,01FB-Tondiarpet Metro,112219,104154,0,1464,27924,0,0,141607,0,0,0,0,250,250,2952,929,3881,3150,794,3944,3030,19,0,2,0,9,42,876,948
1,26/10/2022,01FD-Thiagaraya College Metro,132920,127245,0,1840,33884,0,0,168644,0,0,0,0,750,750,3705,1180,4885,3923,1005,4928,3837,25,47,0,0,6,70,1097,1245
1,26/10/2022,0101-Washermanpet,127164,127904,100,1800,35876,0,0,164940,0,0,0,0,10500,10500,3736,1280,5016,3655,1231,4886,3743,28,235,0,0,3,66,1198,1530
1,26/10/2022,0103-Mannadi,106731,112687,0,824,28376,0,0,135931,0,0,0,0,500,500,3243,1000,4243,3608,1102,4710,3533,16,97,1,0,4,31,959,1108
1,26/10/2022,0105-High Court,152768,233862,0,2584,63010,0,0,218362,0,0,0,0,0,0,6847,2291,9138,7014,1726,8740,7010,31,234,0,0,3,106,2131,2505
1,26/10/2022,0109-Government Estate,108968,148466,200,2176,47000,0,0,158344,0,0,0,0,3250,3250,3872,1713,5585,4496,1554,6050,4471,29,169,1,0,7,113,1555,1874
1,26/10/2022,0111-LIC,87035,152401,25,1832,28022,0,0,116914,0,0,0,0,0,0,4361,1022,5383,5065,923,5988,4974,31,0,0,0,3,79,901,1014
1,26/10/2022,0113-Thousand Lights,181991,249587,450,4064,35760,0,0,222265,0,0,0,0,500,500,7680,1378,9058,8507,1516,10023,8534,40,255,3,0,2,170,1136,1606
1,26/10/2022,0115-AG-DMS,126630,142715,0,1544,21720,0,0,149894,0,0,0,0,250,250,4677,785,5462,4741,742,5483,4773,26,113,2,0,2,66,684,893
1,26/10/2022,0117-Teynampet,106714,149826,500,1312,30812,0,0,139338,0,0,0,0,500,500,4557,1143,5700,5111,1028,6139,4938,24,0,1,0,0,59,1049,1133
1,26/10/2022,0119-Nandanam,111907,121671,200,1480,27982,0,0,141569,0,0,0,0,500,500,3610,1052,4662,4153,926,5079,3991,28,1,1,0,2,64,944,1040
1,26/10/2022,0121-Saidapet,56456,76973,100,920,19074,0,0,76550,0,0,0,0,2750,2750,1774,671,2445,2440,726,3166,2307,13,0,1,0,1,40,627,682
1,26/10/2022,0123-Little Mount,109034,91942,150,2152,21408,0,0,132744,0,0,0,0,750,750,3205,827,4032,2896,799,3695,2853,15,139,1,0,0,77,703,935
1,26/10/2022,0125-Guindy,166956,255694,200,5160,68214,0,0,240530,0,0,0,0,0,0,7686,2397,10083,7253,2330,9583,7392,39,561,4,0,5,219,2113,2941
1,26/10/2022,0129-Nanganallur Road,65390,49745,0,912,12600,0,0,78902,0,0,0,0,0,0,1268,398,1666,1439,351,1790,1397,10,19,0,0,0,21,367,417
1,26/10/2022,0131-Meenambakkam,145271,141622,0,2784,37346,0,0,185401,0,0,0,0,0,0,4010,1100,5110,3452,839,4291,3564,16,247,1,0,5,92,1002,1363
1,26/10/2022,0133-Chennai International Airport,201905,330737,300,8584,140460,0,0,351249,0,0,0,0,12500,12500,5686,3910,9596,6267,3477,9744,6125,60,698,32,0,13,254,3466,4523
2,26/10/2022,0201-Puratchi Thalaivar Dr. M.G. Ramachandran Central,349491,513166,26,20784,138940,0,0,509241,0,0,0,0,10850,10850,15766,5452,21218,11181,6828,18009,15067,102,4651,15,0,13,834,4225,9840
2,26/10/2022,0203-Egmore,103769,141271,116,5104,49738,0,0,158727,0,0,0,0,10000,10000,3582,1875,5457,2869,2224,5093,3593,20,1260,4,0,4,199,1642,3129
2,26/10/2022,0205-Nehru Park,46421,45562,0,528,14140,0,0,61089,0,0,0,0,500,500,1365,527,1892,1354,441,1795,1342,13,104,0,0,0,22,495,634
2,26/10/2022,0207-Kilpauk,45897,59868,0,1312,18082,0,0,65291,0,0,0,0,0,0,1533,682,2215,1759,619,2378,1692,14,56,0,0,3,47,619,739
2,26/10/2022,0209-Pachaiyappas College,49734,48841,0,608,12690,0,0,63032,0,0,0,0,0,0,1652,494,2146,1669,456,2125,1543,13,63,1,0,2,23,463,565
2,26/10/2022,0211-Shenoy Nagar,43323,45354,0,736,12228,0,0,56287,0,0,0,0,2000,2000,1227,450,1677,1432,418,1850,1373,9,57,0,0,0,25,413,504
2,26/10/2022,0213-Anna Nagar East,93230,104631,600,1960,25450,0,0,121240,0,0,0,0,3500,3500,2986,951,3937,3250,832,4082,3102,15,140,1,0,3,66,860,1085
2,26/10/2022,0215-Anna Nagar Tower,91564,100602,100,1992,24148,0,0,117804,0,0,0,0,2250,2250,2698,859,3557,2991,840,3831,2932,17,177,2,0,1,38,803,1038
2,26/10/2022,0217-Thirumangalam,287574,300908,48,5744,74372,0,0,367738,0,0,0,0,0,0,7994,2516,10510,8687,2506,11193,8516,63,513,5,0,6,198,2227,3012
2,26/10/2022,0219-Koyambedu,242311,261764,0,6808,78426,0,0,327545,0,0,0,0,25500,25500,6969,2778,9747,5836,2214,8050,6626,63,1329,8,0,14,245,2419,4078
2,26/10/2022,0221-Puratchi Thalaivi Dr. J. Jayalalithaa CMBT,139713,235628,0,6880,83722,0,0,230315,0,0,0,0,0,0,5254,2940,8194,3665,3374,7039,5537,26,2460,6,0,4,276,2525,5297
2,26/10/2022,0223-Arumbakkam,72346,58001,100,776,19216,0,0,92438,0,0,0,0,13500,13500,1541,691,2232,1713,580,2293,1569,16,2,2,0,5,32,653,710
2,26/10/2022,0225-Vadapalani,150471,220914,200,4240,68496,0,0,223407,0,0,0,0,10500,10500,5247,2380,7627,5905,2507,8412,5804,39,669,6,0,10,158,2139,3021
2,26/10/2022,0227-Ashok Nagar,119301,145798,20,3040,43740,0,0,166101,0,0,0,0,0,0,3673,1500,5173,3944,1601,5545,3968,41,450,0,0,0,116,1328,1935
2,26/10/2022,0229-Ekkattuthangal,93927,124758,200,2136,21556,0,0,117819,0,0,0,0,250,250,3480,829,4309,4197,1057,5254,4088,21,223,0,0,3,88,683,1018
2,26/10/2022,0231-Arignar Anna Alandur,179768,198434,900,4264,58104,0,0,243036,0,0,0,0,4250,4250,5429,2043,7472,5316,1566,6882,5406,52,432,1,0,5,152,1789,2431
2,26/10/2022,0233-St. Thomas Mount,107299,109589,500,2576,33026,0,0,143401,0,0,0,3400,9300,12700,2966,1122,4088,3052,909,3961,2958,32,168,5,0,2,93,1011,1311
1,27/10/2022,01ED-Wimco Nagar Depot Metro,76599,80969,200,1280,24858,0,0,102937,0,0,0,0,2250,2250,2198,644,2842,1811,357,2168,1760,8,10,1,0,4,41,620,684
1,27/10/2022,01EF-Wimco Nagar Metro,137581,145817,0,3152,34336,0,0,175069,0,0,0,0,1250,1250,3644,919,4563,3478,897,4375,3445,35,140,3,0,9,89,818,1094
1,27/10/2022,01F1-Thiruvotriyur Metro,123629,115119,0,760,24982,0,0,149371,0,0,0,0,0,0,3111,674,3785,3148,554,3702,2979,28,0,4,0,11,23,650,716
1,27/10/2022,01F3-Thiruvotriyur Theradi Metro,116914,131684,300,2328,29960,0,0,149502,0,0,0,0,0,0,3185,892,4077,3507,886,4393,3460,21,139,7,0,7,79,794,1047
1,27/10/2022,01F5-Kaladipet Metro,109404,119331,0,1424,32816,0,0,143644,0,0,0,0,0,0,3338,980,4318,3418,791,4209,3232,18,1,1,0,3,49,924,996
1,27/10/2022,01F7-Tollgate Metro,62333,63643,200,832,18448,0,0,81813,0,0,0,0,0,0,1764,567,2331,1718,417,2135,1663,10,3,0,0,4,27,533,577
1,27/10/2022,01F9-New Washermenpet Metro,108666,108947,0,1448,25488,0,0,135602,0,0,0,0,1000,1000,3277,849,4126,3354,812,4166,3327,27,115,2,0,2,56,798,1000
1,27/10/2022,01FB-Tondiarpet Metro,97339,111612,200,1776,30236,0,0,129551,0,0,0,0,500,500,3122,1002,4124,3309,887,4196,3196,24,23,2,0,4,56,936,1045
1,27/10/2022,01FD-Thiagaraya College Metro,116040,142022,0,1808,38840,0,0,156688,0,0,0,0,500,500,4078,1334,5412,4274,1072,5346,4183,32,68,1,0,8,72,1254,1435
1,27/10/2022,0101-Washermanpet,112635,139522,50,2376,45610,0,0,160671,0,0,0,0,13000,13000,4034,1598,5632,3855,1235,5090,3815,24,155,2,0,6,89,1500,1776
1,27/10/2022,0103-Mannadi,97167,117787,0,1352,26414,0,0,124933,0,0,0,0,1500,1500,3430,898,4328,3685,1017,4702,3769,28,282,0,0,3,42,856,1211
1,27/10/2022,0105-High Court,165060,241901,0,2240,59700,0,0,227000,0,0,0,0,0,0,7239,2127,9366,7339,1763,9102,7495,41,418,0,0,5,101,1994,2559
1,27/10/2022,0109-Government Estate,86527,151428,340,2224,45376,0,0,134467,0,0,0,0,2000,2000,4017,1657,5674,4680,1405,6085,4638,28,224,0,0,5,100,1487,1844
1,27/10/2022,0111-LIC,105827,186307,100,3008,32032,0,0,140967,0,0,0,0,3000,3000,5390,1187,6577,6259,1037,7296,6168,23,24,2,0,3,94,1040,1186
1,27/10/2022,0113-Thousand Lights,167667,264253,1800,5392,28768,0,0,203627,0,0,0,0,0,0,8504,1222,9726,8885,1504,10389,9316,42,566,0,0,6,226,881,1721
1,27/10/2022,0115-AG-DMS,113125,152756,0,2312,23680,0,0,139117,0,0,0,0,1000,1000,5093,846,5939,4935,720,5655,5068,20,209,1,0,1,71,734,1036
1,27/10/2022,0117-Teynampet,96755,159848,200,2312,35144,0,0,134411,0,0,0,0,250,250,4900,1294,6194,5336,1058,6394,5207,19,88,2,0,3,86,1168,1366
1,27/10/2022,0119-Nandanam,90968,131100,200,1896,30140,0,0,123204,0,0,0,0,250,250,3911,1110,5021,4479,843,5322,4317,18,0,1,0,3,77,992,1091
1,27/10/2022,0121-Saidapet,59783,85762,0,1840,21924,0,0,83547,0,0,0,0,8500,8500,2002,774,2776,2676,713,3389,2568,18,0,1,0,3,60,698,780
1,27/10/2022,0123-Little Mount,103337,102889,0,2904,24466,0,0,130707,0,0,0,0,250,250,3575,948,4523,3121,724,3845,3159,18,154,2,0,6,100,805,1085
1,27/10/2022,0125-Guindy,158281,271716,800,6696,60968,0,0,226745,0,0,0,0,0,0,8561,2233,10794,7637,2235,9872,8236,34,949,1,0,6,237,1893,3120
1,27/10/2022,0129-Nanganallur Road,42451,50448,200,1544,13008,0,0,57203,0,0,0,0,0,0,1315,413,1728,1538,326,1864,1454,8,1,3,0,2,30,385,429
1,27/10/2022,0131-Meenambakkam,148348,144238,0,2744,25438,0,0,176530,0,0,0,0,0,0,4510,782,5292,3593,872,4465,3985,22,549,3,0,5,92,676,1347
1,27/10/2022,0133-Chennai International Airport,181247,357437,300,8672,142750,0,0,332969,0,0,0,0,7750,7750,6321,3969,10290,6887,3649,10536,6863,52,994,14,0,21,254,3496,4831
2,27/10/2022,0201-Puratchi Thalaivar Dr. M.G. Ramachandran Central,284502,498889,246,14752,154942,0,0,454442,0,0,0,0,8450,8450,14487,5595,20082,12469,6720,19189,14260,105,3232,5,0,26,578,4812,8758
2,27/10/2022,0203-Egmore,106461,153493,750,4128,54222,0,0,165561,0,0,0,0,13000,13000,3541,1980,5521,3382,2405,5787,3882,29,1195,17,0,16,164,1752,3173
2,27/10/2022,0205-Nehru Park,69479,47566,120,912,14596,0,0,85107,0,0,0,0,28000,28000,1444,534,1978,1415,421,1836,1414,11,102,0,0,1,35,491,640
2,27/10/2022,0207-Kilpauk,40185,63571,0,624,18764,0,0,59573,0,0,0,0,250,250,1635,669,2304,1882,604,2486,1807,11,79,0,0,2,26,632,750
2,27/10/2022,0209-Pachaiyappas College,57982,53765,0,952,14558,0,0,73492,0,0,0,0,12000,12000,1848,588,2436,1733,454,2187,1670,19,65,2,0,0,38,540,664
2,27/10/2022,0211-Shenoy Nagar,42908,55128,100,1032,13628,0,0,57668,0,0,0,0,0,0,1442,496,1938,1763,442,2205,1689,10,73,0,0,3,31,458,575
2,27/10/2022,0213-Anna Nagar East,87426,115466,528,1824,27972,0,0,117750,0,0,0,0,0,0,3309,1029,4338,3560,850,4410,3462,16,176,2,0,0,67,944,1205
2,27/10/2022,0215-Anna Nagar Tower,96941,104358,0,1472,24516,0,0,122929,0,0,0,0,2500,2500,2922,875,3797,3162,780,3942,3094,17,182,2,0,3,58,795,1057
2,27/10/2022,0217-Thirumangalam,270920,329946,326,6648,79346,0,0,357240,0,0,0,0,0,0,9108,2675,11783,9200,2728,11928,9325,63,919,4,0,4,188,2410,3588
2,27/10/2022,0219-Koyambedu,240094,272949,0,4784,83522,0,0,328400,0,0,0,10000,14250,24250,7124,2864,9988,6413,2291,8704,6860,68,1054,9,0,14,200,2584,3929
2,27/10/2022,0221-Puratchi Thalaivi Dr. J. Jayalalithaa CMBT,142684,228864,200,6160,60010,0,0,209054,0,0,0,0,0,0,5333,2141,7474,4190,3715,7905,6054,40,2739,4,0,1,256,1753,4793
2,27/10/2022,0223-Arumbakkam,67881,67465,0,1224,25088,0,0,94193,0,0,0,0,4500,4500,1711,928,2639,1916,728,2644,1729,23,2,6,0,7,51,856,945
2,27/10/2022,0225-Vadapalani,151166,226467,0,4400,59600,0,0,215166,0,0,0,0,3500,3500,5844,2047,7891,5831,2445,8276,6308,39,1116,1,0,4,172,1786,3118
2,27/10/2022,0227-Ashok Nagar,113889,154302,0,3368,37672,0,0,154929,0,0,0,0,6000,6000,4365,1366,5731,4143,1492,5635,4463,44,756,0,0,2,129,1164,2095
2,27/10/2022,0229-Ekkattuthangal,258121,134160,250,3568,27814,0,0,289753,0,0,0,0,750,750,3826,1035,4861,4257,979,5236,4242,58,289,0,0,1,138,864,1350
2,27/10/2022,0231-Arignar Anna Alandur,169485,216664,600,5184,71132,0,0,246401,0,0,0,0,7500,7500,5674,2429,8103,5556,1753,7309,5671,43,426,8,0,6,192,2142,2817
2,27/10/2022,0233-St. Thomas Mount,98205,116957,200,2544,37070,0,0,138019,0,0,0,6000,3400,9400,3147,1242,4389,3205,916,4121,3112,25,175,2,0,2,99,1089,1392
1,28/10/2022,01ED-Wimco Nagar Depot Metro,75661,86610,0,1328,30638,0,0,107627,0,0,0,0,3500,3500,2181,755,2936,1862,456,2318,1780,23,0,0,0,12,42,726,803
1,28/10/2022,01EF-Wimco Nagar Metro,124172,149037,0,4480,32334,0,0,160986,0,0,0,0,3500,3500,3783,873,4656,3544,971,4515,3597,52,184,3,0,14,107,766,1126
1,28/10/2022,01F1-Thiruvotriyur Metro,110049,124648,0,1744,31892,0,0,143685,0,0,0,0,0,0,3191,848,4039,3202,598,3800,3074,30,0,3,0,14,52,815,914
1,28/10/2022,01F3-Thiruvotriyur Theradi Metro,110146,140250,0,2248,39072,0,0,151466,0,0,0,0,0,0,3214,1075,4289,3524,1113,4637,3473,15,112,3,0,8,59,996,1193
1,28/10/2022,01F5-Kaladipet Metro,96687,114000,200,2032,29354,0,0,128273,0,0,0,0,0,0,3203,883,4086,3305,729,4034,3162,15,19,0,0,6,39,840,919
1,28/10/2022,01F7-Tollgate Metro,57676,70485,200,824,22968,0,0,81668,0,0,0,0,0,0,1780,701,2481,1814,502,2316,1716,11,3,1,0,8,28,662,713
1,28/10/2022,01F9-New Washermenpet Metro,95522,107264,200,1328,26344,0,0,123394,0,0,0,0,2500,2500,3183,866,4049,3210,827,4037,3179,23,117,3,0,4,45,814,1006
1,28/10/2022,01FB-Tondiarpet Metro,110164,114101,50,1584,33432,0,0,145230,0,0,0,0,500,500,3156,1096,4252,3341,885,4226,3177,15,0,2,0,7,51,1028,1103
1,28/10/2022,01FD-Thiagaraya College Metro,114503,147406,0,2304,41438,0,0,158245,0,0,0,0,3000,3000,4032,1393,5425,4306,1127,5433,4271,34,112,1,0,6,83,1307,1543
1,28/10/2022,0101-Washermanpet,126630,136072,30,2368,44268,0,0,173296,0,0,0,0,22500,22500,3961,1546,5507,3626,1366,4992,3722,18,245,1,0,4,94,1434,1796
1,28/10/2022,0103-Mannadi,84557,118734,0,1440,32548,0,0,118545,0,0,0,0,0,0,3315,1077,4392,3664,1129,4793,3612,17,98,3,0,3,40,1036,1197
1,28/10/2022,0105-High Court,153693,246932,100,2608,57594,0,0,213995,0,0,0,0,0,0,7464,2054,9518,7212,1881,9093,7689,24,675,3,0,6,111,1926,2745
1,28/10/2022,0109-Government Estate,87799,155332,200,2528,49446,0,0,139973,0,0,0,0,3750,3750,4124,1793,5917,4630,1582,6212,4624,26,215,0,0,7,99,1612,1959
1,28/10/2022,0111-LIC,96045,179853,125,2264,32652,0,0,131086,0,0,0,0,0,0,5187,1180,6367,6002,955,6957,5898,28,0,0,0,3,96,1044,1171
1,28/10/2022,0113-Thousand Lights,167380,258254,2120,5160,36008,0,0,210668,0,0,0,0,1250,1250,8150,1406,9556,8561,1450,10011,8836,39,393,3,0,7,229,1113,1784
1,28/10/2022,0115-AG-DMS,111540,167726,0,2144,31662,0,0,145346,0,0,0,0,1500,1500,5293,1089,6382,5094,857,5951,5292,19,323,0,0,9,83,951,1385
1,28/10/2022,0117-Teynampet,97037,151181,3800,2496,34390,0,0,137723,0,0,0,0,0,0,4655,1269,5924,5079,993,6072,4915,36,2,1,0,6,90,1134,1269
1,28/10/2022,0119-Nandanam,98085,131763,0,2000,33688,0,0,133773,0,0,0,0,500,500,3807,1244,5051,4363,952,5315,4219,28,0,6,0,3,83,1117,1237
1,28/10/2022,0121-Saidapet,54737,86624,1000,968,25562,0,0,82267,0,0,0,0,4000,4000,1972,879,2851,2544,823,3367,2433,16,0,1,0,2,42,818,879
1,28/10/2022,0123-Little Mount,97432,105119,0,3152,27984,0,0,128568,0,0,0,0,500,500,3569,1080,4649,3016,664,3680,3107,29,198,2,0,5,98,924,1256
1,28/10/2022,0125-Guindy,172361,284393,1650,7904,63858,0,0,245773,0,0,0,0,0,0,8897,2319,11216,7450,2527,9977,8523,40,1334,2,0,6,296,1933,3611
1,28/10/2022,0129-Nanganallur Road,42694,54935,100,760,16572,0,0,60126,0,0,0,0,0,0,1329,521,1850,1564,360,1924,1459,4,0,1,0,2,25,486,518
1,28/10/2022,0131-Meenambakkam,131607,153911,730,3192,45474,0,0,181003,0,0,0,0,0,0,4210,1307,5517,3613,977,4590,3723,18,283,3,0,2,97,1212,1615
1,28/10/2022,0133-Chennai International Airport,193837,384398,1200,9768,173414,0,0,378219,0,0,0,0,8250,8250,6366,4788,11154,6622,3933,10555,6753,95,931,22,0,17,285,4159,5509
2,28/10/2022,0201-Puratchi Thalaivar Dr. M.G. Ramachandran Central,275829,511934,640,12720,161176,0,0,450365,0,0,0,0,7250,7250,14121,5728,19849,12438,7719,20157,14457,79,3317,9,0,23,512,5072,9012
2,28/10/2022,0203-Egmore,113413,153929,200,4112,52388,0,0,170113,0,0,0,0,14250,14250,3407,1882,5289,3290,2507,5797,3943,17,1257,9,0,6,169,1717,3175
2,28/10/2022,0205-Nehru Park,36313,48053,50,904,14784,0,0,52051,0,0,0,0,2000,2000,1445,561,2006,1416,446,1862,1426,5,85,5,0,3,37,509,644
2,28/10/2022,0207-Kilpauk,40283,65351,80,1040,20530,0,0,61933,0,0,0,0,250,250,1661,765,2426,1866,640,2506,1815,16,82,4,0,1,43,698,844
2,28/10/2022,0209-Pachaiyappas College,64047,55903,0,1056,15394,0,0,80497,0,0,0,0,18000,18000,1895,617,2512,1741,470,2211,1716,14,72,1,0,4,40,558,689
2,28/10/2022,0211-Shenoy Nagar,47435,50349,0,632,12758,0,0,60825,0,0,0,0,4250,4250,1434,464,1898,1584,388,1972,1542,8,66,0,0,1,23,422,520
2,28/10/2022,0213-Anna Nagar East,89237,121086,0,2088,32670,0,0,123995,0,0,0,0,3000,3000,3400,1206,4606,3544,986,4530,3516,25,183,0,0,1,80,1080,1369
2,28/10/2022,0215-Anna Nagar Tower,104147,110354,1200,2296,27492,0,0,135135,0,0,0,0,1000,1000,3073,996,4069,3207,908,4115,3204,16,206,0,0,3,78,892,1195
2,28/10/2022,0217-Thirumangalam,265360,334700,700,6552,84888,0,0,357500,0,0,0,0,3000,3000,9089,2862,11951,9011,2857,11868,9258,64,880,6,0,7,230,2544,3731
2,28/10/2022,0219-Koyambedu,192505,261402,0,4592,89958,0,0,287055,0,0,0,0,13000,13000,6533,3068,9601,6081,2422,8503,6254,48,803,6,0,12,185,2799,3853
2,28/10/2022,0221-Puratchi Thalaivi Dr. J. Jayalalithaa CMBT,100337,212778,150,4152,78216,0,0,182855,0,0,0,0,0,0,3809,2560,6369,4770,4378,9148,5014,37,1446,10,0,5,164,2328,3990
2,28/10/2022,0223-Arumbakkam,73409,70743,400,1232,27692,0,0,102733,0,0,0,0,16750,16750,1772,987,2759,1896,707,2603,1747,32,3,1,0,10,45,922,1013
2,28/10/2022,0225-Vadapalani,152302,251798,400,5456,74442,0,0,232600,0,0,0,0,4000,4000,6291,2579,8870,6069,2756,8825,6677,38,1249,6,0,17,211,2258,3779
2,28/10/2022,0227-Ashok Nagar,96242,158711,200,3480,45118,0,0,145040,0,0,0,0,5000,5000,4220,1630,5850,4048,1648,5696,4378,39,657,4,0,1,135,1387,2223
2,28/10/2022,0229-Ekkattuthangal,80440,132509,400,3016,30526,0,0,114382,0,0,0,0,0,0,3870,1139,5009,3953,949,4902,4079,17,302,2,0,4,124,944,1393
2,28/10/2022,0231-Arignar Anna Alandur,174056,220089,200,4664,70872,0,0,249792,0,0,0,0,4250,4250,5753,2353,8106,5602,1844,7446,5761,44,572,6,0,10,176,2081,2889
2,28/10/2022,0233-St. Thomas Mount,88521,124269,552,4016,37488,0,0,130577,0,0,0,3400,6400,9800,3308,1281,4589,3157,1005,4162,3320,26,330,2,0,12,118,1127,1615
1,29/10/2022,01ED-Wimco Nagar Depot Metro,55913,76489,0,2088,30444,0,0,88445,0,0,0,0,3000,3000,1781,788,2569,1509,436,1945,1465,19,0,1,0,4,60,733,817
1,29/10/2022,01EF-Wimco Nagar Metro,109011,135887,700,4128,44256,0,0,158095,0,0,0,0,3250,3250,3152,1142,4294,2894,977,3871,2845,46,86,5,0,20,96,1058,1311
1,29/10/2022,01F1-Thiruvotriyur Metro,108612,113713,100,2864,36002,0,0,147578,0,0,0,0,0,0,2709,992,3701,2623,682,3305,2549,39,1,2,0,9,68,918,1037
1,29/10/2022,01F3-Thiruvotriyur Theradi Metro,103127,125716,500,2104,34882,0,0,140613,0,0,0,0,0,0,3017,1035,4052,3019,1095,4114,3064,26,219,3,0,15,69,912,1244
1,29/10/2022,01F5-Kaladipet Metro,91829,101286,0,1784,31016,0,0,124629,0,0,0,0,0,0,2663,935,3598,2708,842,3550,2584,16,24,0,0,1,57,868,966
1,29/10/2022,01F7-Tollgate Metro,54453,63537,0,976,23714,0,0,79143,0,0,0,0,0,0,1460,738,2198,1554,490,2044,1467,11,17,0,0,7,32,694,761
1,29/10/2022,01F9-New Washermenpet Metro,88718,101669,520,1696,31100,0,0,122034,0,0,0,0,250,250,2774,1019,3793,2831,876,3707,2756,23,100,1,0,12,52,950,1138
1,29/10/2022,01FB-Tondiarpet Metro,87266,106442,3350,1544,38190,0,0,130350,0,0,0,0,0,0,2614,1202,3816,2852,999,3851,2649,19,0,0,0,16,45,1142,1222
1,29/10/2022,01FD-Thiagaraya College Metro,103848,133605,1300,2288,45208,0,0,152644,0,0,0,0,1250,1250,3420,1527,4947,3697,1212,4909,3577,60,35,1,0,5,87,1406,1594
1,29/10/2022,0101-Washermanpet,83987,116840,130,2592,45324,0,0,132033,0,0,0,0,10250,10250,3093,1565,4658,2932,1362,4294,2943,10,146,3,0,9,88,1438,1694
1,29/10/2022,0103-Mannadi,87804,113296,200,1960,32632,0,0,122596,0,0,0,0,3000,3000,2989,1144,4133,3172,1349,4521,3318,25,261,1,0,7,84,1066,1444
1,29/10/2022,0105-High Court,107652,193611,200,3488,66760,0,0,178100,0,0,0,0,0,0,5005,2414,7419,4887,2126,7013,5147,32,449,0,0,3,139,2181,2804
1,29/10/2022,0109-Government Estate,79515,148071,0,3520,52390,0,0,135425,0,0,0,0,4000,4000,3619,1935,5554,3923,1842,5765,4114,21,429,2,0,2,165,1704,2323
1,29/10/2022,0111-LIC,59890,119276,900,2024,32292,0,0,95106,0,0,0,0,0,0,2977,1142,4119,3545,907,4452,3435,25,0,1,0,11,79,1034,1150
1,29/10/2022,0113-Thousand Lights,108200,198194,1665,4848,46666,0,0,161379,0,0,0,0,1000,1000,5262,1739,7001,5960,1531,7491,6002,22,198,1,0,3,207,1446,1877
1,29/10/2022,0115-AG-DMS,68039,115835,800,1728,28626,0,0,99193,0,0,0,0,250,250,3362,996,4358,3243,750,3993,3379,13,219,0,0,2,74,878,1186
1,29/10/2022,0117-Teynampet,70404,120078,334,1672,35260,0,0,107670,0,0,0,0,0,0,3318,1282,4600,3602,1055,4657,3458,20,16,2,0,5,71,1170,1284
1,29/10/2022,0119-Nandanam,59795,94351,300,2072,33748,0,0,95915,0,0,0,0,750,750,2355,1222,3577,2674,803,3477,2529,16,0,1,0,4,78,1107,1206
1,29/10/2022,0121-Saidapet,36667,64786,78,1400,26052,0,0,64197,0,0,0,0,4250,4250,1312,893,2205,1657,721,2378,1533,23,0,0,0,1,58,820,902
1,29/10/2022,0123-Little Mount,71340,76218,650,2096,26268,0,0,100354,0,0,0,0,1750,1750,2210,978,3188,1896,667,2563,1968,25,198,2,0,4,91,841,1161
1,29/10/2022,0125-Guindy,123341,241543,872,8280,81508,0,0,214001,0,0,0,0,0,0,5962,2791,8753,5361,2923,8284,6025,48,1068,4,0,9,255,2434,3818
1,29/10/2022,0129-Nanganallur Road,37582,42992,500,696,16028,0,0,54806,0,0,0,0,0,0,933,490,1423,1108,374,1482,1004,7,0,2,0,0,24,456,489
1,29/10/2022,0131-Meenambakkam,120621,143028,700,6136,50864,0,0,178321,0,0,0,0,0,0,3355,1504,4859,2899,1104,4003,3094,27,338,10,0,5,135,1349,1864
1,29/10/2022,0133-Chennai International Airport,182009,379661,500,11224,183772,0,0,377505,0,0,0,0,6000,6000,5646,5143,10789,5739,4228,9967,6099,68,1444,37,0,26,342,4427,6344
2,29/10/2022,0201-Puratchi Thalaivar Dr. M.G. Ramachandran Central,267804,483322,250,11696,166958,0,0,446708,0,0,0,0,6350,6350,11838,5857,17695,9898,8132,18030,12372,69,3992,10,0,31,468,5212,9782
2,29/10/2022,0203-Egmore,86335,140507,1000,2504,55128,0,0,144967,0,0,0,0,12250,12250,2741,1926,4667,3016,2772,5788,3325,27,964,7,0,14,110,1768,2890
2,29/10/2022,0205-Nehru Park,35281,47491,0,1400,16908,0,0,53589,0,0,0,0,2750,2750,1270,637,1907,1260,550,1810,1275,13,133,0,0,3,48,552,749
2,29/10/2022,0207-Kilpauk,27320,57609,600,1000,21856,0,0,50776,0,0,0,0,0,0,1338,368,1706,1492,663,2155,1440,9,67,0,0,5,42,718,841
2,29/10/2022,0209-Pachaiyappas College,47897,62814,0,616,24674,0,0,73187,0,0,0,0,6000,6000,1650,871,2521,1561,685,2246,1557,9,115,1,0,4,27,851,1007
2,29/10/2022,0211-Shenoy Nagar,32327,47376,100,488,15338,0,0,48253,0,0,0,0,0,0,1240,555,1795,1396,474,1870,1327,14,74,0,0,0,20,517,625
2,29/10/2022,0213-Anna Nagar East,65929,110443,3000,3504,36124,0,0,108557,0,0,0,0,1500,1500,2881,1368,4249,2922,1057,3979,2982,21,210,2,0,3,134,1182,1552
2,29/10/2022,0215-Anna Nagar Tower,68337,97335,1100,2192,31268,0,0,102897,0,0,0,0,12750,12750,2406,1150,3556,2555,1073,3628,2538,17,256,1,0,1,91,1019,1385
2,29/10/2022,0217-Thirumangalam,202825,303484,300,8680,112658,0,0,324463,0,0,0,0,0,0,6892,3793,10685,6966,3179,10145,7116,61,790,6,0,9,311,3393,4570
2,29/10/2022,0219-Koyambedu,163287,228765,700,5056,82526,0,0,251569,0,0,0,0,4250,4250,5449,2908,8357,4774,2551,7325,5313,39,1167,6,0,15,188,2574,3989
2,29/10/2022,0221-Puratchi Thalaivi Dr. J. Jayalalithaa CMBT,96835,203074,0,2984,66772,0,0,166591,0,0,0,0,0,0,3646,2237,5883,4370,4671,9041,4959,23,1714,2,0,7,114,2066,3926
2,29/10/2022,0223-Arumbakkam,46819,73219,0,2264,35090,0,0,84173,0,0,0,0,6500,6500,1538,1248,2786,1663,883,2546,1526,12,2,6,0,7,85,1138,1250
2,29/10/2022,0225-Vadapalani,140304,255813,1000,8928,93178,0,0,243410,0,0,0,0,4500,4500,5608,3436,9044,5232,3608,8840,6132,54,1619,2,0,13,365,2819,4872
2,29/10/2022,0227-Ashok Nagar,95378,146454,1900,4488,52476,0,0,154242,0,0,0,0,0,0,3515,1908,5423,3485,1712,5197,3628,29,664,7,0,6,163,1641,2510
2,29/10/2022,0229-Ekkattuthangal,62397,92008,100,2904,31018,0,0,96419,0,0,0,0,0,0,2331,1178,3509,2325,891,3216,2473,22,295,0,0,4,130,999,1450
2,29/10/2022,0231-Arignar Anna Alandur,132141,203579,2402,7016,83190,0,0,224749,0,0,0,0,1750,1750,4445,2840,7285,4290,2325,6615,4510,40,646,8,0,11,225,2438,3368
2,29/10/2022,0233-St. Thomas Mount,77258,120983,100,4216,51368,0,0,132942,0,0,0,9400,3400,12800,2618,1713,4331,2598,1337,3935,2610,22,314,5,0,5,161,1518,2025
1,30/10/2022,01ED-Wimco Nagar Depot Metro,53483,67687,0,2376,31212,0,0,87071,0,0,0,0,0,0,1085,798,1883,1080,522,1602,1094,18,87,4,0,14,56,749,928
1,30/10/2022,01EF-Wimco Nagar Metro,55853,86132,200,2128,35658,0,0,93839,0,0,0,0,0,0,1422,891,2313,1580,953,2533,1509,34,136,3,0,25,58,824,1080
1,30/10/2022,01F1-Thiruvotriyur Metro,61615,85027,100,2520,34808,0,0,99043,0,0,0,0,0,0,1412,934,2346,1731,765,2496,1588,23,0,0,0,24,74,874,995
1,30/10/2022,01F3-Thiruvotriyur Theradi Metro,75690,115231,50,2896,51860,0,0,130496,0,0,0,0,0,0,1862,1391,3253,2060,1356,3416,2049,21,205,3,0,28,92,1294,1643
1,30/10/2022,01F5-Kaladipet Metro,60695,78487,0,1288,37104,0,0,99087,0,0,0,0,0,0,1381,1035,2416,1620,889,2509,1428,18,0,1,0,16,40,1002,1077
1,30/10/2022,01F7-Tollgate Metro,35078,47500,100,784,21226,0,0,57188,0,0,0,0,0,0,903,651,1554,931,603,1534,908,8,90,2,0,14,26,596,736
1,30/10/2022,01F9-New Washermenpet Metro,60730,74723,15,1504,33548,0,0,95797,0,0,0,0,1000,1000,1446,1002,2448,1490,887,2377,1497,19,159,1,0,13,51,958,1201
1,30/10/2022,01FB-Tondiarpet Metro,54168,83425,400,2288,39342,0,0,96198,0,0,0,0,1000,1000,1471,1205,2676,1729,1093,2822,1577,17,4,2,0,41,69,1130,1263
1,30/10/2022,01FD-Thiagaraya College Metro,64446,104443,700,1888,52750,0,0,119784,0,0,0,0,1000,1000,1875,1609,3484,2073,1316,3389,1941,23,102,0,0,13,60,1524,1722
1,30/10/2022,0101-Washermanpet,70777,87479,200,1800,47716,0,0,120493,0,0,0,0,22250,22250,1543,1567,3110,1548,1383,2931,1530,11,196,2,0,15,74,1479,1777
1,30/10/2022,0103-Mannadi,44625,70040,100,1800,34542,0,0,81067,0,0,0,0,0,0,1190,1148,2338,1346,1320,2666,1383,16,189,0,0,12,68,1098,1383
1,30/10/2022,0105-High Court,33823,82226,0,1456,43042,0,0,78321,0,0,0,0,0,0,1572,1520,3092,1610,1281,2891,1590,11,180,2,0,14,53,1441,1701
1,30/10/2022,0109-Government Estate,43944,92664,100,2824,43396,0,0,90264,0,0,0,0,250,250,1732,1589,3321,1872,1273,3145,1930,10,373,2,0,18,107,1427,1937
1,30/10/2022,0111-LIC,19518,58251,0,1648,31380,0,0,52546,0,0,0,0,250,250,863,1076,1939,1199,760,1959,1049,7,0,0,0,3,61,988,1059
1,30/10/2022,0113-Thousand Lights,36509,80097,0,2600,34742,0,0,73851,0,0,0,0,1000,1000,1433,1230,2663,2001,1132,3133,1784,10,0,8,0,11,97,1059,1185
1,30/10/2022,0115-AG-DMS,30929,42573,500,1600,16418,0,0,49447,0,0,0,0,0,0,913,564,1477,869,518,1387,954,16,181,9,0,1,48,491,746
1,30/10/2022,0117-Teynampet,27971,50581,0,1112,23854,0,0,52937,0,0,0,0,2000,2000,874,855,1729,1246,720,1966,1046,24,4,4,0,13,44,803,892
1,30/10/2022,0119-Nandanam,29682,74263,0,1832,41746,0,0,73260,0,0,0,0,0,0,1105,1438,2543,1368,1103,2471,1227,13,5,0,0,34,62,1362,1476
1,30/10/2022,0121-Saidapet,20299,49809,100,1272,28570,0,0,50241,0,0,0,0,2000,2000,649,955,1604,934,849,1783,800,7,0,2,1,6,44,891,951
1,30/10/2022,0123-Little Mount,31076,59349,0,2256,27648,0,0,60980,0,0,0,0,0,0,1192,1006,2198,1157,790,1947,1207,16,196,1,0,7,85,903,1208
1,30/10/2022,0125-Guindy,122854,183598,501,5168,58870,0,0,187393,0,0,0,0,0,0,4074,1992,6066,2718,3107,5825,4185,30,2043,16,0,16,192,1678,3975
1,30/10/2022,0129-Nanganallur Road,14472,23922,100,760,12512,0,0,27844,0,0,0,0,0,0,333,392,725,461,368,829,399,7,0,0,0,3,25,355,390
1,30/10/2022,0131-Meenambakkam,60667,101853,0,3504,53548,0,0,117719,0,0,0,0,0,0,1584,1450,3034,1306,1094,2400,1507,15,410,9,0,9,106,1367,1916
1,30/10/2022,0133-Chennai International Airport,128284,341240,1900,12344,202540,0,0,345068,0,0,0,0,1500,1500,3916,5590,9506,4031,4581,8612,4281,75,1144,28,0,37,383,4874,6541
2,30/10/2022,0201-Puratchi Thalaivar Dr. M.G. Ramachandran Central,211964,409274,250,13712,185278,0,0,411204,0,0,0,0,3000,3000,8082,6477,14559,5878,8231,14109,8160,94,3965,21,0,44,507,5643,10274
2,30/10/2022,0203-Egmore,84362,128650,0,4104,54550,0,0,143016,0,0,0,0,9000,9000,2664,1957,4621,2059,2678,4737,2779,24,1360,9,0,19,143,1742,3297
2,30/10/2022,0205-Nehru Park,20014,33908,200,1280,16686,0,0,38180,0,0,0,0,0,0,635,634,1269,654,547,1201,660,9,125,14,0,1,44,581,774
2,30/10/2022,0207-Kilpauk,15665,33203,100,1168,16456,0,0,33389,0,0,0,0,0,0,559,577,1136,646,510,1156,653,8,89,0,0,6,40,507,650
2,30/10/2022,0209-Pachaiyappas College,26269,34060,100,792,15742,0,0,42903,0,0,0,0,6000,6000,725,569,1294,683,478,1161,727,7,112,0,0,1,26,521,667
2,30/10/2022,0211-Shenoy Nagar,15713,26891,30,728,12700,0,0,29171,0,0,0,0,0,0,558,451,1009,571,453,1024,570,5,66,3,0,8,28,416,526
2,30/10/2022,0213-Anna Nagar East,37127,67984,0,2160,28434,0,0,67721,0,0,0,0,0,0,1457,1044,2501,1531,950,2481,1584,27,238,3,0,3,95,929,1295
2,30/10/2022,0215-Anna Nagar Tower,48149,66135,600,1856,26930,0,0,77535,0,0,0,0,0,0,1372,978,2350,1508,944,2452,1474,16,214,3,0,4,74,870,1181
2,30/10/2022,0217-Thirumangalam,123757,217484,200,7560,108026,0,0,239543,0,0,0,0,0,0,3671,3592,7263,4164,3190,7354,4040,42,716,1,0,8,271,3206,4244
2,30/10/2022,0219-Koyambedu,91800,166556,300,3968,96570,0,0,192638,0,0,0,0,6750,6750,2792,3197,5989,2576,2392,4968,2602,47,673,6,0,24,172,2917,3839
2,30/10/2022,0221-Puratchi Thalaivi Dr. J. Jayalalithaa CMBT,74747,180615,200,4600,92532,0,0,172079,0,0,0,0,0,0,2748,3086,5834,2643,3852,6495,3143,23,1450,7,0,10,205,2760,4455
2,30/10/2022,0223-Arumbakkam,26477,50029,0,880,31264,0,0,58621,0,0,0,0,6000,6000,769,1067,1836,1015,678,1693,795,9,2,3,0,11,40,1026,1091
2,30/10/2022,0225-Vadapalani,119243,270925,340,12040,121182,0,0,252805,0,0,0,0,2500,2500,4895,4349,9244,4466,4216,8682,5467,42,1825,5,0,45,441,3661,6019
2,30/10/2022,0227-Ashok Nagar,59766,100976,1800,3184,49516,0,0,114266,0,0,0,0,500,500,1850,1677,3527,1765,1681,3446,1928,27,498,3,0,6,124,1527,2185
2,30/10/2022,0229-Ekkattuthangal,38374,61906,210,2752,24120,0,0,65456,0,0,0,0,0,0,1247,936,2183,1412,971,2383,1501,19,331,3,0,9,119,790,1271
2,30/10/2022,0231-Arignar Anna Alandur,84248,170344,50,5568,91648,0,0,181514,0,0,0,0,250,250,2564,2945,5509,2653,2221,4874,2766,34,638,6,0,30,190,2650,3548
2,30/10/2022,0233-St. Thomas Mount,58753,94552,300,5248,40452,0,0,104753,0,0,0,15400,4500,19900,1652,1382,3034,1597,1391,2988,1901,21,644,4,0,7,192,1175,2043
1,31/10/2022,01ED-Wimco Nagar Depot Metro,102090,84550,200,1648,29394,0,0,133332,0,0,0,0,4750,4750,2089,764,2853,1807,404,2211,1746,14,0,3,0,4,44,722,787
1,31/10/2022,01EF-Wimco Nagar Metro,167277,151903,200,3216,35470,0,0,206163,0,0,0,0,2000,2000,3732,957,4689,3729,1036,4765,3631,53,66,1,1,11,92,864,1088
1,31/10/2022,01F1-Thiruvotriyur Metro,155482,113765,0,864,24570,0,0,180916,0,0,0,0,0,0,3020,690,3710,3083,565,3648,2986,32,0,1,0,6,27,664,730
1,31/10/2022,01F3-Thiruvotriyur Theradi Metro,148656,132336,670,1832,29590,0,0,180748,0,0,0,0,0,0,3075,858,3933,3607,937,4544,3508,25,72,1,0,4,55,789,946
1,31/10/2022,01F5-Kaladipet Metro,144983,112342,500,1592,26040,0,0,173115,0,0,0,0,0,0,3143,832,3975,3330,721,4051,3216,26,0,1,0,5,47,777,856
1,31/10/2022,01F7-Tollgate Metro,83370,63662,0,1128,16788,0,0,101286,0,0,0,0,0,0,1733,435,2168,1774,355,2129,1719,9,0,0,0,5,29,500,543
1,31/10/2022,01F9-New Washermenpet Metro,131284,109030,1200,1056,21936,0,0,155476,0,0,0,0,500,500,3281,757,4038,3467,868,4335,3430,24,92,1,0,5,41,709,872
1,31/10/2022,01FB-Tondiarpet Metro,120963,112315,280,1072,28586,0,0,150901,0,0,0,0,500,500,3098,934,4032,3450,940,4390,3289,27,16,2,0,7,36,900,988
1,31/10/2022,01FD-Thiagaraya College Metro,148082,136517,500,1192,38700,0,0,188474,0,0,0,0,2250,2250,3787,1353,5140,4169,1030,5199,4038,45,21,0,0,3,45,1295,1409
1,31/10/2022,0101-Washermanpet,137227,141302,300,2448,42174,0,0,182149,0,0,0,0,5000,5000,4083,1497,5580,3921,1440,5361,3970,32,189,2,0,5,70,1389,1687
1,31/10/2022,0103-Mannadi,106815,119336,50,1248,30666,0,0,138779,0,0,0,0,4500,4500,3414,1110,4524,3744,1150,4894,3721,22,126,1,0,2,50,1053,1254
1,31/10/2022,0105-High Court,188457,257347,0,2928,66396,0,0,257781,0,0,0,0,0,0,7895,2415,10310,7287,1928,9215,7727,31,627,1,0,7,126,2244,3036
1,31/10/2022,0109-Government Estate,106493,160083,0,2952,51638,0,0,161083,0,0,0,0,0,0,4252,1928,6180,4813,1664,6477,4794,39,201,2,0,4,126,1739,2111
1,31/10/2022,0111-LIC,126355,187934,1200,3808,37198,0,0,168561,0,0,0,0,0,0,5476,1369,6845,6166,1037,7203,6081,31,0,0,0,0,122,1206,1359
1,31/10/2022,0113-Thousand Lights,200673,276671,300,6672,54072,0,0,261717,0,0,0,0,0,0,8203,2069,10272,9112,1651,10763,8998,44,28,2,0,5,271,1726,2076
1,31/10/2022,0115-AG-DMS,150872,159908,1000,2504,27208,0,0,181584,0,0,0,0,1000,1000,5350,1020,6370,5172,811,5983,5276,23,198,0,0,0,95,857,1173
1,31/10/2022,0117-Teynampet,139645,163182,1500,1872,31940,0,0,174957,0,0,0,0,0,0,5041,1207,6248,5647,1060,6707,5495,30,1,0,0,0,83,1077,1191
1,31/10/2022,0119-Nandanam,147610,138731,200,2256,33224,0,0,183290,0,0,0,0,0,0,4170,1268,5438,4708,958,5666,4503,27,0,2,0,3,92,1122,1246
1,31/10/2022,0121-Saidapet,71377,93558,200,1664,24880,0,0,98121,0,0,0,0,4500,4500,2124,899,3023,2885,883,3768,2790,14,0,0,0,1,69,810,894
1,31/10/2022,0123-Little Mount,118723,106339,1080,1888,27604,0,0,149295,0,0,0,0,1000,1000,3714,1067,4781,3184,771,3955,3241,22,188,1,0,1,87,920,1219
1,31/10/2022,0125-Guindy,186551,281653,1250,6880,69822,0,0,264503,0,0,0,0,0,0,8608,2531,11139,7989,2682,10671,8432,44,740,2,0,5,266,2177,3234
1,31/10/2022,0129-Nanganallur Road,62848,51060,900,728,12618,0,0,77094,0,0,0,0,0,0,1426,386,1812,1566,333,1899,1477,7,1,0,0,0,14,362,384
1,31/10/2022,0131-Meenambakkam,183564,147809,600,2248,41892,0,0,228304,0,0,0,0,0,0,4162,1226,5388,3585,885,4470,3622,27,224,6,0,1,65,1152,1475
1,31/10/2022,0133-Chennai International Airport,225978,370440,1550,9064,161248,0,0,397840,0,0,0,0,3750,3750,6389,4456,10845,6713,3600,10313,6759,61,742,11,1,26,273,3983,5097
2,31/10/2022,0201-Puratchi Thalaivar Dr. M.G. Ramachandran Central,371161,504830,1870,16680,133164,0,0,522875,0,0,0,0,7850,7850,15880,4988,20868,11902,7683,19585,15311,93,4223,3,0,5,656,4028,9008
2,31/10/2022,0203-Egmore,124791,149278,78,4240,60756,0,0,189865,0,0,0,0,19250,19250,3565,2185,5750,2913,2565,5478,3542,35,1065,3,0,4,166,1985,3258
2,31/10/2022,0205-Nehru Park,50036,52384,0,912,17696,0,0,68644,0,0,0,0,4250,4250,1495,675,2170,1495,556,2051,1470,20,90,0,0,0,40,610,760
2,31/10/2022,0207-Kilpauk,58063,64677,1500,880,19372,0,0,79815,0,0,0,0,0,0,1703,713,2416,1878,609,2487,1842,10,97,1,0,2,37,670,817
2,31/10/2022,0209-Pachaiyappas College,58340,56251,0,936,14502,0,0,73778,0,0,0,0,6000,6000,1921,595,2516,1835,504,2339,1769,16,108,1,0,3,39,545,712
2,31/10/2022,0211-Shenoy Nagar,58159,55140,600,840,13024,0,0,72623,0,0,0,0,2250,2250,1526,473,1999,1749,478,2227,1734,10,93,0,0,2,26,442,573
2,31/10/2022,0213-Anna Nagar East,126981,119689,2786,1912,29324,0,0,161003,0,0,0,0,6000,6000,3518,1108,4626,3624,984,4608,3607,16,188,1,0,1,84,993,1283
2,31/10/2022,0215-Anna Nagar Tower,119157,112120,0,1752,24950,0,0,145859,0,0,0,0,1500,1500,3323,917,4240,3374,871,4245,3388,19,210,2,0,3,59,831,1124
2,31/10/2022,0217-Thirumangalam,365299,335705,1857,8432,86548,0,0,462136,0,0,0,0,0,0,8931,2994,11925,9524,2896,12420,9402,76,490,4,0,3,264,2632,3469
2,31/10/2022,0219-Koyambedu,265319,276266,224,7224,87396,0,0,360163,0,0,0,10000,14750,24750,7180,3038,10218,6369,2355,8724,6920,61,1019,3,0,15,242,2680,4020
2,31/10/2022,0221-Puratchi Thalaivi Dr. J. Jayalalithaa CMBT,126961,220670,800,4928,83456,0,0,216145,0,0,0,0,0,0,4438,2813,7251,3961,3550,7511,5067,30,1749,3,0,4,206,2501,4493
2,31/10/2022,0223-Arumbakkam,82575,67617,20,1576,23870,0,0,108041,0,0,0,0,5250,5250,1736,876,2612,1964,702,2666,1796,22,4,5,0,3,49,817,900
2,31/10/2022,0225-Vadapalani,173914,232158,843,6208,58390,0,0,239355,0,0,0,0,7500,7500,6024,2172,8196,5828,2650,8478,6645,46,1208,3,0,6,250,1789,3302
2,31/10/2022,0227-Ashok Nagar,112966,158538,2086,2696,48932,0,0,166680,0,0,0,0,0,0,4019,1688,5707,4382,1618,6000,4298,38,311,8,0,0,115,1503,1975
2,31/10/2022,0229-Ekkattuthangal,117155,145818,1550,2904,30398,0,0,152007,0,0,0,0,1000,1000,4051,1111,5162,4591,1162,5753,4623,33,297,2,0,2,127,933,1394
2,31/10/2022,0231-Arignar Anna Alandur,204634,213173,430,4912,67422,0,0,277398,0,0,0,0,2250,2250,5738,2310,8048,5508,1726,7234,5690,45,454,4,0,7,186,2061,2757
2,31/10/2022,0233-St. Thomas Mount,109646,118855,1000,3272,34928,0,0,148846,0,0,0,3400,9900,13300,3150,1229,4379,3424,990,4414,3295,26,57,3,0,2,105,1083,1276
1,01/11/2022,01ED-Wimco Nagar Depot Metro,60791,66628,2300,1776,22534,0,0,87401,0,0,0,0,5750,5750,1778,616,2394,1406,357,1763,1391,14,0,5,0,3,51,552,625
1,01/11/2022,01EF-Wimco Nagar Metro,144974,118399,500,2704,25530,0,0,173708,0,0,0,0,0,0,3062,708,3770,2873,722,3595,2895,56,69,1,1,8,71,628,834
1,01/11/2022,01F1-Thiruvotriyur Metro,128243,83088,0,1400,16724,0,0,146367,0,0,0,0,0,0,2245,480,2725,2249,461,2710,2199,26,0,1,0,8,43,435,513
1,01/11/2022,01F3-Thiruvotriyur Theradi Metro,78620,101600,114,1528,23010,0,0,103272,0,0,0,0,0,0,2342,691,3033,2696,738,3434,2680,26,34,2,0,4,52,615,733
1,01/11/2022,01F5-Kaladipet Metro,121612,82615,0,1184,19540,0,0,142336,0,0,0,0,0,0,2378,614,2992,2366,509,2875,2295,31,0,0,0,0,40,565,636
1,01/11/2022,01F7-Tollgate Metro,65406,46363,510,576,12998,0,0,79490,0,0,0,0,0,0,1147,421,1568,1224,339,1563,1206,11,0,0,0,3,19,389,422
1,01/11/2022,01F9-New Washermenpet Metro,106861,86630,100,1000,19256,0,0,127217,0,0,0,0,250,250,2553,643,3196,2537,608,3145,2573,19,93,0,0,4,36,600,752
1,01/11/2022,01FB-Tondiarpet Metro,77463,87889,500,1416,25380,0,0,104759,0,0,0,0,500,500,2408,836,3244,2501,750,3251,2448,29,3,2,0,3,41,780,858
1,01/11/2022,01FD-Thiagaraya College Metro,99077,101707,1330,1672,27460,0,0,129539,0,0,0,0,1000,1000,2915,995,3910,3058,822,3880,3029,36,14,0,0,1,63,919,1033
1,01/11/2022,0101-Washermanpet,114822,115067,2250,1448,33028,0,0,151548,0,0,0,0,6750,6750,3447,1172,4619,3017,1080,4097,3257,23,378,0,0,5,59,1100,1565
1,01/11/2022,0103-Mannadi,64541,89696,0,1128,24320,0,0,89989,0,0,0,0,0,0,2430,914,3344,2708,956,3664,2761,16,192,0,0,0,47,851,1106
1,01/11/2022,0105-High Court,166163,213677,0,2960,60672,0,0,229795,0,0,0,0,0,0,6200,2223,8423,6374,1857,8231,6381,42,176,2,0,1,110,2063,2394
1,01/11/2022,0109-Government Estate,77552,125792,300,1848,39242,0,0,118942,0,0,0,0,2750,2750,3386,1503,4889,3927,1328,5255,3853,23,91,3,0,1,90,1347,1555
1,01/11/2022,0111-LIC,118448,164121,3500,2400,30908,0,0,155256,0,0,0,0,1000,1000,4697,1147,5844,5419,991,6410,5359,34,54,0,0,1,96,1005,1190
1,01/11/2022,0113-Thousand Lights,207238,232431,4688,5552,38400,0,0,255878,0,0,0,0,0,0,6970,1291,8261,7516,1464,8980,7740,55,344,0,0,4,228,1177,1808
1,01/11/2022,0115-AG-DMS,121520,139736,503,3896,27552,0,0,153471,0,0,0,0,3000,3000,4361,953,5314,4310,781,5091,4444,31,194,0,1,1,78,825,1130
1,01/11/2022,0117-Teynampet,114440,113879,1150,1832,27004,0,0,144426,0,0,0,0,0,0,3208,1020,4228,3771,869,4640,3658,25,0,2,0,1,78,901,1007
1,01/11/2022,0119-Nandanam,124923,120046,1720,2680,29610,0,0,158933,0,0,0,0,500,500,3562,1154,4716,3957,928,4885,3840,42,0,0,0,2,104,1012,1160
1,01/11/2022,0121-Saidapet,65090,75254,830,1208,21582,0,0,88710,0,0,0,0,12750,12750,1855,775,2630,2250,765,3015,2195,22,0,1,0,0,52,700,775
1,01/11/2022,0123-Little Mount,109898,87882,1620,1696,21774,0,0,134988,0,0,0,0,2000,2000,3121,833,3954,2629,637,3266,2713,17,177,1,0,0,68,720,983
1,01/11/2022,0125-Guindy,177045,219963,2956,6528,51082,0,0,237611,0,0,0,0,0,0,6895,1924,8819,6323,1920,8243,6798,60,571,0,0,2,224,1607,2464
1,01/11/2022,0129-Nanganallur Road,59310,38034,0,616,9250,0,0,69176,0,0,0,0,0,0,1041,299,1340,1149,270,1419,1104,13,0,0,0,0,17,270,300
1,01/11/2022,0131-Meenambakkam,162620,116386,850,2232,30384,0,0,196086,0,0,0,0,0,0,3502,912,4414,2807,655,3462,2944,24,194,7,0,4,74,825,1128
1,01/11/2022,0133-Chennai International Airport,219613,302996,5300,7152,131584,0,0,363649,0,0,0,0,3750,3750,5034,3652,8686,5234,3076,8310,5528,62,854,11,3,12,208,3271,4421
2,01/11/2022,0201-Puratchi Thalaivar Dr. M.G. Ramachandran Central,298801,419017,3018,12280,134388,0,0,448487,0,0,0,0,3800,3800,12309,4961,17270,10542,6853,17395,12122,116,2475,8,0,15,433,4366,7413
2,01/11/2022,0203-Egmore,91110,134334,100,2816,59952,0,0,153978,0,0,0,0,17500,17500,2773,2017,4790,2704,2444,5148,3044,26,757,15,0,8,113,1929,2848
2,01/11/2022,0205-Nehru Park,37294,42934,400,1104,14096,0,0,52894,0,0,0,0,0,0,1235,554,1789,1167,450,1617,1234,19,125,0,0,3,49,496,692
2,01/11/2022,0207-Kilpauk,52698,56524,100,1280,18710,0,0,72788,0,0,0,0,1000,1000,1389,687,2076,1529,646,2175,1523,19,88,0,0,1,50,617,775
2,01/11/2022,0209-Pachaiyappas College,48403,46936,0,656,15010,0,0,64069,0,0,0,0,5000,5000,1403,568,1971,1320,474,1794,1330,9,82,1,0,0,31,518,641
2,01/11/2022,0211-Shenoy Nagar,51767,48480,0,792,14142,0,0,66701,0,0,0,0,0,0,1297,512,1809,1399,446,1845,1383,13,75,0,1,2,34,477,602
2,01/11/2022,0213-Anna Nagar East,106232,96947,300,1824,26490,0,0,134846,0,0,0,0,0,0,2700,986,3686,2747,786,3533,2773,26,164,2,0,0,79,883,1154
2,01/11/2022,0215-Anna Nagar Tower,102422,87347,100,1376,20460,0,0,124358,0,0,0,0,2750,2750,2467,756,3223,2545,647,3192,2591,21,170,0,0,1,55,676,923
2,01/11/2022,0217-Thirumangalam,307225,271540,900,6976,68180,0,0,383281,0,0,0,0,0,0,7311,2345,9656,7389,2376,9765,7630,71,579,2,0,0,192,2090,2934
2,01/11/2022,0219-Koyambedu,228180,208025,1400,5136,67924,0,0,302640,0,0,0,0,13250,13250,5409,2337,7746,4765,1999,6764,5164,50,694,2,0,7,153,2091,2997
2,01/11/2022,0221-Puratchi Thalaivi Dr. J. Jayalalithaa CMBT,92580,156842,840,3328,66914,0,0,163662,0,0,0,0,0,0,2732,2209,4941,3336,3263,6599,3456,41,798,3,0,0,91,2052,2985
2,01/11/2022,0223-Arumbakkam,67744,66409,600,1128,27726,0,0,97198,0,0,0,0,9500,9500,1580,984,2564,1694,690,2384,1560,32,1,3,0,5,47,919,1007
2,01/11/2022,0225-Vadapalani,147140,190968,1448,4576,66852,0,0,220016,0,0,0,0,5000,5000,4486,2349,6835,4494,2285,6779,4779,39,639,1,0,9,186,2053,2927
2,01/11/2022,0227-Ashok Nagar,115805,142040,3712,3632,43918,0,0,167067,0,0,0,0,0,0,3636,1510,5146,3504,1418,4922,3744,37,479,5,0,4,124,1323,1972
2,01/11/2022,0229-Ekkattuthangal,127878,117206,1400,4528,25734,0,0,159540,0,0,0,0,0,0,3301,1003,4304,3470,922,4392,3652,20,288,0,0,1,144,805,1258
2,01/11/2022,0231-Arignar Anna Alandur,184983,162028,1700,4600,52822,0,0,244105,0,0,0,0,5000,5000,4487,1848,6335,4102,1331,5433,4301,58,352,3,0,0,159,1613,2185
2,01/11/2022,0233-St. Thomas Mount,98855,95793,510,3544,28786,0,0,131695,0,0,0,0,1950,1950,2638,1034,3672,2695,740,3435,2670,20,61,1,0,1,97,898,1078
1,02/11/2022,01ED-Wimco Nagar Depot Metro,76602,60494,300,1304,20084,0,0,98290,0,0,0,0,5000,5000,1658,534,2192,1295,349,1644,1274,19,3,1,0,2,41,489,555
1,02/11/2022,01EF-Wimco Nagar Metro,121981,118963,1500,2800,29690,0,0,155971,0,0,0,0,2500,2500,2980,807,3787,2791,684,3475,2794,34,76,1,0,6,77,720,914
1,02/11/2022,01F1-Thiruvotriyur Metro,105362,73978,0,1168,16878,0,0,123408,0,0,0,0,0,0,1907,470,2377,1941,416,2357,1899,13,0,4,0,3,35,436,491
1,02/11/2022,01F3-Thiruvotriyur Theradi Metro,83084,100006,700,2320,22666,0,0,108770,0,0,0,0,0,0,2423,696,3119,2610,666,3276,2613,11,60,1,1,4,68,606,751
1,02/11/2022,01F5-Kaladipet Metro,95439,81171,100,1376,21100,0,0,118015,0,0,0,0,0,0,1644,655,2299,2257,599,2856,2206,25,0,0,0,0,45,601,671
1,02/11/2022,01F7-Tollgate Metro,62840,45454,100,728,12200,0,0,75868,0,0,0,0,250,250,1273,390,1663,1235,334,1569,1217,14,0,1,0,1,21,359,396
1,02/11/2022,01F9-New Washermenpet Metro,114465,80116,300,1160,18172,0,0,134097,0,0,0,0,0,0,2463,611,3074,2402,574,2976,2396,18,66,3,0,3,42,566,698
1,02/11/2022,01FB-Tondiarpet Metro,77557,84086,800,2056,26580,0,0,106993,0,0,0,0,250,250,2276,850,3126,2326,703,3029,2275,19,0,0,0,4,58,795,876
1,02/11/2022,01FD-Thiagaraya College Metro,91149,97246,100,1672,25416,0,0,118337,0,0,0,0,250,250,2874,899,3773,2952,710,3662,2929,49,36,2,0,0,60,827,974
1,02/11/2022,0101-Washermanpet,119336,109889,400,2552,37970,0,0,160258,0,0,0,0,15250,15250,3086,1301,4387,2787,1068,3855,2890,23,145,2,1,6,86,1198,1461
1,02/11/2022,0103-Mannadi,62774,85626,0,1480,24990,0,0,89244,0,0,0,0,0,0,2357,891,3248,2576,910,3486,2578,14,80,1,0,2,42,831,970
1,02/11/2022,0105-High Court,154211,218721,1300,2864,57804,0,0,216179,0,0,0,0,0,0,6318,2120,8438,6592,1762,8354,6626,32,170,0,0,5,109,1971,2287
1,02/11/2022,0109-Government Estate,94623,137844,750,2184,42348,0,0,139905,0,0,0,0,3500,3500,3748,1593,5341,4180,1425,5605,4262,33,196,2,0,1,105,1431,1768
1,02/11/2022,0111-LIC,93844,139258,300,2488,25734,0,0,122366,0,0,0,0,0,0,4191,989,5180,4683,834,5517,4637,30,0,0,0,2,104,848,984
1,02/11/2022,0113-Thousand Lights,200747,232060,4040,5392,33776,0,0,243955,0,0,0,0,0,0,7356,1368,8724,7640,1331,8971,7924,47,331,0,1,5,219,1055,1658
1,02/11/2022,0115-AG-DMS,109540,120677,1200,1936,23552,0,0,136228,0,0,0,0,2000,2000,3753,853,4606,3742,740,4482,3869,28,152,2,0,1,75,728,986
1,02/11/2022,0117-Teynampet,110148,114968,600,1872,26302,0,0,138922,0,0,0,0,0,0,3372,1007,4379,3882,811,4693,3794,32,0,2,0,1,83,876,994
1,02/11/2022,0119-Nandanam,126007,123178,1802,2144,28478,0,0,158431,0,0,0,0,2500,2500,3821,1096,4917,4150,863,5013,4065,38,0,0,0,1,89,962,1090
1,02/11/2022,0121-Saidapet,64660,71272,500,1472,19984,0,0,86616,0,0,0,0,4000,4000,1848,712,2560,2187,667,2854,2134,14,0,0,0,0,48,650,712
1,02/11/2022,0123-Little Mount,100007,87105,2610,1368,21238,0,0,125223,0,0,0,0,750,750,3082,804,3886,2685,598,3283,2719,25,144,0,0,4,54,712,939
1,02/11/2022,0125-Guindy,184370,218911,4570,6352,54942,0,0,250234,0,0,0,0,3000,3000,6763,2027,8790,6408,1980,8388,6699,40,448,3,1,2,212,1711,2417
1,02/11/2022,0129-Nanganallur Road,44868,44686,500,672,9558,0,0,55598,0,0,0,0,0,0,1269,315,1584,1378,291,1669,1340,13,4,1,0,2,22,285,327
1,02/11/2022,0131-Meenambakkam,149241,109238,1900,2728,27516,0,0,181385,0,0,0,0,0,0,3214,843,4057,2646,672,3318,2815,27,193,1,0,1,80,762,1064
1,02/11/2022,0133-Chennai International Airport,201311,311195,1600,7112,145774,0,0,355797,0,0,0,0,7500,7500,4944,3998,8942,5328,3379,8707,5402,62,627,13,0,2,218,3615,4537
2,02/11/2022,0201-Puratchi Thalaivar Dr. M.G. Ramachandran Central,298229,398534,1894,11944,107264,0,0,419331,0,0,0,0,3800,3800,12110,3999,16109,9690,6710,16400,12195,111,3235,5,0,11,399,3457,7218
2,02/11/2022,0203-Egmore,76629,124276,17,2624,54026,0,0,133296,0,0,0,0,11000,11000,2644,1894,4538,2509,2478,4987,2892,21,785,10,0,3,92,1748,2659
2,02/11/2022,0205-Nehru Park,41840,40952,0,808,14490,0,0,57138,0,0,0,0,250,250,1167,550,1717,1120,442,1562,1128,18,104,0,0,0,30,497,649
2,02/11/2022,0207-Kilpauk,44635,54721,50,2584,17748,0,0,65017,0,0,0,0,0,0,1354,649,2003,1492,587,2079,1498,12,105,3,0,1,44,592,757
2,02/11/2022,0209-Pachaiyappas College,51705,41426,1050,2864,11804,0,0,67423,0,0,0,0,4000,4000,1304,440,1744,1190,408,1598,1227,19,88,1,0,1,34,399,542
2,02/11/2022,0211-Shenoy Nagar,45390,46004,0,1000,12990,0,0,59380,0,0,0,0,0,0,1269,472,1741,1322,384,1706,1336,14,87,1,0,3,41,417,563
2,02/11/2022,0213-Anna Nagar East,87076,91956,3400,1840,24654,0,0,116970,0,0,0,0,0,0,2526,879,3405,2552,781,3333,2614,24,178,0,0,2,71,786,1061
2,02/11/2022,0215-Anna Nagar Tower,99809,82004,228,1016,19808,0,0,120861,0,0,0,0,750,750,2288,689,2977,2410,732,3142,2411,32,193,3,0,1,40,637,906
2,02/11/2022,0217-Thirumangalam,286358,279069,3715,7528,71168,0,0,368769,0,0,0,0,0,0,7438,2469,9907,7570,2163,9733,7752,88,506,3,0,7,244,2154,3002
2,02/11/2022,0219-Koyambedu,223238,189018,200,3856,66756,0,0,294050,0,0,0,0,9250,9250,4687,2267,6954,4352,1620,5972,4490,60,437,9,0,13,145,2073,2737
2,02/11/2022,0221-Puratchi Thalaivi Dr. J. Jayalalithaa CMBT,70342,139376,646,3752,65344,0,0,140084,0,0,0,0,0,0,2060,2005,4065,3162,2873,6035,2841,29,334,5,0,1,93,2012,2474
2,02/11/2022,0223-Arumbakkam,75805,60529,150,2440,22302,0,0,100697,0,0,0,0,12000,12000,1537,810,2347,1620,605,2225,1527,27,0,1,0,3,61,730,822
2,02/11/2022,0225-Vadapalani,191401,173931,1130,4680,61784,0,0,258995,0,0,0,0,68000,68000,3938,2155,6093,3869,2146,6015,4220,52,704,2,1,2,168,1885,2814
2,02/11/2022,0227-Ashok Nagar,96397,136153,800,3024,44576,0,0,144797,0,0,0,0,3000,3000,3384,1554,4938,3362,1275,4637,3493,40,327,2,0,4,121,1338,1832
2,02/11/2022,0229-Ekkattuthangal,112853,122060,1300,4216,27212,0,0,145581,0,0,0,0,1000,1000,3383,1048,4431,3603,968,4571,3795,21,269,0,0,1,141,845,1277
2,02/11/2022,0231-Arignar Anna Alandur,197575,168474,1100,3984,46092,0,0,248751,0,0,0,0,5250,5250,4827,1610,6437,4529,1386,5915,4759,54,392,8,0,3,137,1392,1986
2,02/11/2022,0233-St. Thomas Mount,81579,87574,900,2104,27578,0,0,112161,0,0,0,0,0,0,2340,933,3273,2317,759,3076,2350,18,138,0,0,3,71,829,1059
1,03/11/2022,01ED-Wimco Nagar Depot Metro,117991,77277,0,1432,21890,0,0,141313,0,0,0,0,4750,4750,2087,574,2661,1826,330,2156,1762,10,0,3,0,3,42,525,583
1,03/11/2022,01EF-Wimco Nagar Metro,167873,145294,500,4288,28618,0,0,201279,0,0,0,0,1250,1250,3715,804,4519,3690,699,4389,3626,45,156,1,1,2,91,688,984
1,03/11/2022,01F1-Thiruvotriyur Metro,151102,107388,0,1096,18938,0,0,171136,0,0,0,0,0,0,2985,544,3529,3074,403,3477,2964,24,0,2,0,1,34,513,574
1,03/11/2022,01F3-Thiruvotriyur Theradi Metro,142280,126538,615,2160,23666,0,0,168721,0,0,0,0,0,0,3093,722,3815,3593,665,4258,3491,23,104,3,0,2,58,642,832
1,03/11/2022,01F5-Kaladipet Metro,120967,107185,0,2048,20938,0,0,143953,0,0,0,0,0,0,3093,686,3779,3322,617,3939,3200,19,37,0,0,3,46,638,743
1,03/11/2022,01F7-Tollgate Metro,68418,58304,300,728,11122,0,0,80568,0,0,0,0,0,0,1713,365,2078,1787,288,2075,1717,11,37,0,0,4,20,331,403
1,03/11/2022,01F9-New Washermenpet Metro,131734,107327,550,840,20650,0,0,153774,0,0,0,0,500,500,3268,698,3966,3494,620,4114,3402,16,122,1,0,4,30,667,840
1,03/11/2022,01FB-Tondiarpet Metro,115364,110347,1240,1096,28638,0,0,146338,0,0,0,0,1250,1250,3059,949,4008,3504,782,4286,3266,20,1,3,0,3,39,895,961
1,03/11/2022,01FD-Thiagaraya College Metro,156929,127896,2300,1640,26356,0,0,187225,0,0,0,0,2000,2000,3980,979,4959,4326,843,5169,4183,22,128,0,0,5,62,905,1122
1,03/11/2022,0101-Washermanpet,138909,137089,3315,1728,38658,0,0,182610,0,0,0,0,7750,7750,4163,1359,5522,4237,1111,5348,4055,24,198,3,0,5,60,1281,1571
1,03/11/2022,0103-Mannadi,108235,117942,100,992,23750,0,0,133077,0,0,0,0,3000,3000,3674,878,4552,3803,974,4777,3999,25,439,3,0,0,42,820,1329
1,03/11/2022,0105-High Court,170795,250675,250,3200,57782,0,0,232027,0,0,0,0,0,0,8279,2178,10457,7379,1681,9060,7916,35,731,1,0,3,126,2035,2931
1,03/11/2022,0109-Government Estate,109661,156654,1600,2880,39716,0,0,153857,0,0,0,0,750,750,4626,1547,6173,4974,1323,6297,5107,24,438,4,0,6,132,1371,1975
1,03/11/2022,0111-LIC,125658,188219,459,3304,25496,0,0,154917,0,0,0,2000,0,2000,6153,1026,7179,6216,915,7131,6489,35,341,0,0,0,141,855,1372
1,03/11/2022,0113-Thousand Lights,196242,274946,2300,6704,33852,0,0,239098,0,0,0,0,1250,1250,9426,1409,10835,9011,1312,10323,9594,50,701,1,0,2,280,1084,2118
1,03/11/2022,0115-AG-DMS,150435,163384,50,2408,24972,0,0,177865,0,0,0,0,0,0,5796,923,6719,5199,672,5871,5436,33,376,0,0,0,96,785,1290
1,03/11/2022,0117-Teynampet,129576,156032,500,1824,28216,0,0,160116,0,0,0,0,1250,1250,5174,1065,6239,5317,838,6155,5307,26,189,1,0,2,79,951,1248
1,03/11/2022,0119-Nandanam,123065,137234,1913,2504,30578,0,0,158060,0,0,0,0,500,500,4358,1205,5563,4739,807,5546,4595,29,0,0,0,2,105,1057,1193
1,03/11/2022,0121-Saidapet,58809,88842,100,1616,23046,0,0,83571,0,0,0,0,2000,2000,2159,823,2982,2825,671,3496,2693,15,0,0,0,0,67,745,827
1,03/11/2022,0123-Little Mount,119902,100662,300,1888,21438,0,0,143528,0,0,0,0,5000,5000,3946,852,4798,3132,592,3724,3229,31,230,2,0,3,64,727,1057
1,03/11/2022,0125-Guindy,201330,270151,2900,7280,43538,0,0,255048,0,0,0,0,4500,4500,9008,1672,10680,8080,1992,10072,8957,49,1197,1,0,4,236,1346,2833
1,03/11/2022,0129-Nanganallur Road,48570,48050,100,656,11270,0,0,60596,0,0,0,0,0,0,1397,342,1739,1486,277,1763,1431,11,0,0,0,0,18,320,349
1,03/11/2022,0131-Meenambakkam,163791,141828,1300,1944,30214,0,0,197249,0,0,0,0,0,0,4381,911,5292,3666,652,4318,3804,26,317,8,0,2,67,838,1258
1,03/11/2022,0133-Chennai International Airport,213586,324706,800,8224,126258,0,0,348868,0,0,0,0,2250,2250,5982,3489,9471,6493,2881,9374,6430,50,846,11,0,12,232,3157,4308
2,03/11/2022,0201-Puratchi Thalaivar Dr. M.G. Ramachandran Central,334878,466731,530,11952,93036,0,0,440396,0,0,0,0,8200,8200,15211,3604,18815,13327,6162,19489,15674,89,3995,16,0,13,393,3075,7581
2,03/11/2022,0203-Egmore,97664,131600,1400,2216,43754,0,0,145034,0,0,0,0,8750,8750,3133,1536,4669,3318,2182,5500,3560,31,979,12,0,7,101,1457,2587
2,03/11/2022,0205-Nehru Park,47090,50898,200,1016,13984,0,0,62290,0,0,0,0,2250,2250,1689,532,2221,1456,387,1843,1534,17,234,4,0,1,34,494,784
2,03/11/2022,0207-Kilpauk,56763,66284,1200,2192,20878,0,0,81033,0,0,0,0,0,0,1771,770,2541,1847,545,2392,1833,27,134,1,0,0,53,706,921
2,03/11/2022,0209-Pachaiyappas College,59396,56143,900,952,13720,0,0,74968,0,0,0,0,4000,4000,2036,551,2587,1799,390,2189,1787,13,159,1,0,0,44,495,712
2,03/11/2022,0211-Shenoy Nagar,58644,53826,500,744,10530,0,0,70418,0,0,0,0,3000,3000,1633,393,2026,1744,378,2122,1742,16,148,0,0,1,29,355,549
2,03/11/2022,0213-Anna Nagar East,116793,118225,308,2632,21698,0,0,141431,0,0,0,0,0,0,3851,827,4678,3622,767,4389,3823,30,419,3,0,0,91,713,1256
2,03/11/2022,0215-Anna Nagar Tower,119402,109279,1306,1592,20606,0,0,142906,0,0,0,0,250,250,3418,771,4189,3263,619,3882,3404,16,371,1,0,2,66,689,1145
2,03/11/2022,0217-Thirumangalam,296190,306276,850,5800,63754,0,0,366594,0,0,0,0,0,0,9160,2225,11385,8861,1998,10859,9132,64,886,3,0,1,220,1965,3139
2,03/11/2022,0219-Koyambedu,203291,236490,950,4192,56484,0,0,264917,0,0,0,0,12500,12500,6523,1993,8516,6584,1665,8249,6631,50,788,4,0,5,151,1795,2793
2,03/11/2022,0221-Puratchi Thalaivi Dr. J. Jayalalithaa CMBT,87784,143712,2500,2616,50340,0,0,143240,0,0,0,0,0,0,2871,1668,4539,3852,2476,6328,3676,29,791,2,0,0,103,1560,2485
2,03/11/2022,0223-Arumbakkam,69792,63537,0,1264,22480,0,0,93536,0,0,0,0,2000,2000,1806,808,2614,1868,501,2369,1675,31,3,2,0,1,52,743,832
2,03/11/2022,0225-Vadapalani,132174,194477,0,5168,40114,0,0,177456,0,0,0,0,4000,4000,5704,1483,7187,5211,1807,7018,5876,30,1161,0,0,5,202,1230,2628
2,03/11/2022,0227-Ashok Nagar,107442,143826,350,3664,40002,0,0,151458,0,0,0,0,3000,3000,3976,1430,5406,4158,1204,5362,4108,29,368,1,0,0,145,1240,1783
2,03/11/2022,0229-Ekkattuthangal,106344,131060,1700,2736,21392,0,0,132172,0,0,0,0,1250,1250,3701,800,4501,4403,748,5151,4520,21,299,1,0,4,112,663,1100
2,03/11/2022,0231-Arignar Anna Alandur,195241,212417,200,4680,44514,0,0,244635,0,0,0,0,2250,2250,6111,1585,7696,6562,1465,8027,6724,38,563,5,0,2,169,1338,2115
2,03/11/2022,0233-St. Thomas Mount,85605,92834,200,2624,26760,0,0,115189,0,0,0,0,1525,1525,2834,942,3776,2607,689,3296,2595,17,195,0,0,1,100,808,1121
1,04/11/2022,01ED-Wimco Nagar Depot Metro,92179,70344,100,1688,23800,0,0,117767,0,0,0,0,5500,5500,1823,628,2451,1451,311,1762,1454,13,0,1,0,7,49,571,641
1,04/11/2022,01EF-Wimco Nagar Metro,126862,128936,50,3792,30842,0,0,161546,0,0,0,0,250,250,3244,863,4107,2957,844,3801,3053,48,129,3,0,5,114,760,1059
1,04/11/2022,01F1-Thiruvotriyur Metro,108842,87727,200,1640,19584,0,0,130266,0,0,0,0,0,0,2435,577,3012,2303,461,2764,2273,23,12,5,0,4,57,516,617
1,04/11/2022,01F3-Thiruvotriyur Theradi Metro,99874,108681,1040,2288,26614,0,0,129816,0,0,0,0,0,0,2691,786,3477,2834,733,3567,2827,19,73,2,0,5,70,705,874
1,04/11/2022,01F5-Kaladipet Metro,103258,92351,200,1736,26320,0,0,131514,0,0,0,0,0,0,2516,805,3321,2512,643,3155,2434,13,0,1,0,5,58,739,816
1,04/11/2022,01F7-Tollgate Metro,55988,50121,100,600,14746,0,0,71434,0,0,0,0,0,0,1394,462,1856,1329,322,1651,1290,16,0,2,0,7,21,435,481
1,04/11/2022,01F9-New Washermenpet Metro,103328,86880,1000,1304,23224,0,0,128856,0,0,0,0,250,250,2562,763,3325,2518,646,3164,2480,12,44,2,0,6,42,716,822
1,04/11/2022,01FB-Tondiarpet Metro,78850,89308,1466,1520,27760,0,0,109596,0,0,0,0,250,250,2422,883,3305,2470,724,3194,2395,21,2,1,0,6,54,815,899
1,04/11/2022,01FD-Thiagaraya College Metro,99846,108533,2000,2224,30136,0,0,134206,0,0,0,0,1750,1750,3106,1045,4151,3216,842,4058,3170,24,19,3,0,4,78,946,1074
1,04/11/2022,0101-Washermanpet,110190,114389,480,2032,37310,0,0,150012,0,0,0,0,13750,13750,3423,1298,4721,3018,1026,4044,3086,26,191,2,0,5,82,1209,1515
1,04/11/2022,0103-Mannadi,79188,94674,0,1432,26358,0,0,106978,0,0,0,0,0,0,2690,938,3628,2824,1048,3872,2879,15,185,2,0,0,49,875,1126
1,04/11/2022,0105-High Court,140266,232411,2800,2760,63250,0,0,209076,0,0,0,0,0,0,6403,2300,8703,6877,1799,8676,6942,41,210,3,0,3,120,2128,2505
1,04/11/2022,0109-Government Estate,90666,149614,850,2592,47686,0,0,141794,0,0,0,0,750,750,3936,1817,5753,4544,1490,6034,4504,28,176,0,0,4,128,1634,1970
1,04/11/2022,0111-LIC,102536,160259,1800,2816,32402,0,0,139554,0,0,0,0,250,250,4525,1190,5715,5153,978,6131,5163,30,84,0,0,1,116,1027,1258
1,04/11/2022,0113-Thousand Lights,188984,246162,2360,5536,33728,0,0,230608,0,0,0,0,0,0,7680,1363,9043,8017,1383,9400,8414,42,519,8,0,4,237,1046,1856
1,04/11/2022,0115-AG-DMS,107579,128239,2300,2312,24380,0,0,136571,0,0,0,0,1000,1000,3950,844,4794,3940,699,4639,4105,25,239,3,0,1,85,716,1069
1,04/11/2022,0117-Teynampet,92918,120588,330,1864,26202,0,0,121314,0,0,0,0,1000,1000,3517,986,4503,4149,816,4965,4003,23,0,0,0,1,78,874,976
1,04/11/2022,0119-Nandanam,110631,133187,260,2864,31810,0,0,145565,0,0,0,0,0,0,3950,1209,5159,4326,940,5266,4289,32,68,4,0,4,114,1048,1270
1,04/11/2022,0121-Saidapet,47233,78740,520,2504,24392,0,0,74649,0,0,0,0,8500,8500,1936,865,2801,2257,681,2938,2168,10,0,2,0,1,67,795,875
1,04/11/2022,0123-Little Mount,101455,98250,350,2064,24182,0,0,128051,0,0,0,0,1000,1000,3482,913,4395,2887,608,3495,3023,19,240,2,0,3,86,780,1130
1,04/11/2022,0125-Guindy,171355,255887,2911,8096,59232,0,0,241594,0,0,0,0,1000,1000,8072,2196,10268,6910,2238,9148,7777,39,1105,3,0,4,272,1803,3226
1,04/11/2022,0129-Nanganallur Road,57235,48591,1400,672,12592,0,0,71899,0,0,0,0,0,0,1322,403,1725,1448,367,1815,1373,7,0,0,0,0,25,369,401
1,04/11/2022,0131-Meenambakkam,146309,124135,2260,2792,31782,0,0,183143,0,0,0,0,0,0,3632,971,4603,2923,747,3670,3136,25,303,3,0,4,85,874,1294
1,04/11/2022,0133-Chennai International Airport,195896,343904,250,9696,151582,0,0,357424,0,0,0,0,3750,3750,5897,4286,10183,5941,3790,9731,6195,56,845,13,0,19,284,3731,4948
2,04/11/2022,0201-Puratchi Thalaivar Dr. M.G. Ramachandran Central,294686,465532,1160,9832,136298,0,0,441976,0,0,0,0,10300,10300,12812,4962,17774,11907,7747,19654,13716,93,3198,9,0,16,409,4440,8165
2,04/11/2022,0203-Egmore,110378,145691,200,2600,43486,0,0,156664,0,0,0,0,9000,9000,3325,1520,4845,3306,2792,6098,4070,26,1331,3,0,18,119,1320,2817
2,04/11/2022,0205-Nehru Park,34382,51124,2100,1448,18312,0,0,56242,0,0,0,0,2250,2250,1409,703,2112,1367,514,1881,1403,11,132,0,0,1,61,619,824
2,04/11/2022,0207-Kilpauk,41637,62319,0,752,16030,0,0,58419,0,0,0,0,0,0,1795,566,2361,1651,650,2301,1826,11,327,1,0,5,36,535,915
2,04/11/2022,0209-Pachaiyappas College,39133,43268,0,560,13008,0,0,52701,0,0,0,0,2000,2000,1300,484,1784,1232,395,1627,1246,13,101,1,0,0,25,441,581
2,04/11/2022,0211-Shenoy Nagar,49177,45799,150,904,13790,0,0,64021,0,0,0,0,1000,1000,1252,507,1759,1298,429,1727,1294,16,80,0,0,0,34,467,597
2,04/11/2022,0213-Anna Nagar East,106274,106764,1100,2712,26972,0,0,137058,0,0,0,0,3000,3000,3091,1014,4105,3130,872,4002,3156,26,214,0,0,5,91,894,1230
2,04/11/2022,0215-Anna Nagar Tower,100536,92595,100,2000,22006,0,0,124642,0,0,0,0,250,250,2608,823,3431,2595,766,3361,2729,15,306,0,0,1,80,725,1127
2,04/11/2022,0217-Thirumangalam,271123,305587,3048,8464,88886,0,0,371521,0,0,0,0,0,0,8054,3107,11161,7931,2424,10355,8098,64,584,7,0,4,321,2686,3666
2,04/11/2022,0219-Koyambedu,225207,227085,1802,4216,76680,0,0,307905,0,0,0,0,16250,16250,5750,2656,8406,5170,2189,7359,5496,53,941,6,1,15,154,2368,3538
2,04/11/2022,0221-Puratchi Thalaivi Dr. J. Jayalalithaa CMBT,68248,169694,1890,2264,67342,0,0,139744,0,0,0,0,0,0,2441,2209,4650,4602,3945,8547,3934,26,527,7,0,3,81,2113,2757
2,04/11/2022,0223-Arumbakkam,66812,62740,900,2680,25420,0,0,95812,0,0,0,0,10750,10750,1629,946,2575,1656,699,2355,1528,21,5,1,0,2,49,875,953
2,04/11/2022,0225-Vadapalani,119650,205546,580,7304,79910,0,0,207444,0,0,0,0,4000,4000,4499,2899,7398,4598,2582,7180,4842,50,690,1,0,13,277,2462,3493
2,04/11/2022,0227-Ashok Nagar,115847,149827,2134,4232,46808,0,0,169021,0,0,0,0,3000,3000,3900,1709,5609,3641,1549,5190,3955,37,584,9,0,1,188,1451,2270
2,04/11/2022,0229-Ekkattuthangal,117200,139162,3220,5480,32202,0,0,158102,0,0,0,0,1000,1000,3994,1263,5257,3829,940,4769,4208,16,444,0,0,6,198,992,1656
2,04/11/2022,0231-Arignar Anna Alandur,183762,201038,300,5864,61288,0,0,251214,0,0,0,0,4250,4250,5478,2144,7622,5005,1628,6633,5378,45,588,4,0,6,207,1805,2655
2,04/11/2022,0233-St. Thomas Mount,83467,102540,450,3064,34864,0,0,121845,0,0,0,15400,2925,18325,2666,1223,3889,2661,886,3547,2652,19,116,0,0,1,119,1068,1323
1,05/11/2022,01ED-Wimco Nagar Depot Metro,69705,80251,0,1904,32602,0,0,104211,0,0,0,0,1250,1250,1878,825,2703,1609,486,2095,1493,23,4,1,0,9,55,790,882
1,05/11/2022,01EF-Wimco Nagar Metro,124581,140233,200,4016,39714,0,0,168511,0,0,0,0,500,500,3134,1054,4188,3199,937,4136,3098,51,232,2,0,12,114,940,1351
1,05/11/2022,01F1-Thiruvotriyur Metro,130615,101686,0,1656,27866,0,0,160137,0,0,0,0,0,0,2589,787,3376,2678,549,3227,2450,26,0,3,0,7,53,728,817
1,05/11/2022,01F3-Thiruvotriyur Theradi Metro,120879,125984,1900,1952,35904,0,0,160635,0,0,0,0,0,0,2916,1068,3984,3314,1076,4390,3088,22,128,1,0,9,63,964,1187
1,05/11/2022,01F5-Kaladipet Metro,110886,99834,0,3392,28612,0,0,142890,0,0,0,0,0,0,2644,948,3592,2814,770,3584,2637,16,0,2,0,2,99,835,954
1,05/11/2022,01F7-Tollgate Metro,67552,55961,100,1232,17130,0,0,86014,0,0,0,0,0,0,1502,564,2066,1574,484,2058,1415,37,0,0,0,5,45,498,585
1,05/11/2022,01F9-New Washermenpet Metro,100384,96887,500,1816,25082,0,0,127782,0,0,0,0,0,0,2710,843,3553,2836,765,3601,2757,21,136,0,0,6,60,781,1004
1,05/11/2022,01FB-Tondiarpet Metro,96116,102620,550,1496,35004,0,0,133166,0,0,0,0,250,250,2681,1137,3818,2978,908,3886,2674,18,0,1,0,8,57,1072,1156
1,05/11/2022,01FD-Thiagaraya College Metro,117369,124170,1300,3016,36090,0,0,157775,0,0,0,0,1000,1000,3462,1278,4740,3740,1068,4808,3546,63,84,0,0,6,108,1153,1414
1,05/11/2022,0101-Washermanpet,108486,135263,1320,3016,51642,0,0,164464,0,0,0,0,16500,16500,3390,1776,5166,3398,1359,4757,3361,16,298,0,0,8,117,1638,2077
1,05/11/2022,0103-Mannadi,97956,123333,0,1656,32386,0,0,131998,0,0,0,0,1500,1500,3099,1169,4268,3607,1284,4891,3701,23,466,2,0,4,77,1072,1644
1,05/11/2022,0105-High Court,130858,208423,3330,4344,68472,0,0,207004,0,0,0,0,0,0,4949,2417,7366,5333,1996,7329,5567,32,660,1,0,3,179,2176,3051
1,05/11/2022,0109-Government Estate,93735,162454,900,3872,64048,0,0,162555,0,0,0,0,5250,5250,3655,2400,6055,4646,1912,6558,4287,30,246,3,0,3,170,2130,2582
1,05/11/2022,0111-LIC,84455,144095,1700,3456,38358,0,0,127969,0,0,0,0,0,0,3668,1363,5031,4545,1130,5675,4253,30,0,2,0,8,132,1172,1344
1,05/11/2022,0113-Thousand Lights,150072,233707,1850,6344,51674,0,0,209940,0,0,0,0,0,0,6030,1974,8004,7178,1905,9083,7159,27,634,3,0,9,259,1587,2519
1,05/11/2022,0115-AG-DMS,117263,128096,1600,2280,24488,0,0,145631,0,0,0,0,0,0,3516,891,4407,3577,740,4317,3905,14,694,0,0,1,83,722,1514
1,05/11/2022,0117-Teynampet,92490,121156,300,1496,34254,0,0,128540,0,0,0,0,5000,5000,3413,1265,4678,4027,976,5003,3579,25,4,0,0,6,72,1153,1260
1,05/11/2022,0119-Nandanam,73096,93649,500,2176,32730,0,0,108502,0,0,0,0,500,500,2471,1208,3679,2904,789,3693,2558,28,0,1,0,5,93,1090,1217
1,05/11/2022,0121-Saidapet,40339,67938,550,1448,26718,0,0,69055,0,0,0,0,4000,4000,1350,944,2294,1904,869,2773,1650,11,0,9,0,2,63,850,935
1,05/11/2022,0123-Little Mount,79434,87480,380,2128,25828,0,0,107770,0,0,0,0,250,250,2349,953,3302,2254,688,2942,2373,20,492,2,0,6,79,831,1430
1,05/11/2022,0125-Guindy,227738,301530,1130,8520,58050,0,0,295438,0,0,0,0,1500,1500,7011,2204,9215,5950,2949,8899,8682,49,3612,5,0,15,304,1700,5685
1,05/11/2022,0129-Nanganallur Road,48060,43287,200,848,13742,0,0,62850,0,0,0,0,0,0,1043,428,1471,1290,382,1672,1118,11,0,5,0,5,22,387,430
1,05/11/2022,0131-Meenambakkam,150101,146897,890,5048,45020,0,0,201059,0,0,0,0,0,0,3372,1340,4712,3127,1164,4291,3362,36,624,3,0,3,106,1218,1990
1,05/11/2022,0133-Chennai International Airport,215373,399615,1225,14112,184710,0,0,415420,0,0,0,0,750,750,5198,5328,10526,7031,4503,11534,6704,69,1826,18,1,24,401,4400,6739
2,05/11/2022,0201-Puratchi Thalaivar Dr. M.G. Ramachandran Central,373213,592291,880,14024,168936,0,0,557053,0,0,0,0,2850,2850,11823,6166,17989,12080,8684,20764,16117,97,7058,5,0,30,558,5428,13176
2,05/11/2022,0203-Egmore,103600,165752,200,3168,56450,0,0,163418,0,0,0,0,7000,7000,2665,2002,4667,3682,2881,6563,4234,21,1850,6,0,11,145,1838,3871
2,05/11/2022,0205-Nehru Park,52076,60778,100,1616,20952,0,0,74744,0,0,0,0,2750,2750,1468,801,2269,1652,684,2336,1629,7,298,0,0,2,73,709,1089
2,05/11/2022,0207-Kilpauk,49212,75363,1000,2440,23388,0,0,76040,0,0,0,0,0,0,1596,910,2506,1990,760,2750,2011,17,340,0,0,6,91,788,1242
2,05/11/2022,0209-Pachaiyappas College,54384,55275,0,456,15800,0,0,70640,0,0,0,0,10000,10000,1670,586,2256,1540,512,2052,1605,13,240,1,0,0,20,549,823
2,05/11/2022,0211-Shenoy Nagar,40956,53515,400,960,15900,0,0,58216,0,0,0,0,5000,5000,1282,570,1852,1525,534,2059,1502,6,194,0,0,3,37,526,766
2,05/11/2022,0213-Anna Nagar East,97089,147749,1160,6336,46744,0,0,151329,0,0,0,0,0,0,3377,1785,5162,3804,1528,5332,3892,22,662,1,0,10,204,1504,2403
2,05/11/2022,0215-Anna Nagar Tower,90409,120964,500,2728,36286,0,0,129923,0,0,0,0,0,0,2751,1336,4087,3085,1131,4216,3205,16,632,1,0,0,107,1164,1920
2,05/11/2022,0217-Thirumangalam,272164,345736,900,9688,106298,0,0,389050,0,0,0,0,0,0,7532,3678,11210,8447,3298,11745,8732,63,1996,6,0,10,333,3214,5622
2,05/11/2022,0219-Koyambedu,221222,279962,460,6880,89176,0,0,317738,0,0,0,0,9750,9750,5780,3170,8950,5949,2902,8851,6951,59,2404,12,0,16,251,2750,5492
2,05/11/2022,0221-Puratchi Thalaivi Dr. J. Jayalalithaa CMBT,79712,199551,250,3336,84202,0,0,167500,0,0,0,0,0,0,1582,2836,4418,5333,4522,9855,4377,20,1286,4,0,4,134,2665,4113
2,05/11/2022,0223-Arumbakkam,64598,64908,0,1912,29288,0,0,95798,0,0,0,0,12500,12500,1526,1141,2667,1861,796,2657,1500,30,4,1,0,7,84,1027,1153
2,05/11/2022,0225-Vadapalani,182953,318637,100,11576,107500,0,0,302129,0,0,0,0,6000,6000,5766,4101,9867,6993,3661,10654,7735,40,2622,4,0,18,441,3320,6445
2,05/11/2022,0227-Ashok Nagar,123597,178534,1520,5192,50960,0,0,181269,0,0,0,0,0,0,3848,1911,5759,3993,1966,5959,4832,36,1614,7,0,4,209,1589,3459
2,05/11/2022,0229-Ekkattuthangal,85004,110943,500,4096,32762,0,0,122362,0,0,0,0,250,250,2551,1257,3808,2856,1100,3956,3070,33,710,3,0,5,173,1024,1948
2,05/11/2022,0231-Arignar Anna Alandur,183066,235840,1350,5712,81146,0,0,271274,0,0,0,0,2750,2750,4869,2720,7589,5150,2211,7361,5663,65,1602,10,0,14,224,2363,4278
2,05/11/2022,0233-St. Thomas Mount,100605,137224,1800,7040,44482,0,0,153927,0,0,0,0,2600,2600,2817,1620,4437,3040,1444,4484,3345,29,850,2,0,9,220,1363,2473
1,06/11/2022,01ED-Wimco Nagar Depot Metro,44073,67304,0,1440,34362,0,0,79875,0,0,0,0,250,250,1079,841,1920,1061,498,1559,1006,14,0,0,0,15,41,793,863
1,06/11/2022,01EF-Wimco Nagar Metro,70696,81424,250,5104,32756,0,0,108806,0,0,0,0,0,0,1497,851,2348,1492,929,2421,1449,70,108,3,0,19,74,768,1042
1,06/11/2022,01F1-Thiruvotriyur Metro,75208,78266,100,2992,30988,0,0,109288,0,0,0,0,0,0,1474,864,2338,1541,778,2319,1500,23,0,3,0,14,82,774,896
1,06/11/2022,01F3-Thiruvotriyur Theradi Metro,64585,104906,0,2344,46164,0,0,113093,0,0,0,0,0,0,1705,1244,2949,1962,1168,3130,1919,26,110,1,0,26,69,1159,1391
1,06/11/2022,01F5-Kaladipet Metro,63052,77368,200,2712,39346,0,0,105310,0,0,0,0,0,0,1313,1153,2466,1432,966,2398,1349,13,0,0,0,11,80,1047,1151
1,06/11/2022,01F7-Tollgate Metro,32736,46521,0,816,21806,0,0,55358,0,0,0,0,0,0,844,685,1529,951,528,1479,884,37,8,0,0,17,32,604,698
1,06/11/2022,01F9-New Washermenpet Metro,46997,66070,0,1592,29666,0,0,78255,0,0,0,0,0,0,1322,932,2254,1363,760,2123,1362,12,115,0,0,6,52,875,1060
1,06/11/2022,01FB-Tondiarpet Metro,49273,73779,260,2648,36738,0,0,88919,0,0,0,0,0,0,1278,1144,2422,1420,1002,2422,1364,17,2,0,0,10,74,1057,1160
1,06/11/2022,01FD-Thiagaraya College Metro,79623,102813,100,3280,47354,0,0,130357,0,0,0,0,1000,1000,2020,1519,3539,1989,1235,3224,2086,54,139,0,0,8,116,1389,1706
1,06/11/2022,0101-Washermanpet,74797,92223,300,2688,46574,0,0,124359,0,0,0,0,23500,23500,1613,1562,3175,1733,1426,3159,1726,14,176,8,0,19,95,1448,1760
1,06/11/2022,0103-Mannadi,47582,71498,0,1432,35616,0,0,84630,0,0,0,0,0,0,1264,1179,2443,1264,1290,2554,1417,7,306,1,0,5,66,1112,1497
1,06/11/2022,0105-High Court,41782,80670,14,1904,40434,0,0,84134,0,0,0,0,0,0,1527,1448,2975,1549,1254,2803,1646,21,263,0,0,9,78,1325,1696
1,06/11/2022,0109-Government Estate,52381,99525,200,2992,45986,0,0,101559,0,0,0,0,2500,2500,1913,1681,3594,1982,1682,3664,2131,22,367,2,0,15,121,1499,2026
1,06/11/2022,0111-LIC,23476,59201,0,1872,31210,0,0,56558,0,0,0,0,2000,2000,949,1079,2028,1209,828,2037,1081,11,0,0,0,8,73,968,1060
1,06/11/2022,0113-Thousand Lights,40624,78626,600,2616,37904,0,0,81744,0,0,0,0,0,0,1397,1314,2711,1826,1232,3058,1603,16,13,1,0,16,101,1149,1296
1,06/11/2022,0115-AG-DMS,25088,40975,0,872,15980,0,0,41940,0,0,0,0,0,0,863,548,1411,811,535,1346,920,10,181,0,0,1,43,471,706
1,06/11/2022,0117-Teynampet,26300,46870,0,1656,22956,0,0,50912,0,0,0,0,0,0,752,860,1612,1057,731,1788,963,15,1,0,0,9,64,764,853
1,06/11/2022,0119-Nandanam,24423,47580,2062,1344,26274,0,0,54103,0,0,0,0,2000,2000,789,948,1737,928,685,1613,839,16,0,3,0,6,52,870,947
1,06/11/2022,0121-Saidapet,31004,51621,0,1648,31338,0,0,63990,0,0,0,0,4000,4000,632,1045,1677,896,943,1839,756,16,1,5,0,4,58,969,1053
1,06/11/2022,0123-Little Mount,38703,63377,200,1888,28072,0,0,68863,0,0,0,0,250,250,1333,991,2324,1186,915,2101,1325,10,259,3,0,14,75,869,1230
1,06/11/2022,0125-Guindy,81610,178248,1022,6680,84014,0,0,173326,0,0,0,0,0,0,2974,2765,5739,2665,2993,5658,3262,14,1040,5,0,21,225,2447,3752
1,06/11/2022,0129-Nanganallur Road,15298,26066,0,768,14548,0,0,30614,0,0,0,0,0,0,351,424,775,485,395,880,406,9,0,2,0,8,23,399,441
1,06/11/2022,0131-Meenambakkam,54723,94492,400,3200,46980,0,0,105303,0,0,0,0,0,0,1482,1336,2818,1281,1191,2472,1498,22,400,4,0,7,94,1256,1783
1,06/11/2022,0133-Chennai International Airport,120337,319836,900,12280,193136,0,0,326653,0,0,0,0,1500,1500,3681,5438,9119,3539,4961,8500,3889,62,1084,16,0,33,354,4696,6245
2,06/11/2022,0201-Puratchi Thalaivar Dr. M.G. Ramachandran Central,190565,381274,350,11368,184720,0,0,387003,0,0,0,0,5350,5350,7013,6370,13383,5111,7546,12657,7204,80,3174,8,0,48,446,5700,9456
2,06/11/2022,0203-Egmore,58402,121148,0,3664,64872,0,0,126938,0,0,0,0,7000,7000,1891,2214,4105,2064,2789,4853,2181,18,683,5,0,14,145,2066,2931
2,06/11/2022,0205-Nehru Park,25739,44662,0,1848,21914,0,0,49501,0,0,0,0,500,500,843,840,1683,875,709,1584,939,6,142,0,0,0,90,758,996
2,06/11/2022,0207-Kilpauk,19773,37381,100,792,17842,0,0,38507,0,0,0,0,0,0,703,628,1331,733,577,1310,758,9,127,1,0,3,30,576,746
2,06/11/2022,0209-Pachaiyappas College,28996,31868,0,840,15494,0,0,45330,0,0,0,0,8000,8000,683,567,1250,643,484,1127,659,10,76,0,0,2,34,520,642
2,06/11/2022,0211-Shenoy Nagar,21915,29599,100,472,14236,0,0,36723,0,0,0,0,2000,2000,626,486,1112,596,473,1069,625,8,98,0,0,5,22,455,588
2,06/11/2022,0213-Anna Nagar East,45851,70521,1200,2512,30484,0,0,80047,0,0,0,0,6000,6000,1635,1149,2784,1482,995,2477,1622,16,279,0,0,10,105,1012,1422
2,06/11/2022,0215-Anna Nagar Tower,50465,68102,0,1952,26132,0,0,78549,0,0,0,0,0,0,1527,942,2469,1503,943,2446,1625,13,301,0,0,7,84,842,1247
2,06/11/2022,0217-Thirumangalam,128342,224932,0,9816,111976,0,0,250134,0,0,0,0,0,0,3926,3832,7758,3890,3241,7131,4159,45,749,6,0,12,362,3339,4513
2,06/11/2022,0219-Koyambedu,118076,182427,950,5832,83648,0,0,208506,0,0,0,0,8250,8250,3461,2982,6443,2898,2917,5815,3620,33,1226,4,0,40,258,2516,4077
2,06/11/2022,0221-Puratchi Thalaivi Dr. J. Jayalalithaa CMBT,52181,159498,66,3528,91538,0,0,147313,0,0,0,0,0,0,1262,3084,4346,2472,4030,6502,2530,15,890,7,0,6,163,2841,3922
2,06/11/2022,0223-Arumbakkam,30181,53168,65,1368,33110,0,0,64724,0,0,0,0,1250,1250,766,1176,1942,957,772,1729,815,21,2,0,0,10,60,1109,1202
2,06/11/2022,0225-Vadapalani,99274,230727,60,9936,114576,0,0,223846,0,0,0,0,2000,2000,3923,4237,8160,3839,4096,7935,4363,39,1248,5,0,23,366,3554,5235
2,06/11/2022,0227-Ashok Nagar,65174,117638,1050,5064,48510,0,0,119798,0,0,0,0,0,0,2336,1739,4075,1909,1872,3781,2582,18,862,10,0,8,198,1415,2511
2,06/11/2022,0229-Ekkattuthangal,38364,60417,250,2840,27812,0,0,69266,0,0,0,0,0,0,1173,1061,2234,1208,987,2195,1317,18,286,7,0,5,113,883,1312
2,06/11/2022,0231-Arignar Anna Alandur,99519,160859,200,5568,75924,0,0,181211,0,0,0,0,1750,1750,2798,2522,5320,2679,2225,4904,3004,40,701,8,0,43,190,2207,3189
2,06/11/2022,0233-St. Thomas Mount,49210,91330,950,4032,55726,0,0,109918,0,0,0,3000,3050,6050,1209,1798,3007,1486,1393,2879,1353,17,114,2,0,14,137,1624,1908
1,07/11/2022,01ED-Wimco Nagar Depot Metro,109896,90062,0,1192,30870,0,0,141958,0,0,0,0,6750,6750,2272,787,3059,1947,457,2404,1857,22,0,3,0,9,34,760,828
1,07/11/2022,01EF-Wimco Nagar Metro,183475,155627,3103,3304,37680,0,0,227562,0,0,0,0,750,750,3861,1008,4869,3685,1004,4689,3647,51,108,3,0,9,90,902,1163
1,07/11/2022,01F1-Thiruvotriyur Metro,158035,120723,0,1808,26672,0,0,186515,0,0,0,0,0,0,3088,771,3859,3229,560,3789,3126,31,0,1,0,6,56,714,808
1,07/11/2022,01F3-Thiruvotriyur Theradi Metro,133560,143329,1000,2744,35698,0,0,173002,0,0,0,0,0,0,3259,1056,4315,3662,1064,4726,3642,27,98,3,0,14,81,952,1175
1,07/11/2022,01F5-Kaladipet Metro,160317,118545,0,1640,28938,0,0,190895,0,0,0,0,0,0,3272,871,4143,3365,764,4129,3305,22,32,3,0,1,54,807,919
1,07/11/2022,01F7-Tollgate Metro,80022,63284,0,944,15854,0,0,96820,0,0,0,0,0,0,1766,554,2320,1805,485,2290,1748,25,0,0,0,4,28,489,546
1,07/11/2022,01F9-New Washermenpet Metro,146507,112487,0,1088,26828,0,0,174423,0,0,0,0,250,250,3258,894,4152,3429,854,4283,3368,15,54,1,0,2,46,847,965
1,07/11/2022,01FB-Tondiarpet Metro,143222,122529,2700,1224,36474,0,0,183620,0,0,0,0,1250,1250,3272,1180,4452,3523,1014,4537,3383,38,11,2,0,7,38,1135,1231
1,07/11/2022,01FD-Thiagaraya College Metro,152255,138299,80,2024,36332,0,0,190691,0,0,0,0,1000,1000,4036,1307,5343,4289,1109,5398,4193,69,50,0,1,1,74,1215,1410
1,07/11/2022,0101-Washermanpet,138005,143280,2400,1896,46598,0,0,188899,0,0,0,0,14500,14500,4145,1620,5765,4002,1389,5391,3977,25,110,0,0,10,74,1523,1742
1,07/11/2022,0103-Mannadi,110932,120654,200,1216,29144,0,0,141492,0,0,0,0,0,0,3510,1048,4558,3727,1217,4944,3831,28,246,1,0,0,37,980,1292
1,07/11/2022,0105-High Court,176990,255647,80,3072,57226,0,0,237368,0,0,0,0,0,0,7988,2074,10062,7423,2135,9558,8053,58,772,0,0,6,115,1894,2845
1,07/11/2022,0109-Government Estate,120654,164830,150,2832,53166,0,0,176802,0,0,0,0,3750,3750,4420,1934,6354,4935,1740,6675,4940,46,213,5,0,7,119,1744,2134
1,07/11/2022,0111-LIC,118669,188131,850,3400,36190,0,0,159109,0,0,0,0,0,0,5395,1328,6723,6214,1150,7364,6143,32,0,0,0,4,115,1164,1315
1,07/11/2022,0113-Thousand Lights,233034,279043,4305,6880,37492,0,0,281711,0,0,0,0,250,250,8743,1554,10297,9182,1769,10951,9610,63,450,1,0,4,265,1180,1963
1,07/11/2022,0115-AG-DMS,155687,167644,2000,2576,32240,0,0,192503,0,0,0,0,3250,3250,5372,1166,6538,5218,902,6120,5359,37,193,0,0,0,104,992,1326
1,07/11/2022,0117-Teynampet,144466,163447,2700,1432,31332,0,0,179930,0,0,0,0,250,250,5158,1113,6271,5572,1130,6702,5502,32,113,1,0,5,63,1041,1255
1,07/11/2022,0119-Nandanam,135294,140915,400,3376,31484,0,0,170554,0,0,0,0,750,750,4133,1206,5339,4806,1065,5871,4714,40,0,2,0,3,99,1045,1189
1,07/11/2022,0121-Saidapet,75079,91817,300,1232,25386,0,0,101997,0,0,0,0,2500,2500,2110,881,2991,2816,805,3621,2685,24,0,13,0,4,55,813,909
1,07/11/2022,0123-Little Mount,129640,101515,400,2064,23160,0,0,155264,0,0,0,0,2750,2750,3697,875,4572,3144,708,3852,3220,16,170,3,0,1,77,745,1012
1,07/11/2022,0125-Guindy,216931,279896,5150,6616,71298,0,0,299995,0,0,0,0,1500,1500,8661,2478,11139,7811,2600,10411,8298,51,732,4,0,8,269,2218,3282
1,07/11/2022,0129-Nanganallur Road,61161,52048,1500,1672,14328,0,0,78661,0,0,0,0,0,0,1360,448,1808,1547,376,1923,1453,10,0,0,0,1,28,409,448
1,07/11/2022,0131-Meenambakkam,169609,153496,214,2680,41654,0,0,214157,0,0,0,0,0,0,4332,1203,5535,3694,970,4664,3831,29,246,3,0,2,85,1105,1470
1,07/11/2022,0133-Chennai International Airport,224056,349423,1650,10848,155612,0,0,392166,0,0,0,0,3000,3000,6377,4358,10735,6056,3735,9791,6239,68,794,9,1,11,308,3864,5055
2,07/11/2022,0201-Puratchi Thalaivar Dr. M.G. Ramachandran Central,377653,537466,560,18248,183232,0,0,579693,0,0,0,0,4550,4550,15632,6722,22354,12266,7561,19827,14799,138,3278,11,0,23,697,5784,9931
2,07/11/2022,0203-Egmore,96070,136408,740,3192,60000,0,0,160002,0,0,0,0,13350,13350,2989,2102,5091,2856,2447,5303,3067,15,672,3,0,4,125,1945,2764
2,07/11/2022,0205-Nehru Park,72313,57813,200,1296,18316,0,0,92125,0,0,0,0,6000,6000,1696,711,2407,1606,575,2181,1669,25,140,0,0,3,55,634,857
2,07/11/2022,0207-Kilpauk,55357,69444,200,1080,21798,0,0,78435,0,0,0,0,250,250,1827,797,2624,1979,687,2666,1948,12,104,0,0,1,48,719,884
2,07/11/2022,0209-Pachaiyappas College,58081,59208,0,976,17568,0,0,76625,0,0,0,0,4500,4500,1941,712,2653,1877,520,2397,1781,15,89,2,0,0,35,655,796
2,07/11/2022,0211-Shenoy Nagar,67622,57246,600,728,14470,0,0,83420,0,0,0,0,3500,3500,1586,521,2107,1772,566,2338,1771,7,84,0,0,4,25,489,609
2,07/11/2022,0213-Anna Nagar East,130181,121631,1500,2152,27354,0,0,161187,0,0,0,0,1500,1500,3635,1052,4687,3704,1039,4743,3805,27,270,0,1,2,86,926,1312
2,07/11/2022,0215-Anna Nagar Tower,133933,115699,800,1600,26944,0,0,163277,0,0,0,1000,1000,2000,3303,1003,4306,3403,907,4310,3461,31,223,0,0,0,65,912,1231
2,07/11/2022,0217-Thirumangalam,375694,345595,1840,9056,85372,0,0,471962,0,0,0,0,1500,1500,9324,3030,12354,9601,2910,12511,9795,74,558,9,0,7,310,2611,3569
2,07/11/2022,0219-Koyambedu,272369,285845,880,4632,97420,0,0,375301,0,0,0,0,19500,19500,7284,3347,10631,6563,2473,9036,6943,54,836,2,0,14,195,3055,4156
2,07/11/2022,0221-Puratchi Thalaivi Dr. J. Jayalalithaa CMBT,130753,223428,1788,4312,76998,0,0,213851,0,0,0,0,0,0,4376,2570,6946,4408,4042,8450,5431,43,1749,0,0,2,183,2318,4295
2,07/11/2022,0223-Arumbakkam,89568,74571,900,1736,26242,0,0,118446,0,0,0,0,5750,5750,1893,1000,2893,2055,772,2827,1961,27,51,1,0,7,65,910,1061
2,07/11/2022,0225-Vadapalani,197637,247420,500,6336,80422,0,0,284895,0,0,0,0,12500,12500,5934,2875,8809,6151,2895,9046,6504,53,863,3,0,8,246,2501,3674
2,07/11/2022,0227-Ashok Nagar,120539,166782,1700,3520,50814,0,0,176573,0,0,0,0,0,0,4243,1811,6054,4475,1811,6286,4534,30,420,0,0,5,137,1615,2207
2,07/11/2022,0229-Ekkattuthangal,125915,150080,1077,3064,29750,0,0,159806,0,0,0,0,250,250,4210,1148,5358,4666,1247,5913,4795,36,391,1,0,0,123,939,1490
2,07/11/2022,0231-Arignar Anna Alandur,206862,220558,2145,5128,64556,0,0,278691,0,0,0,0,9250,9250,6120,2275,8395,5870,1990,7860,6065,57,480,7,0,2,164,1984,2694
2,07/11/2022,0233-St. Thomas Mount,131775,120678,600,4240,39912,0,0,176527,0,0,0,0,13000,13000,3067,1389,4456,3314,1075,4389,3175,30,34,2,0,1,135,1205,1407
1,08/11/2022,01ED-Wimco Nagar Depot Metro,92928,79246,500,1296,17178,0,0,111902,0,0,0,0,4250,4250,2289,472,2761,1775,420,2195,1916,11,193,0,0,6,42,421,673
1,08/11/2022,01EF-Wimco Nagar Metro,151782,139005,200,3120,24852,0,0,179954,0,0,0,0,250,250,3769,714,4483,3418,779,4197,3544,59,188,2,0,4,88,601,942
1,08/11/2022,01F1-Thiruvotriyur Metro,137655,107222,0,2136,19794,0,0,159585,0,0,0,0,0,0,3006,579,3585,2920,439,3359,2919,13,40,1,0,3,52,526,635
1,08/11/2022,01F3-Thiruvotriyur Theradi Metro,118706,117889,500,2008,21758,0,0,142972,0,0,0,0,0,0,3025,665,3690,3202,768,3970,3281,18,132,4,0,4,66,591,815
1,08/11/2022,01F5-Kaladipet Metro,119549,103881,0,1760,19402,0,0,140711,0,0,0,0,0,0,3153,626,3779,3185,587,3772,3163,25,43,1,0,2,49,568,688
1,08/11/2022,01F7-Tollgate Metro,75066,56775,2200,544,11354,0,0,89164,0,0,0,0,250,250,1747,377,2124,1687,318,2005,1668,26,38,0,0,2,14,352,432
1,08/11/2022,01F9-New Washermenpet Metro,126357,100731,500,648,19648,0,0,147153,0,0,0,0,1000,1000,3215,650,3865,3257,730,3987,3256,22,97,0,0,4,24,625,772
1,08/11/2022,01FB-Tondiarpet Metro,106321,105618,500,3128,23516,0,0,133465,0,0,0,0,750,750,3079,803,3882,3316,772,4088,3215,19,0,1,0,6,56,736,818
1,08/11/2022,01FD-Thiagaraya College Metro,134333,122714,200,2232,24180,0,0,160945,0,0,0,0,500,500,3919,956,4875,4132,885,5017,4090,66,27,3,0,7,82,862,1047
1,08/11/2022,0101-Washermanpet,119466,131202,786,2088,39240,0,0,161580,0,0,0,0,9500,9500,3956,1393,5349,3761,1257,5018,3750,25,138,1,0,2,84,1292,1542
1,08/11/2022,0103-Mannadi,99849,117576,3100,1336,28598,0,0,132883,0,0,0,0,1500,1500,3323,1050,4373,3695,1093,4788,3758,24,182,1,0,1,59,975,1242
1,08/11/2022,0105-High Court,178711,249289,1050,3136,65304,0,0,248201,0,0,0,0,0,0,7401,2373,9774,7502,2086,9588,7609,39,324,2,0,3,128,2223,2719
1,08/11/2022,0109-Government Estate,106981,154292,600,2544,40598,0,0,150723,0,0,0,0,500,500,4380,1507,5887,4652,1685,6337,4950,24,462,1,0,0,110,1332,1929
1,08/11/2022,0111-LIC,120168,186668,2600,2608,33578,0,0,158954,0,0,0,0,1250,1250,5457,1230,6687,6193,989,7182,6137,30,42,0,0,3,106,1076,1257
1,08/11/2022,0113-Thousand Lights,184111,266064,2500,6312,31916,0,0,224839,0,0,0,0,0,0,8546,1376,9922,9076,1534,10610,9382,52,380,0,0,3,250,1016,1701
1,08/11/2022,0115-AG-DMS,132204,145011,1800,2472,26224,0,0,162700,0,0,0,0,1250,1250,4735,970,5705,4582,807,5389,4681,31,195,0,0,2,86,815,1129
1,08/11/2022,0117-Teynampet,124067,150050,2300,1840,22376,0,0,150583,0,0,0,0,1000,1000,4881,881,5762,5257,906,6163,5298,28,142,1,0,1,82,755,1009
1,08/11/2022,0119-Nandanam,112786,133289,3650,2096,28906,0,0,147438,0,0,0,0,500,500,4075,1124,5199,4596,873,5469,4499,38,0,0,0,1,90,979,1108
1,08/11/2022,0121-Saidapet,66800,84870,0,1480,22866,0,0,91146,0,0,0,0,6000,6000,2035,826,2861,2593,719,3312,2509,18,0,4,0,0,61,747,830
1,08/11/2022,0123-Little Mount,108318,99096,1235,1960,22808,0,0,134321,0,0,0,0,500,500,3672,883,4555,3078,608,3686,3117,22,171,1,0,5,90,738,1027
1,08/11/2022,0125-Guindy,189868,253114,1040,6912,51088,0,0,248908,0,0,0,0,500,500,8241,1970,10211,7358,2200,9558,8033,50,880,5,0,6,267,1588,2796
1,08/11/2022,0129-Nanganallur Road,60328,48624,50,1352,13226,0,0,74956,0,0,0,0,0,0,1261,400,1661,1417,301,1718,1345,10,0,1,0,2,21,375,409
1,08/11/2022,0131-Meenambakkam,130122,111710,300,2440,28494,0,0,161356,0,0,0,0,0,0,3401,877,4278,2751,724,3475,2860,24,183,3,0,2,81,779,1072
1,08/11/2022,0133-Chennai International Airport,209412,312820,800,8304,135856,0,0,354372,0,0,0,0,5250,5250,5798,3828,9626,5629,3586,9215,5741,65,648,16,0,7,257,3377,4370
2,08/11/2022,0201-Puratchi Thalaivar Dr. M.G. Ramachandran Central,304597,475162,1650,14728,145154,0,0,466129,0,0,0,0,14250,14250,13942,5415,19357,11838,6678,18516,13896,104,2923,8,0,16,513,4640,8204
2,08/11/2022,0203-Egmore,88735,127733,450,3216,57632,0,0,150033,0,0,0,0,19350,19350,2885,2149,5034,2841,2284,5125,2911,26,483,10,0,6,128,1944,2597
2,08/11/2022,0205-Nehru Park,51305,54730,0,760,18492,0,0,70557,0,0,0,0,750,750,1539,682,2221,1518,488,2006,1518,19,129,0,0,0,31,641,820
2,08/11/2022,0207-Kilpauk,46550,59958,500,736,18408,0,0,66194,0,0,0,0,0,0,1626,670,2296,1729,617,2346,1705,13,86,2,0,0,31,609,741
2,08/11/2022,0209-Pachaiyappas College,59168,54512,200,904,13330,0,0,73602,0,0,0,0,13000,13000,1895,546,2441,1794,478,2272,1744,12,110,2,0,0,36,498,658
2,08/11/2022,0211-Shenoy Nagar,51590,49627,100,696,9712,0,0,62098,0,0,0,0,500,500,1490,376,1866,1607,405,2012,1642,16,78,0,0,0,27,339,460
2,08/11/2022,0213-Anna Nagar East,113954,115881,320,2760,27048,0,0,144082,0,0,0,0,6000,6000,3348,1047,4395,3466,959,4425,3534,21,171,0,0,1,109,916,1218
2,08/11/2022,0215-Anna Nagar Tower,107638,105414,800,2016,21394,0,0,131848,0,0,0,0,1250,1250,3157,816,3973,3200,726,3926,3263,27,201,0,0,1,79,717,1025
2,08/11/2022,0217-Thirumangalam,304739,311919,619,7784,78168,0,0,391310,0,0,0,0,0,0,8544,2728,11272,8660,2444,11104,8823,60,556,3,0,0,251,2403,3273
2,08/11/2022,0219-Koyambedu,233833,268502,1250,5680,73730,0,0,314493,0,0,0,500,11500,12000,7305,2603,9908,6432,2346,8778,7095,51,1053,3,0,13,211,2302,3633
2,08/11/2022,0221-Puratchi Thalaivi Dr. J. Jayalalithaa CMBT,85809,177562,1350,3248,76738,0,0,167145,0,0,0,0,0,0,3168,2506,5674,3673,3022,6695,3930,30,805,3,0,2,128,2332,3300
2,08/11/2022,0223-Arumbakkam,56329,65612,0,1464,23538,0,0,81331,0,0,0,0,750,750,1695,868,2563,1878,596,2474,1748,26,1,1,0,0,53,796,877
2,08/11/2022,0225-Vadapalani,154944,224602,420,5128,70040,0,0,230532,0,0,0,0,5500,5500,5523,2515,8038,5667,2630,8297,5955,51,762,1,0,9,211,2173,3207
2,08/11/2022,0227-Ashok Nagar,106324,146384,1000,4088,43202,0,0,154614,0,0,0,0,0,0,3847,1544,5391,3930,1419,5349,4046,37,313,2,0,3,131,1327,1813
2,08/11/2022,0229-Ekkattuthangal,113213,143569,1300,4112,27624,0,0,146249,0,0,0,0,750,750,4175,1085,5260,4509,961,5470,4661,19,270,0,0,3,160,867,1319
2,08/11/2022,0231-Arignar Anna Alandur,182931,200143,680,5032,54684,0,0,243327,0,0,0,0,2750,2750,5830,1917,7747,5513,1613,7126,5700,56,407,1,0,4,171,1648,2287
2,08/11/2022,0233-St. Thomas Mount,111277,110626,700,3632,34442,0,0,150051,0,0,0,3000,7650,10650,2983,1240,4223,3098,877,3975,3021,22,23,0,0,4,142,1051,1242
1,09/11/2022,01ED-Wimco Nagar Depot Metro,93546,78402,235,1360,21286,0,0,116427,0,0,0,0,4750,4750,2245,568,2813,1854,371,2225,1812,18,0,0,0,5,40,535,598
1,09/11/2022,01EF-Wimco Nagar Metro,139335,144249,724,3656,30666,0,0,174381,0,0,0,0,2000,2000,3852,863,4715,3449,859,4308,3526,72,138,4,0,2,93,751,1060
1,09/11/2022,01F1-Thiruvotriyur Metro,135310,111620,100,1600,22268,0,0,159278,0,0,0,0,0,0,3170,638,3808,3025,563,3588,2984,23,0,3,0,0,44,593,663
1,09/11/2022,01F3-Thiruvotriyur Theradi Metro,109084,125333,500,2168,27706,0,0,139458,0,0,0,0,0,0,3110,811,3921,3386,797,4183,3344,19,48,8,0,3,56,744,878
1,09/11/2022,01F5-Kaladipet Metro,112230,110772,200,1864,24468,0,0,138762,0,0,0,0,0,0,3309,794,4103,3262,593,3855,3234,17,0,0,0,1,52,739,809
1,09/11/2022,01F7-Tollgate Metro,69017,58787,0,736,12554,0,0,82307,0,0,0,0,0,0,1745,427,2172,1723,377,2100,1700,27,0,0,0,1,27,388,443
1,09/11/2022,01F9-New Washermenpet Metro,109552,104425,98,952,21974,0,0,132576,0,0,0,0,1000,1000,3213,747,3960,3211,756,3967,3242,14,74,1,0,1,33,710,833
1,09/11/2022,01FB-Tondiarpet Metro,104196,107907,0,1880,25764,0,0,131840,0,0,0,0,1000,1000,3149,842,3991,3326,754,4080,3242,23,0,2,0,2,32,795,854
1,09/11/2022,01FD-Thiagaraya College Metro,123309,131144,150,2672,27158,0,0,153289,0,0,0,0,1250,1250,4071,997,5068,4268,952,5220,4280,52,42,1,0,3,66,927,1091
1,09/11/2022,0101-Washermanpet,118186,135436,650,1840,40882,0,0,161558,0,0,0,0,11250,11250,4117,1415,5532,3841,1336,5177,3875,22,123,1,0,3,74,1325,1548
1,09/11/2022,0103-Mannadi,113973,120844,1350,1512,29082,0,0,145917,0,0,0,0,0,0,3497,1100,4597,3843,1192,5035,3866,19,133,2,0,0,53,1028,1235
1,09/11/2022,0105-High Court,153738,258026,300,2432,73174,0,0,229644,0,0,0,0,0,0,7458,2631,10089,7621,1983,9604,7641,52,182,3,0,1,99,2494,2831
1,09/11/2022,0109-Government Estate,112406,161072,820,2824,46752,0,0,162802,0,0,0,0,3000,3000,4420,1779,6199,4919,1714,6633,5067,20,249,2,0,0,126,1551,1948
1,09/11/2022,0111-LIC,100296,187736,1500,2192,32236,0,0,136224,0,0,0,0,0,0,5539,1178,6717,6302,985,7287,6243,27,0,0,0,2,90,1041,1160
1,09/11/2022,0113-Thousand Lights,156308,278787,1850,6928,45180,0,0,210266,0,0,0,250,250,500,8549,1750,10299,9363,1589,10952,9400,41,115,0,0,6,230,1426,1818
1,09/11/2022,0115-AG-DMS,144216,162510,1600,2504,26430,0,0,174750,0,0,0,0,2750,2750,5376,965,6341,5233,787,6020,5386,36,239,1,0,0,90,835,1201
1,09/11/2022,0117-Teynampet,109837,160121,650,2000,28296,0,0,140783,0,0,0,0,0,0,5102,1096,6198,5585,998,6583,5501,36,4,4,0,3,85,965,1097
1,09/11/2022,0119-Nandanam,114714,141344,1050,1976,31324,0,0,149064,0,0,0,0,1750,1750,4261,1208,5469,4820,957,5777,4728,39,0,1,0,1,81,1062,1184
1,09/11/2022,0121-Saidapet,64456,89110,500,1552,23680,0,0,90188,0,0,0,0,6750,6750,2165,867,3032,2687,675,3362,2640,20,0,0,0,1,64,779,864
1,09/11/2022,0123-Little Mount,108529,101606,433,2264,23032,0,0,134258,0,0,0,0,2000,2000,3767,896,4663,3124,666,3790,3206,17,154,1,0,1,88,768,1029
1,09/11/2022,0125-Guindy,156471,277531,2100,6528,60266,0,0,225365,0,0,0,0,3000,3000,8979,2178,11157,7864,2366,10230,8569,44,872,4,0,5,226,1842,2993
1,09/11/2022,0129-Nanganallur Road,48046,53815,1000,648,14644,0,0,64338,0,0,0,0,0,0,1426,440,1866,1567,364,1931,1493,8,0,0,0,0,24,416,448
1,09/11/2022,0131-Meenambakkam,152309,140484,600,2768,32224,0,0,187901,0,0,0,0,0,0,4284,986,5270,3512,862,4374,3696,23,247,7,0,2,70,899,1248
1,09/11/2022,0133-Chennai International Airport,202738,336662,3500,7904,144654,0,0,358796,0,0,0,0,3000,3000,6346,4041,10387,5841,3691,9532,6221,82,785,19,0,10,237,3601,4734
2,09/11/2022,0201-Puratchi Thalaivar Dr. M.G. Ramachandran Central,302847,476813,1530,12072,134018,0,0,450467,0,0,0,0,8950,8950,14562,4982,19544,11991,7445,19436,14422,130,3123,10,0,19,481,4332,8095
2,09/11/2022,0203-Egmore,93298,128869,100,2600,51172,0,0,147170,0,0,0,0,6250,6250,2887,1822,4709,2867,2450,5317,3192,23,665,6,0,3,107,1675,2479
2,09/11/2022,0205-Nehru Park,53179,51785,100,880,14894,0,0,69053,0,0,0,0,500,500,1645,573,2218,1512,488,2000,1565,18,119,0,0,2,38,527,704
2,09/11/2022,0207-Kilpauk,45251,66187,700,1288,18702,0,0,65941,0,0,0,0,250,250,1794,711,2505,1869,671,2540,1912,23,114,0,0,1,45,640,823
2,09/11/2022,0209-Pachaiyappas College,52207,56382,400,680,14988,0,0,68275,0,0,0,0,4500,4500,1914,587,2501,1894,488,2382,1780,12,82,1,0,1,27,545,668
2,09/11/2022,0211-Shenoy Nagar,51085,55044,100,624,13450,0,0,65259,0,0,0,0,3000,3000,1497,489,1986,1720,448,2168,1725,13,64,0,0,0,27,454,558
2,09/11/2022,0213-Anna Nagar East,94484,121570,2350,2552,29934,0,0,129320,0,0,0,0,3000,3000,3514,1142,4656,3591,959,4550,3664,23,167,2,0,0,96,1011,1299
2,09/11/2022,0215-Anna Nagar Tower,114416,116604,800,2024,28364,0,0,145604,0,0,0,0,250,250,3363,1039,4402,3418,878,4296,3440,27,171,5,1,1,78,934,1217
2,09/11/2022,0217-Thirumangalam,276414,343243,1824,7352,84658,0,0,370248,0,0,0,0,3000,3000,9460,2980,12440,9535,2686,12221,9749,61,560,2,0,3,268,2600,3494
2,09/11/2022,0219-Koyambedu,216323,264928,800,4904,84860,0,0,306887,0,0,0,0,17750,17750,6887,2944,9831,6410,2277,8687,6671,44,595,7,0,9,201,2665,3521
2,09/11/2022,0221-Puratchi Thalaivi Dr. J. Jayalalithaa CMBT,74500,165289,1600,2064,72074,0,0,150238,0,0,0,0,0,0,2779,2406,5185,3867,3301,7168,3690,29,497,3,0,3,83,2272,2887
2,09/11/2022,0223-Arumbakkam,71051,70179,0,1624,25276,0,0,97951,0,0,0,0,9000,9000,1906,943,2849,1950,718,2668,1862,30,0,2,0,4,60,860,956
2,09/11/2022,0225-Vadapalani,148286,249921,350,6704,85888,0,0,241228,0,0,0,0,12500,12500,5839,3053,8892,6102,2924,9026,6404,44,717,1,0,11,255,2717,3745
2,09/11/2022,0227-Ashok Nagar,95954,161001,1250,3240,51618,0,0,152062,0,0,0,0,500,500,4217,1871,6088,4245,1499,5744,4326,30,277,0,0,3,142,1644,2096
2,09/11/2022,0229-Ekkattuthangal,110100,150318,830,4048,28872,0,0,143850,0,0,0,0,1000,1000,4496,1119,5615,4591,1091,5682,4883,24,413,2,0,0,134,911,1484
2,09/11/2022,0231-Arignar Anna Alandur,200140,212811,6050,4960,55638,0,0,266788,0,0,0,0,3500,3500,6113,1946,8059,5883,1660,7543,6128,54,466,0,0,4,152,1677,2353
2,09/11/2022,0233-St. Thomas Mount,105194,112369,1300,2384,33742,0,0,142620,0,0,0,6000,3900,9900,3145,1171,4316,3177,886,4063,3111,24,69,1,0,1,85,1042,1222
1,10/11/2022,01ED-Wimco Nagar Depot Metro,90394,84532,700,1024,27624,0,0,119742,0,0,0,0,5000,5000,2264,713,2977,1852,396,2248,1795,15,1,1,0,9,31,675,732
1,10/11/2022,01EF-Wimco Nagar Metro,140303,152442,0,3080,36518,0,0,179901,0,0,0,0,250,250,3800,976,4776,3626,835,4461,3598,49,113,3,0,9,89,875,1138
1,10/11/2022,01F1-Thiruvotriyur Metro,123856,111016,0,1624,22516,0,0,147996,0,0,0,0,0,0,3123,651,3774,3057,499,3556,2976,23,0,4,0,4,48,606,685
1,10/11/2022,01F3-Thiruvotriyur Theradi Metro,116277,135591,700,1488,30292,0,0,148757,0,0,0,0,0,0,3315,882,4197,3615,832,4447,3574,19,129,4,0,6,49,804,1011
1,10/11/2022,01F5-Kaladipet Metro,128892,114266,1000,1408,28010,0,0,159310,0,0,0,0,0,0,3264,870,4134,3323,712,4035,3220,19,0,0,0,5,50,819,893
1,10/11/2022,01F7-Tollgate Metro,63449,65857,310,1096,16664,0,0,81519,0,0,0,0,0,0,1860,559,2419,1845,481,2326,1792,29,2,0,0,4,38,506,579
1,10/11/2022,01F9-New Washermenpet Metro,92706,110644,1100,1600,26458,0,0,121864,0,0,0,0,500,500,3226,888,4114,3393,772,4165,3352,20,71,1,0,3,47,839,981
1,10/11/2022,01FB-Tondiarpet Metro,110853,113971,1800,2720,29000,0,0,144373,0,0,0,0,2500,2500,3244,983,4227,3463,803,4266,3365,22,2,2,0,3,63,912,1004
1,10/11/2022,01FD-Thiagaraya College Metro,121588,132851,1200,1576,30390,0,0,154754,0,0,0,0,2250,2250,4051,1103,5154,4294,976,5270,4247,36,18,2,0,3,58,1027,1144
1,10/11/2022,0101-Washermanpet,108615,137300,150,2128,42674,0,0,153567,0,0,0,0,7000,7000,4129,1495,5624,3871,1351,5222,3888,21,159,0,0,3,79,1393,1655
1,10/11/2022,0103-Mannadi,94418,123202,0,1176,32134,0,0,127728,0,0,0,0,4500,4500,3358,1131,4489,3788,1148,4936,3812,26,153,0,0,2,47,1078,1306
1,10/11/2022,0105-High Court,164316,250461,700,3784,59942,0,0,228742,0,0,0,0,0,0,7875,2234,10109,7381,1937,9318,7831,38,565,0,0,2,138,2030,2773
1,10/11/2022,0109-Government Estate,96013,160736,1300,2528,48112,0,0,147953,0,0,0,0,6000,6000,4484,1837,6321,4814,1640,6454,4974,33,324,0,0,4,123,1625,2109
1,10/11/2022,0111-LIC,102180,190463,300,3352,33740,0,0,139572,0,0,0,0,250,250,5701,1287,6988,6202,998,7200,6283,25,118,0,0,1,143,1096,1383
1,10/11/2022,0113-Thousand Lights,182054,282063,970,7896,41122,0,0,232042,0,0,0,0,0,0,9012,1710,10722,9184,1618,10802,9645,39,429,0,0,4,325,1273,2070
1,10/11/2022,0115-AG-DMS,118559,162130,2050,3392,32262,0,0,156263,0,0,0,0,250,250,5304,1140,6444,5022,827,5849,5156,25,195,1,0,1,104,995,1321
1,10/11/2022,0117-Teynampet,102082,161958,1450,2776,35490,0,0,141798,0,0,0,0,0,0,5035,1355,6390,5410,1082,6492,5295,25,5,0,0,3,104,1213,1350
1,10/11/2022,0119-Nandanam,98304,145117,1000,2728,34370,0,0,136402,0,0,0,0,1500,1500,4464,1320,5784,4850,933,5783,4730,43,0,3,0,3,110,1149,1308
1,10/11/2022,0121-Saidapet,60421,89380,0,1592,27256,0,0,89269,0,0,0,0,6750,6750,2148,980,3128,2651,821,3472,2534,22,0,0,0,1,61,903,987
1,10/11/2022,0123-Little Mount,93651,106212,900,3024,28474,0,0,126049,0,0,0,0,1500,1500,3758,1092,4850,2976,853,3829,3163,22,224,2,0,2,113,928,1291
1,10/11/2022,0125-Guindy,173854,301979,2012,8008,67590,0,0,251464,0,0,0,0,500,500,9203,2503,11706,8113,2577,10690,9169,33,1206,4,0,9,334,2054,3640
1,10/11/2022,0129-Nanganallur Road,44866,56002,600,608,17292,0,0,63366,0,0,0,0,0,0,1366,534,1900,1566,375,1941,1477,9,0,0,0,0,23,492,524
1,10/11/2022,0131-Meenambakkam,138182,151319,0,2944,36534,0,0,177660,0,0,0,0,0,0,4434,1121,5555,3621,981,4602,3873,18,366,2,0,1,90,1019,1496
1,10/11/2022,0133-Chennai International Airport,187675,347422,1100,10696,149698,0,0,349169,0,0,0,0,7500,7500,6406,4248,10654,6058,4040,10098,6372,74,921,19,0,8,314,3665,5001
2,10/11/2022,0201-Puratchi Thalaivar Dr. M.G. Ramachandran Central,290990,512862,762,11552,142648,0,0,445952,0,0,0,0,3100,3100,14873,5222,20095,12971,7810,20781,15448,91,3572,10,0,15,457,4519,8664
2,10/11/2022,0203-Egmore,92445,143860,595,2832,48646,0,0,144518,0,0,0,0,18750,18750,3236,1751,4987,3409,2911,6320,3844,17,1017,7,0,9,109,1607,2766
2,10/11/2022,0205-Nehru Park,53503,54788,0,824,17954,0,0,72281,0,0,0,0,4000,4000,1680,678,2358,1536,523,2059,1585,20,151,0,0,1,38,619,829
2,10/11/2022,0207-Kilpauk,43958,66640,0,1464,19182,0,0,64604,0,0,0,0,1000,1000,1816,723,2539,1874,587,2461,1916,16,143,4,0,0,52,637,852
2,10/11/2022,0209-Pachaiyappas College,55224,58184,2168,808,16742,0,0,74942,0,0,0,0,6250,6250,1991,659,2650,1855,500,2355,1765,12,98,2,0,0,31,610,753
2,10/11/2022,0211-Shenoy Nagar,54582,53944,100,952,11580,0,0,67214,0,0,0,0,2250,2250,1573,436,2009,1678,487,2165,1727,15,94,0,0,1,38,382,530
2,10/11/2022,0213-Anna Nagar East,87468,122085,1100,2912,29278,0,0,120758,0,0,0,0,0,0,3610,1136,4746,3638,904,4542,3733,28,180,0,0,1,128,963,1300
2,10/11/2022,0215-Anna Nagar Tower,92285,115474,1648,2504,28856,0,0,125293,0,0,0,0,2000,2000,3381,1078,4459,3306,925,4231,3362,21,202,0,0,2,77,970,1272
2,10/11/2022,0217-Thirumangalam,295484,353158,930,10920,94068,0,0,401402,0,0,0,0,0,0,9252,3286,12538,9433,2792,12225,9720,61,714,3,0,7,351,2834,3970
2,10/11/2022,0219-Koyambedu,212480,279461,790,5968,89442,0,0,308680,0,0,0,0,13750,13750,7083,3124,10207,6589,2414,9003,6904,49,811,4,0,18,214,2796,3892
2,10/11/2022,0221-Puratchi Thalaivi Dr. J. Jayalalithaa CMBT,74159,182446,500,2656,77510,0,0,154825,0,0,0,0,0,0,2724,2583,5307,4733,4009,8742,4146,24,525,5,0,0,112,2430,3096
2,10/11/2022,0223-Arumbakkam,63442,73937,0,1264,27200,0,0,91906,0,0,0,0,3000,3000,1888,992,2880,2063,810,2873,1912,27,14,1,0,7,47,921,1017
2,10/11/2022,0225-Vadapalani,127461,216315,150,5512,76094,0,0,209217,0,0,0,0,8000,8000,5163,2732,7895,5275,2574,7849,5503,37,682,1,0,7,219,2374,3320
2,10/11/2022,0227-Ashok Nagar,92134,157812,1582,4048,47604,0,0,145368,0,0,0,0,0,0,4136,1723,5859,4198,1538,5736,4324,36,357,5,0,1,152,1513,2064
2,10/11/2022,0229-Ekkattuthangal,95928,151262,1840,4544,31592,0,0,133904,0,0,0,0,0,0,4398,1193,5591,4523,1152,5675,4775,33,364,0,0,6,141,986,1530
2,10/11/2022,0231-Arignar Anna Alandur,179353,215379,252,5000,60126,0,0,244731,0,0,0,0,5250,5250,6135,2119,8254,5707,1746,7453,6050,51,583,7,0,5,185,1831,2662
2,10/11/2022,0233-St. Thomas Mount,83896,120032,0,3664,39552,0,0,127112,0,0,0,3000,6800,9800,3079,1398,4477,3202,998,4200,3133,15,112,0,0,2,113,1221,1463
1,11/11/2022,01ED-Wimco Nagar Depot Metro,56509,59155,0,1128,23078,0,0,80715,0,0,0,0,3000,3000,1480,609,2089,1158,321,1479,1139,12,1,3,0,8,37,565,626
1,11/11/2022,01EF-Wimco Nagar Metro,89840,109656,0,2808,28390,0,0,121038,0,0,0,0,3500,3500,2664,763,3427,2464,697,3161,2502,43,107,0,0,10,73,679,912
1,11/11/2022,01F1-Thiruvotriyur Metro,76917,75686,50,1424,20112,0,0,98503,0,0,0,0,0,0,1952,545,2497,1860,508,2368,1838,18,2,3,0,8,39,510,580
1,11/11/2022,01F3-Thiruvotriyur Theradi Metro,85356,108822,900,2408,35724,0,0,124388,0,0,0,0,0,0,2327,1009,3336,2539,841,3380,2476,20,38,1,0,14,67,933,1073
1,11/11/2022,01F5-Kaladipet Metro,78089,78940,300,1136,24490,0,0,104015,0,0,0,0,0,0,2078,734,2812,2027,615,2642,1967,13,0,1,0,4,39,685,742
1,11/11/2022,01F7-Tollgate Metro,46681,53063,0,1016,19942,0,0,67639,0,0,0,0,0,0,1291,637,1928,1269,490,1759,1223,23,0,1,0,8,39,573,644
1,11/11/2022,01F9-New Washermenpet Metro,72816,78208,150,1432,24900,0,0,99298,0,0,0,0,0,0,2173,807,2980,2035,649,2684,2064,20,83,0,0,1,51,760,915
1,11/11/2022,01FB-Tondiarpet Metro,67681,80748,300,1464,27498,0,0,96943,0,0,0,0,750,750,2153,888,3041,2169,720,2889,2089,13,1,0,0,8,42,835,899
1,11/11/2022,01FD-Thiagaraya College Metro,89489,101148,200,1816,32686,0,0,124191,0,0,0,0,1000,1000,2809,1114,3923,2805,865,3670,2783,28,35,2,0,13,60,1040,1178
1,11/11/2022,0101-Washermanpet,94200,102831,400,2488,35060,0,0,132148,0,0,0,0,12250,12250,3071,1216,4287,2424,1106,3530,2679,36,307,1,0,5,91,1101,1541
1,11/11/2022,0103-Mannadi,74397,80068,0,3200,27386,0,0,104983,0,0,0,0,0,0,2101,980,3081,2267,1047,3314,2238,21,80,1,0,2,53,914,1071
1,11/11/2022,0105-High Court,112155,188282,1320,2488,50812,0,0,166775,0,0,0,0,0,0,5305,1831,7136,5537,1645,7182,5671,36,247,2,0,3,106,1692,2086
1,11/11/2022,0109-Government Estate,77370,128956,400,2096,43230,0,0,123096,0,0,0,0,2000,2000,3439,1571,5010,3674,1455,5129,3756,32,183,2,0,0,92,1442,1751
1,11/11/2022,0111-LIC,62932,133164,670,2200,29592,0,0,95394,0,0,0,0,0,0,3665,1045,4710,4286,811,5097,4204,27,0,1,0,3,92,926,1049
1,11/11/2022,0113-Thousand Lights,113846,208185,1301,6496,41156,0,0,162799,0,0,0,0,250,250,6005,1639,7644,6552,1396,7948,6680,31,184,0,0,4,260,1283,1762
1,11/11/2022,0115-AG-DMS,93831,117162,0,2296,28602,0,0,124729,0,0,0,0,1000,1000,3306,982,4288,3296,798,4094,3463,23,218,0,0,1,90,859,1191
1,11/11/2022,0117-Teynampet,62986,97604,400,1928,26790,0,0,92104,0,0,0,0,0,0,2632,978,3610,3062,748,3810,2986,16,1,0,0,2,76,862,957
1,11/11/2022,0119-Nandanam,83007,112992,395,2640,33178,0,0,119220,0,0,0,0,2500,2500,3142,1212,4354,3446,814,4260,3376,27,0,0,0,7,98,1065,1197
1,11/11/2022,0121-Saidapet,45491,67111,0,1288,23556,0,0,70335,0,0,0,0,2000,2000,1636,813,2449,1847,646,2493,1770,22,0,1,0,3,49,756,831
1,11/11/2022,0123-Little Mount,80502,80272,620,2808,23798,0,0,107728,0,0,0,0,2000,2000,2651,939,3590,2143,614,2757,2325,15,224,6,0,3,102,789,1139
1,11/11/2022,0125-Guindy,132170,216208,2310,6224,62686,0,0,203390,0,0,0,0,0,0,6338,2276,8614,5208,2021,7229,6069,35,1000,1,0,3,252,1921,3212
1,11/11/2022,0129-Nanganallur Road,41654,43421,120,1480,16314,0,0,59568,0,0,0,0,0,0,967,504,1471,1091,347,1438,1033,11,0,0,0,1,26,467,505
1,11/11/2022,0131-Meenambakkam,99542,105655,350,2480,32788,0,0,135160,0,0,0,0,0,0,2911,972,3883,2263,771,3034,2458,21,273,2,0,4,74,892,1266
1,11/11/2022,0133-Chennai International Airport,156467,296309,2400,8624,157766,0,0,325257,0,0,0,0,6750,6750,4908,4392,9300,4000,3756,7756,4384,63,843,18,0,22,270,3935,5151
2,11/11/2022,0201-Puratchi Thalaivar Dr. M.G. Ramachandran Central,244426,458520,2600,10920,148382,0,0,406328,0,0,0,0,3500,3500,11236,5324,16560,10563,8480,19043,12691,90,3283,7,0,24,428,4791,8623
2,11/11/2022,0203-Egmore,90326,144680,300,3056,63128,0,0,156810,0,0,0,0,12500,12500,2646,2202,4848,3162,3237,6399,3409,27,730,11,0,12,125,2054,2959
2,11/11/2022,0205-Nehru Park,31075,43338,100,1232,17092,0,0,49499,0,0,0,0,0,0,1090,652,1742,1083,520,1603,1112,18,113,0,0,2,48,577,758
2,11/11/2022,0207-Kilpauk,27545,52768,0,1048,16584,0,0,45177,0,0,0,0,250,250,1304,619,1923,1381,621,2002,1432,10,146,0,0,2,48,561,767
2,11/11/2022,0209-Pachaiyappas College,40263,38503,0,632,12296,0,0,53191,0,0,0,0,6000,6000,1142,465,1607,1043,333,1376,1073,17,104,2,0,1,26,419,569
2,11/11/2022,0211-Shenoy Nagar,30026,36359,0,808,11246,0,0,42080,0,0,0,0,0,0,1046,398,1444,985,398,1383,1004,8,80,0,0,1,32,358,479
2,11/11/2022,0213-Anna Nagar East,60817,82842,0,2288,26350,0,0,89455,0,0,0,0,0,0,2162,948,3110,2102,822,2924,2182,8,184,4,0,1,87,838,1122
2,11/11/2022,0215-Anna Nagar Tower,56074,68149,410,1488,19270,0,0,77242,0,0,0,0,250,250,1844,706,2550,1820,627,2447,1878,9,168,1,1,2,54,629,864
2,11/11/2022,0217-Thirumangalam,196429,259777,1040,8224,87170,0,0,292863,0,0,0,0,0,0,6154,2978,9132,6103,2342,8445,6395,57,629,3,0,5,294,2652,3640
2,11/11/2022,0219-Koyambedu,136829,202191,1900,4904,86672,0,0,230305,0,0,0,0,10500,10500,4440,2985,7425,4012,2227,6239,4255,42,671,6,0,11,199,2723,3652
2,11/11/2022,0221-Puratchi Thalaivi Dr. J. Jayalalithaa CMBT,67339,171218,350,2384,71390,0,0,141463,0,0,0,0,0,0,2304,2373,4677,4443,4813,9256,3849,21,602,7,0,1,107,2253,2991
2,11/11/2022,0223-Arumbakkam,45245,63543,500,1448,28834,0,0,76027,0,0,0,0,6000,6000,1432,1023,2455,1496,803,2299,1367,29,1,2,0,11,54,957,1054
2,11/11/2022,0225-Vadapalani,109445,194658,1405,7504,78786,0,0,197140,0,0,0,0,4000,4000,4158,2807,6965,3824,2585,6409,4370,36,893,2,0,10,280,2390,3611
2,11/11/2022,0227-Ashok Nagar,86428,132648,1150,5472,52954,0,0,146004,0,0,0,0,0,0,3032,1888,4920,2807,1492,4299,3048,20,379,3,0,0,201,1612,2215
2,11/11/2022,0229-Ekkattuthangal,74892,110010,300,4504,34652,0,0,114348,0,0,0,0,0,0,2940,1267,4207,2670,948,3618,2980,14,402,0,1,5,177,1043,1642
2,11/11/2022,0231-Arignar Anna Alandur,130898,150386,1150,4352,58022,0,0,194422,0,0,0,0,2750,2750,4137,1964,6101,3193,1536,4729,3566,46,573,8,0,7,157,1688,2479
2,11/11/2022,0233-St. Thomas Mount,63604,91926,700,3648,39998,0,0,107950,0,0,0,0,400,400,2050,1368,3418,2158,922,3080,2060,23,49,2,0,5,118,1213,1410
1,12/11/2022,01ED-Wimco Nagar Depot Metro,60294,61501,0,1872,25868,0,0,88034,0,0,0,0,2250,2250,1506,670,2176,1140,405,1545,1132,15,0,1,0,8,51,618,693
1,12/11/2022,01EF-Wimco Nagar Metro,91844,101027,1100,4576,28024,0,0,125544,0,0,0,0,0,0,2287,794,3081,2104,868,2972,2242,54,141,11,0,6,96,671,979
1,12/11/2022,01F1-Thiruvotriyur Metro,76948,77816,0,1840,22168,0,0,100956,0,0,0,0,0,0,1981,628,2609,1922,557,2479,1865,20,0,4,1,3,54,573,655
1,12/11/2022,01F3-Thiruvotriyur Theradi Metro,88367,101415,140,2792,29398,0,0,120697,0,0,0,0,0,0,2262,890,3152,2404,918,3322,2435,26,73,3,0,4,82,762,950
1,12/11/2022,01F5-Kaladipet Metro,78633,76992,0,1696,22840,0,0,103169,0,0,0,0,0,0,2045,726,2771,2077,646,2723,2004,22,0,0,0,2,52,663,739
1,12/11/2022,01F7-Tollgate Metro,44225,44418,0,1392,14314,0,0,59931,0,0,0,0,0,0,1159,486,1645,1115,375,1490,1112,32,0,0,0,6,48,415,501
1,12/11/2022,01F9-New Washermenpet Metro,63931,81709,0,1288,26146,0,0,91365,0,0,0,0,1000,1000,2192,870,3062,2147,698,2845,2158,14,96,3,0,4,46,814,977
1,12/11/2022,01FB-Tondiarpet Metro,65691,81785,700,1664,30592,0,0,98647,0,0,0,0,250,250,2070,990,3060,2098,793,2891,2004,31,1,0,0,8,61,921,1022
1,12/11/2022,01FD-Thiagaraya College Metro,91390,97669,200,2136,32346,0,0,126072,0,0,0,0,0,0,2648,1078,3726,2602,805,3407,2614,51,77,0,0,5,74,996,1203
1,12/11/2022,0101-Washermanpet,88488,103751,600,2704,41342,0,0,133134,0,0,0,0,18250,18250,2475,1399,3874,2363,1184,3547,2477,19,180,1,0,7,98,1278,1583
1,12/11/2022,0103-Mannadi,66902,91582,0,1624,31692,0,0,100218,0,0,0,0,3000,3000,2221,1129,3350,2422,1141,3563,2506,18,190,2,0,2,64,1059,1335
1,12/11/2022,0105-High Court,74255,150825,600,2600,56708,0,0,134163,0,0,0,0,0,0,3597,1999,5596,3692,1682,5374,3823,22,274,2,0,6,102,1833,2239
1,12/11/2022,0109-Government Estate,70648,138467,1850,3656,53610,0,0,129764,0,0,0,0,500,500,3188,1980,5168,3541,1772,5313,3642,21,236,2,0,4,138,1751,2152
1,12/11/2022,0111-LIC,43491,78408,500,2464,27804,0,0,74259,0,0,0,0,5500,5500,1702,975,2677,2083,811,2894,2025,16,0,0,0,6,69,859,950
1,12/11/2022,0113-Thousand Lights,79896,148629,250,4096,40824,0,0,125066,0,0,0,0,1000,1000,3695,1496,5191,4218,1488,5706,4259,21,182,3,0,11,157,1243,1617
1,12/11/2022,0115-AG-DMS,51508,65991,400,2624,18090,0,0,72622,0,0,0,0,1000,1000,1590,679,2269,1629,677,2306,1813,10,200,0,0,1,97,542,850
1,12/11/2022,0117-Teynampet,37145,70821,0,1208,24766,0,0,63119,0,0,0,0,1000,1000,1653,901,2554,1971,749,2720,1873,9,0,2,0,4,52,814,881
1,12/11/2022,0119-Nandanam,47276,71064,200,2296,25012,0,0,74784,0,0,0,0,1000,1000,1803,918,2721,1956,699,2655,1883,23,13,1,0,1,87,792,917
1,12/11/2022,0121-Saidapet,23501,50810,0,1072,22700,0,0,47273,0,0,0,0,500,500,1013,761,1774,1202,602,1804,1095,8,0,6,0,1,42,707,764
1,12/11/2022,0123-Little Mount,47741,60146,100,1960,21758,0,0,71559,0,0,0,0,2250,2250,1625,815,2440,1402,649,2051,1526,13,208,7,0,4,79,711,1022
1,12/11/2022,0125-Guindy,91832,177297,1060,6592,72594,0,0,172078,0,0,0,0,3000,3000,3925,2503,6428,3672,2324,5996,3971,32,649,3,0,10,238,2145,3077
1,12/11/2022,0129-Nanganallur Road,28280,32489,0,544,12522,0,0,41346,0,0,0,0,0,0,603,375,978,806,298,1104,717,7,0,0,0,1,21,352,381
1,12/11/2022,0131-Meenambakkam,76988,92566,1600,3360,34270,0,0,116218,0,0,0,0,0,0,2208,1020,3228,1785,847,2632,1927,29,261,3,0,9,81,925,1308
1,12/11/2022,0133-Chennai International Airport,141744,299760,1700,11096,175796,0,0,330336,0,0,0,0,1500,1500,4310,4960,9270,3250,4366,7616,3824,59,1067,21,0,17,337,4331,5832
2,12/11/2022,0201-Puratchi Thalaivar Dr. M.G. Ramachandran Central,236461,430655,505,13976,167098,0,0,418040,0,0,0,0,6500,6500,9565,5985,15550,7896,7795,15691,10123,95,3296,12,0,25,527,5140,9095
2,12/11/2022,0203-Egmore,76149,125860,500,3072,58366,0,0,138087,0,0,0,0,16000,16000,2204,2023,4227,2501,2832,5333,2688,15,722,2,0,7,125,1905,2776
2,12/11/2022,0205-Nehru Park,30069,50589,0,1512,19910,0,0,51491,0,0,0,0,250,250,1191,760,1951,1175,664,1839,1265,16,153,0,0,2,65,673,909
2,12/11/2022,0207-Kilpauk,26015,50315,200,1400,17134,0,0,44749,0,0,0,0,0,0,1110,636,1746,1222,651,1873,1278,9,180,0,0,1,57,571,818
2,12/11/2022,0209-Pachaiyappas College,39143,33555,0,368,10888,0,0,50399,0,0,0,0,8000,8000,958,407,1365,916,368,1284,928,6,125,0,0,1,19,373,524
2,12/11/2022,0211-Shenoy Nagar,42369,36557,630,1008,10876,0,0,54883,0,0,0,0,4000,4000,1000,395,1395,984,403,1387,1015,9,120,0,0,2,38,345,514
2,12/11/2022,0213-Anna Nagar East,65612,94210,1100,3624,31762,0,0,102098,0,0,0,0,4500,4500,2417,1226,3643,2303,1023,3326,2477,22,264,4,0,2,151,1046,1489
2,12/11/2022,0215-Anna Nagar Tower,53218,77745,350,3504,24908,0,0,81980,0,0,0,0,250,250,1922,931,2853,1951,864,2815,2035,11,226,0,0,3,101,808,1149
2,12/11/2022,0217-Thirumangalam,174071,255510,2400,9800,97078,0,0,283349,0,0,0,0,0,0,5470,3379,8849,5451,3158,8609,5861,42,890,5,0,7,360,2904,4208
2,12/11/2022,0219-Koyambedu,126779,194272,1350,5728,85126,0,0,218983,0,0,0,5000,3000,8000,4021,2974,6995,3585,2484,6069,3996,42,856,8,0,18,226,2584,3734
2,12/11/2022,0221-Puratchi Thalaivi Dr. J. Jayalalithaa CMBT,55104,155213,1250,3696,75958,0,0,136008,0,0,0,0,0,0,2065,2556,4621,3363,3871,7234,3069,27,577,3,0,6,122,2357,3092
2,12/11/2022,0223-Arumbakkam,44461,55776,100,1224,26968,0,0,72753,0,0,0,2000,500,2500,1231,994,2225,1303,744,2047,1171,21,0,12,0,13,50,927,1023
2,12/11/2022,0225-Vadapalani,121099,223969,270,11096,79994,0,0,212459,0,0,0,0,4500,4500,4877,3198,8075,4470,3503,7973,5434,35,1435,6,0,13,431,2497,4417
2,12/11/2022,0227-Ashok Nagar,80037,125082,675,5352,47054,0,0,133118,0,0,0,0,4500,4500,2829,1758,4587,2572,1658,4230,2936,26,600,0,0,3,205,1478,2312
2,12/11/2022,0229-Ekkattuthangal,53249,79131,800,2528,28416,0,0,84993,0,0,0,0,0,0,1960,1027,2987,1801,816,2617,1995,14,347,3,0,4,101,891,1360
2,12/11/2022,0231-Arignar Anna Alandur,123206,161010,100,5928,70200,0,0,199434,0,0,0,0,2250,2250,3303,2378,5681,3106,1937,5043,3373,54,628,3,0,1,198,2025,2909
2,12/11/2022,0233-St. Thomas Mount,54399,96624,100,4752,48776,0,0,108027,0,0,0,0,3000,3000,1718,1657,3375,1967,1067,3034,1792,16,79,1,0,12,153,1441,1702
1,13/11/2022,01ED-Wimco Nagar Depot Metro,46834,66248,150,2392,33518,0,0,82894,0,0,0,0,2250,2250,996,838,1834,1105,475,1580,1003,16,0,4,0,14,58,785,877
1,13/11/2022,01EF-Wimco Nagar Metro,51632,67638,1000,2048,27240,0,0,81920,0,0,0,0,0,0,1295,723,2018,1167,743,1910,1218,40,118,3,0,12,65,627,865
1,13/11/2022,01F1-Thiruvotriyur Metro,67287,80569,0,2640,37190,0,0,107117,0,0,0,0,0,0,1348,983,2331,1480,705,2185,1389,12,0,4,0,11,75,914,1016
1,13/11/2022,01F3-Thiruvotriyur Theradi Metro,58825,94182,700,2832,41470,0,0,103827,0,0,0,0,0,0,1519,1158,2677,1682,1141,2823,1715,17,103,0,0,12,88,1044,1264
1,13/11/2022,01F5-Kaladipet Metro,44678,70797,0,1448,37042,0,0,83168,0,0,0,0,0,0,1196,1049,2245,1331,861,2192,1217,18,0,0,0,9,51,975,1053
1,13/11/2022,01F7-Tollgate Metro,32426,47322,0,1312,24396,0,0,58134,0,0,0,0,0,0,775,729,1504,840,561,1401,801,24,24,0,0,14,46,668,776
1,13/11/2022,01F9-New Washermenpet Metro,38887,62587,0,1296,28954,0,0,69137,0,0,0,0,250,250,1218,882,2100,1304,764,2068,1263,8,93,0,0,6,40,846,993
1,13/11/2022,01FB-Tondiarpet Metro,41935,69958,1200,1504,34434,0,0,79073,0,0,0,0,0,0,1261,1066,2327,1438,861,2299,1326,18,2,0,0,13,48,1007,1088
1,13/11/2022,01FD-Thiagaraya College Metro,63208,87807,0,3440,39684,0,0,106332,0,0,0,0,500,500,1821,1343,3164,1869,1116,2985,1868,60,57,0,0,7,115,1202,1441
1,13/11/2022,0101-Washermanpet,75396,81796,0,2456,42100,0,0,119952,0,0,0,0,21000,21000,1460,1384,2844,1433,1236,2669,1517,14,171,0,0,13,91,1269,1558
1,13/11/2022,0103-Mannadi,39698,63407,100,1896,31220,0,0,72914,0,0,0,0,0,0,1088,1081,2169,1192,1144,2336,1247,13,196,0,0,4,59,996,1268
1,13/11/2022,0105-High Court,32840,63034,100,1432,32558,0,0,66930,0,0,0,0,0,0,1192,1183,2375,1163,958,2121,1229,13,185,3,0,1,61,1087,1350
1,13/11/2022,0109-Government Estate,45998,86586,250,2216,39884,0,0,88348,0,0,0,0,250,250,1737,1436,3173,1747,1340,3087,1902,21,357,0,0,12,82,1276,1748
1,13/11/2022,0111-LIC,15047,52377,250,1832,26966,0,0,44095,0,0,0,0,0,0,809,932,1741,1053,742,1795,976,9,0,1,0,3,69,835,917
1,13/11/2022,0113-Thousand Lights,24805,77258,500,2664,37010,0,0,64979,0,0,0,0,0,0,1298,1295,2593,1750,1167,2917,1581,14,0,3,0,5,99,1085,1206
1,13/11/2022,0115-AG-DMS,20538,38242,280,1696,15898,0,0,38412,0,0,0,0,0,0,747,545,1292,743,455,1198,815,9,149,0,0,0,59,475,692
1,13/11/2022,0117-Teynampet,19561,41285,0,1384,21254,0,0,42199,0,0,0,0,0,0,695,784,1479,909,762,1671,807,19,9,0,0,6,53,701,788
1,13/11/2022,0119-Nandanam,20325,47496,0,2688,24414,0,0,47427,0,0,0,0,0,0,755,917,1672,959,682,1641,887,11,19,3,0,4,87,781,905
1,13/11/2022,0121-Saidapet,21674,45273,100,1360,25282,0,0,48416,0,0,0,0,4000,4000,606,857,1463,857,777,1634,738,6,1,0,0,4,51,803,865
1,13/11/2022,0123-Little Mount,28470,48305,0,1904,21938,0,0,52312,0,0,0,0,1000,1000,960,778,1738,896,666,1562,982,20,202,6,0,5,75,677,985
1,13/11/2022,0125-Guindy,66072,145384,250,5680,74820,0,0,146822,0,0,0,0,4000,4000,2335,2459,4794,2151,2604,4755,2478,20,666,3,0,13,204,2191,3097
1,13/11/2022,0129-Nanganallur Road,7481,21913,50,392,12770,0,0,20693,0,0,0,0,0,0,261,384,645,418,353,771,326,3,0,1,0,0,14,366,384
1,13/11/2022,0131-Meenambakkam,47102,74271,100,1880,38428,0,0,87510,0,0,0,0,0,0,1246,1071,2317,1004,970,1974,1124,11,283,2,0,7,57,976,1336
1,13/11/2022,0133-Chennai International Airport,119394,305624,2940,9328,185974,0,0,317636,0,0,0,0,0,0,3615,5155,8770,3344,4349,7693,3673,50,1101,15,0,23,300,4379,5868
2,13/11/2022,0201-Puratchi Thalaivar Dr. M.G. Ramachandran Central,197532,367819,300,12128,157632,0,0,367592,0,0,0,0,4650,4650,7354,5671,13025,4951,7123,12074,7647,92,3667,8,0,24,463,4855,9109
2,13/11/2022,0203-Egmore,68365,122876,0,3088,60556,0,0,132009,0,0,0,0,13000,13000,2088,2060,4148,1931,2613,4544,2316,16,905,2,0,18,125,1922,2988
2,13/11/2022,0205-Nehru Park,24396,40178,0,1056,19220,0,0,44672,0,0,0,0,1000,1000,782,708,1490,765,625,1390,818,10,179,0,1,1,46,641,878
2,13/11/2022,0207-Kilpauk,16926,36420,0,1080,18140,0,0,36146,0,0,0,0,0,0,598,646,1244,694,594,1288,705,5,102,2,0,0,45,592,746
2,13/11/2022,0209-Pachaiyappas College,21716,25930,100,376,11132,0,0,33324,0,0,0,0,8000,8000,551,390,941,545,359,904,580,8,114,0,0,1,15,370,508
2,13/11/2022,0211-Shenoy Nagar,16078,25353,50,400,11110,0,0,27638,0,0,0,0,0,0,514,387,901,588,420,1008,568,6,75,0,0,4,20,360,465
2,13/11/2022,0213-Anna Nagar East,40628,63615,150,1888,28074,0,0,70740,0,0,0,0,3000,3000,1390,998,2388,1341,968,2309,1391,16,272,0,0,6,80,892,1266
2,13/11/2022,0215-Anna Nagar Tower,41641,58215,400,1744,22308,0,0,66093,0,0,0,0,0,0,1237,803,2040,1236,824,2060,1356,15,302,1,0,2,71,706,1097
2,13/11/2022,0217-Thirumangalam,118000,212985,1320,8472,105032,0,0,232824,0,0,0,0,0,0,3689,3499,7188,3794,3044,6838,3950,39,752,7,0,5,307,3003,4113
2,13/11/2022,0219-Koyambedu,93653,161674,200,3848,81216,0,0,178917,0,0,0,5000,1250,6250,2865,2798,5663,2441,2375,4816,2853,39,964,4,0,24,155,2492,3678
2,13/11/2022,0221-Puratchi Thalaivi Dr. J. Jayalalithaa CMBT,63135,147347,420,3440,78002,0,0,144997,0,0,0,0,0,0,1768,2575,4343,2398,3643,6041,2543,25,972,2,0,7,140,2397,3543
2,13/11/2022,0223-Arumbakkam,22210,42779,50,704,27728,0,0,50692,0,0,0,0,2250,2250,643,1011,1654,814,693,1507,625,7,0,0,0,12,32,941,992
2,13/11/2022,0225-Vadapalani,91136,204503,800,9608,93710,0,0,195254,0,0,0,0,2500,2500,3610,3447,7057,3656,3495,7151,4186,36,1131,7,0,22,388,2843,4427
2,13/11/2022,0227-Ashok Nagar,52200,94478,400,3376,47448,0,0,103424,0,0,0,0,0,0,1617,1684,3301,1773,1544,3317,1786,26,351,2,0,9,146,1446,1980
2,13/11/2022,0229-Ekkattuthangal,33798,52504,650,2568,20180,0,0,57196,0,0,0,0,0,0,1161,776,1937,1116,778,1894,1298,16,374,1,0,5,113,619,1128
2,13/11/2022,0231-Arignar Anna Alandur,82194,135475,0,4440,63662,0,0,150296,0,0,0,0,1250,1250,2415,2095,4510,2326,1902,4228,2586,37,715,20,1,19,162,1827,2781
2,13/11/2022,0233-St. Thomas Mount,40620,77951,0,2608,44030,0,0,87258,0,0,0,0,1050,1050,1141,1418,2559,1290,1169,2459,1227,21,236,0,0,4,106,1276,1643
1,14/11/2022,01ED-Wimco Nagar Depot Metro,102636,85597,950,1336,27400,0,0,132322,0,0,0,0,4000,4000,2205,731,2936,1895,431,2326,1845,20,0,7,0,6,39,674,746
1,14/11/2022,01EF-Wimco Nagar Metro,161555,144158,210,3584,32308,0,0,197657,0,0,0,0,750,750,3738,917,4655,3505,887,4392,3527,53,77,5,0,8,102,797,1042
1,14/11/2022,01F1-Thiruvotriyur Metro,152430,118548,146,1784,25518,0,0,179878,0,0,0,0,0,0,3199,742,3941,3184,615,3799,3091,38,0,2,0,6,58,680,784
1,14/11/2022,01F3-Thiruvotriyur Theradi Metro,130712,140398,2200,2000,32880,0,0,167792,0,0,0,0,0,0,3170,954,4124,3646,1100,4746,3638,33,85,1,0,16,64,870,1069
1,14/11/2022,01F5-Kaladipet Metro,135101,118511,0,2144,29994,0,0,167239,0,0,0,0,0,0,3256,923,4179,3373,801,4174,3285,21,0,0,1,1,52,871,946
1,14/11/2022,01F7-Tollgate Metro,79289,63559,0,1488,15930,0,0,96707,0,0,0,0,0,0,1731,526,2257,1789,398,2187,1750,16,0,0,0,6,39,468,529
1,14/11/2022,01F9-New Washermenpet Metro,115915,110666,0,1160,27146,0,0,144221,0,0,0,0,1250,1250,3164,911,4075,3381,859,4240,3332,17,61,1,0,1,40,866,986
1,14/11/2022,01FB-Tondiarpet Metro,113733,125213,200,1872,38194,0,0,153999,0,0,0,0,500,500,3261,1245,4506,3538,1052,4590,3413,24,1,2,0,6,56,1169,1258
1,14/11/2022,01FD-Thiagaraya College Metro,155741,138970,900,1968,35258,0,0,193867,0,0,0,0,2500,2500,4090,1255,5345,4333,1076,5409,4271,51,61,2,0,6,69,1161,1350
1,14/11/2022,0101-Washermanpet,128079,145538,862,1920,46652,0,0,177513,0,0,0,0,15250,15250,4147,1605,5752,4064,1489,5553,4009,28,142,3,0,8,70,1519,1770
1,14/11/2022,0103-Mannadi,110326,120997,230,1072,32000,0,0,143628,0,0,0,0,1500,1500,3333,1122,4455,3776,1306,5082,3753,20,105,3,0,2,43,1054,1227
1,14/11/2022,0105-High Court,181458,248632,0,3320,59084,0,0,243862,0,0,0,0,0,0,7637,2051,9688,7400,2039,9439,7769,33,500,0,0,1,118,2004,2656
1,14/11/2022,0109-Government Estate,94922,161252,1400,2880,50102,0,0,149304,0,0,0,0,1750,1750,4261,1877,6138,4942,1746,6688,4936,26,131,0,0,5,123,1681,1966
1,14/11/2022,0111-LIC,117426,188596,2350,3032,24674,0,0,147482,0,0,0,0,0,0,5866,949,6815,6302,1143,7445,6514,22,291,0,0,1,125,774,1213
1,14/11/2022,0113-Thousand Lights,183426,279419,2950,7240,44816,0,0,238432,0,0,0,0,0,0,8524,1758,10282,9146,1772,10918,9354,51,284,1,0,5,242,1396,1979
1,14/11/2022,0115-AG-DMS,126975,170589,3680,2568,32296,0,0,165519,0,0,0,0,1500,1500,5389,1151,6540,5309,985,6294,5459,29,185,1,0,3,103,995,1316
1,14/11/2022,0117-Teynampet,117793,163717,1550,2288,37742,0,0,159373,0,0,0,0,250,250,4962,1392,6354,5418,1162,6580,5282,21,1,0,0,5,87,1266,1380
1,14/11/2022,0119-Nandanam,123114,141934,1048,3352,28986,0,0,156500,0,0,0,0,2500,2500,4223,1150,5373,4874,1034,5908,4812,27,60,3,0,1,128,966,1185
1,14/11/2022,0121-Saidapet,58906,98322,230,1760,29756,0,0,90652,0,0,0,0,2500,2500,2138,1059,3197,2846,941,3787,2769,19,0,0,0,4,72,979,1074
1,14/11/2022,0123-Little Mount,102323,108581,1901,2688,26768,0,0,133680,0,0,0,0,1500,1500,3868,1023,4891,3253,805,4058,3311,18,158,1,0,4,106,879,1166
1,14/11/2022,0125-Guindy,172835,293540,2900,9592,78032,0,0,263359,0,0,0,0,2500,2500,8659,2811,11470,7959,2704,10663,8537,47,783,3,0,5,301,2375,3514
1,14/11/2022,0129-Nanganallur Road,73621,49785,100,696,11918,0,0,86335,0,0,0,0,0,0,1371,384,1755,1510,319,1829,1459,17,2,1,0,0,27,349,396
1,14/11/2022,0131-Meenambakkam,152337,147362,1400,2952,40396,0,0,197085,0,0,0,0,0,0,4230,1248,5478,3503,1049,4552,3662,19,237,0,1,2,97,1119,1475
1,14/11/2022,0133-Chennai International Airport,231999,362470,1050,9368,148682,0,0,391099,0,0,0,0,7500,7500,6895,4201,11096,6105,4115,10220,6784,64,1269,9,0,16,288,3657,5303
2,14/11/2022,0201-Puratchi Thalaivar Dr. M.G. Ramachandran Central,349262,532155,940,16960,172374,0,0,539536,0,0,0,0,8450,8450,15684,6401,22085,12485,7650,20135,14972,121,3326,4,0,16,662,5433,9562
2,14/11/2022,0203-Egmore,113240,145348,0,4344,59700,0,0,177284,0,0,0,0,12250,12250,3533,2152,5685,2932,2588,5520,3468,26,909,5,0,14,170,1933,3057
2,14/11/2022,0205-Nehru Park,42289,55211,1000,1048,19098,0,0,63435,0,0,0,0,4500,4500,1565,715,2280,1538,619,2157,1544,12,117,0,0,0,44,657,830
2,14/11/2022,0207-Kilpauk,42587,66316,100,1176,21778,0,0,65641,0,0,0,0,250,250,1696,813,2509,1827,699,2526,1812,21,96,0,0,2,51,747,917
2,14/11/2022,0209-Pachaiyappas College,59930,57294,0,840,14562,0,0,75332,0,0,0,0,3000,3000,1941,573,2514,1864,562,2426,1810,25,99,1,0,0,32,524,681
2,14/11/2022,0211-Shenoy Nagar,62741,58222,1100,824,15594,0,0,80259,0,0,0,0,5500,5500,1520,566,2086,1738,543,2281,1744,15,102,0,0,2,30,523,672
2,14/11/2022,0213-Anna Nagar East,102314,124531,400,3704,33424,0,0,139842,0,0,0,0,0,0,3510,1230,4740,3559,1035,4594,3634,32,190,1,0,1,114,1102,1440
2,14/11/2022,0215-Anna Nagar Tower,127696,112426,1350,2752,27008,0,0,158806,0,0,0,0,12750,12750,3127,1018,4145,3320,890,4210,3338,21,175,2,0,0,100,889,1187
2,14/11/2022,0217-Thirumangalam,327610,342523,400,10848,88934,0,0,427792,0,0,0,0,0,0,9085,3086,12171,9392,3011,12403,9524,72,561,4,0,4,271,2711,3623
2,14/11/2022,0219-Koyambedu,254007,286961,934,5488,99092,0,0,359521,0,0,0,5000,14000,19000,7325,3348,10673,6230,2648,8878,6917,78,1021,8,0,18,223,2989,4337
2,14/11/2022,0221-Puratchi Thalaivi Dr. J. Jayalalithaa CMBT,110632,213039,700,5040,87812,0,0,204184,0,0,0,0,0,0,2648,2980,5628,4088,3583,7671,4742,27,1231,2,0,9,203,2697,4169
2,14/11/2022,0223-Arumbakkam,79536,72321,500,1440,27076,0,0,108552,0,0,0,0,11250,11250,1733,966,2699,1997,807,2804,1857,20,10,2,0,3,60,888,983
2,14/11/2022,0225-Vadapalani,154776,241178,50,4848,87332,0,0,247006,0,0,0,0,10500,10500,5412,3076,8488,5959,2931,8890,5980,39,632,3,0,7,209,2724,3614
2,14/11/2022,0227-Ashok Nagar,117190,165246,3300,3992,54082,0,0,178564,0,0,0,0,3500,3500,4133,1888,6021,4384,1727,6111,4370,32,257,4,0,2,146,1679,2120
2,14/11/2022,0229-Ekkattuthangal,106910,151571,700,3360,32588,0,0,143558,0,0,0,0,500,500,4240,1245,5485,4642,1300,5942,4763,37,331,1,0,5,140,1036,1550
2,14/11/2022,0231-Arignar Anna Alandur,198670,217524,0,4984,63748,0,0,267402,0,0,0,0,5250,5250,6038,2206,8244,5737,1798,7535,5986,64,492,1,0,4,179,1892,2632
2,14/11/2022,0233-St. Thomas Mount,102604,120066,2500,3184,39590,0,0,147878,0,0,0,0,4800,4800,3098,1357,4455,3286,1133,4419,3186,25,61,1,0,5,115,1200,1407
1,15/11/2022,01ED-Wimco Nagar Depot Metro,91443,81588,0,1504,25188,0,0,118135,0,0,0,0,2000,2000,2244,667,2911,1830,397,2227,1794,17,0,4,0,2,44,615,682
1,15/11/2022,01EF-Wimco Nagar Metro,132204,135398,404,2952,29796,0,0,165356,0,0,0,0,2500,2500,3694,836,4530,3330,800,4130,3336,68,58,6,0,3,88,731,954
1,15/11/2022,01F1-Thiruvotriyur Metro,139173,109123,0,1792,20828,0,0,161793,0,0,0,0,0,0,3194,612,3806,3004,472,3476,2972,25,1,0,0,4,53,558,641
1,15/11/2022,01F3-Thiruvotriyur Theradi Metro,105407,119407,1500,1912,23906,0,0,132725,0,0,0,0,0,0,3053,725,3778,3348,669,4017,3291,18,36,2,0,2,60,640,758
1,15/11/2022,01F5-Kaladipet Metro,114679,105321,0,1288,20862,0,0,136829,0,0,0,0,0,0,3138,685,3823,3218,555,3773,3158,21,0,0,0,2,46,620,689
1,15/11/2022,01F7-Tollgate Metro,71394,59205,0,608,12788,0,0,84790,0,0,0,0,0,0,1795,416,2211,1764,360,2124,1716,32,1,0,0,3,20,384,440
1,15/11/2022,01F9-New Washermenpet Metro,107276,98196,250,656,15176,0,0,123358,0,0,0,0,0,0,3278,541,3819,3246,644,3890,3310,17,139,2,0,4,23,515,700
1,15/11/2022,01FB-Tondiarpet Metro,107892,106528,350,1728,24528,0,0,134498,0,0,0,0,750,750,3217,850,4067,3303,782,4085,3238,24,0,1,0,3,52,779,859
1,15/11/2022,01FD-Thiagaraya College Metro,125135,124762,0,1568,25554,0,0,152257,0,0,0,0,1750,1750,4048,932,4980,4120,845,4965,4098,60,50,1,0,2,57,862,1032
1,15/11/2022,0101-Washermanpet,121295,131528,324,2264,38842,0,0,162725,0,0,0,0,15000,15000,4135,1390,5525,3822,1243,5065,3832,29,100,0,0,4,87,1283,1503
1,15/11/2022,0103-Mannadi,94997,117948,1000,1304,26990,0,0,124291,0,0,0,0,0,0,3367,976,4343,3861,1086,4947,3825,23,106,0,0,0,54,908,1091
1,15/11/2022,0105-High Court,166407,272010,550,3472,69668,0,0,240097,0,0,0,0,0,0,7862,2367,10229,8040,2170,10210,8276,45,405,2,0,2,141,2332,2927
1,15/11/2022,0109-Government Estate,112973,165650,600,2856,51294,0,0,167723,0,0,0,0,1500,1500,4510,1884,6394,5080,1647,6727,5078,33,186,2,0,4,129,1698,2052
1,15/11/2022,0111-LIC,97206,190140,992,2584,33572,0,0,134354,0,0,0,0,0,0,5491,1215,6706,6367,1033,7400,6267,12,12,0,0,3,109,1064,1200
1,15/11/2022,0113-Thousand Lights,151901,276218,2050,6128,39404,0,0,199483,0,0,0,0,0,0,8626,1596,10222,9400,1494,10894,9573,46,218,0,0,5,246,1248,1763
1,15/11/2022,0115-AG-DMS,132055,160459,1100,2760,28064,0,0,163979,0,0,0,0,0,0,5263,1022,6285,5205,814,6019,5284,34,138,1,0,3,85,884,1145
1,15/11/2022,0117-Teynampet,116523,155216,700,2272,20228,0,0,139723,0,0,0,0,4000,4000,5261,837,6098,5477,962,6439,5606,31,239,2,0,2,85,712,1071
1,15/11/2022,0119-Nandanam,108863,137775,350,1784,27226,0,0,138223,0,0,0,0,1000,1000,4258,1062,5320,4892,873,5765,4769,31,0,0,0,2,79,944,1056
1,15/11/2022,0121-Saidapet,57026,91884,0,1736,23618,0,0,82380,0,0,0,0,2250,2250,2208,854,3062,2844,826,3670,2772,17,0,1,0,2,60,776,856
1,15/11/2022,0123-Little Mount,108698,102500,200,2432,23206,0,0,134536,0,0,0,0,4000,4000,3764,921,4685,3186,637,3823,3239,26,142,0,0,1,90,792,1051
1,15/11/2022,0125-Guindy,171588,276780,2767,6080,56396,0,0,236831,0,0,0,0,4500,4500,8937,2071,11008,8007,2329,10336,8693,45,895,4,0,6,232,1763,2945
1,15/11/2022,0129-Nanganallur Road,57520,51138,100,1336,12862,0,0,71818,0,0,0,0,0,0,1379,401,1780,1522,334,1856,1467,12,0,0,0,1,20,370,403
1,15/11/2022,0131-Meenambakkam,144038,140593,350,3216,34582,0,0,182186,0,0,0,0,0,0,4156,1064,5220,3514,903,4417,3635,26,172,2,0,1,87,950,1238
1,15/11/2022,0133-Chennai International Airport,249781,344090,1230,9872,128380,0,0,389263,0,0,0,0,28500,28500,7031,3632,10663,5871,3952,9823,6808,85,1460,13,0,10,253,3190,5011
2,15/11/2022,0201-Puratchi Thalaivar Dr. M.G. Ramachandran Central,306776,487239,2000,12120,147744,0,0,468640,0,0,0,0,11650,11650,14626,5395,20021,12130,6971,19101,14351,123,3011,9,0,21,512,4678,8354
2,15/11/2022,0203-Egmore,87328,140316,900,3128,61050,0,0,152406,0,0,0,0,14500,14500,2973,2106,5079,2892,2580,5472,3229,22,695,10,0,9,130,1984,2850
2,15/11/2022,0205-Nehru Park,43307,51660,400,1128,15300,0,0,60135,0,0,0,0,500,500,1547,603,2150,1504,511,2015,1542,15,116,0,0,1,41,546,719
2,15/11/2022,0207-Kilpauk,45250,64081,500,1256,18378,0,0,65384,0,0,0,0,1000,1000,1671,695,2366,1807,640,2447,1844,8,94,0,0,1,51,615,769
2,15/11/2022,0209-Pachaiyappas College,58875,56248,0,680,13788,0,0,73343,0,0,0,0,6000,6000,1940,547,2487,1838,496,2334,1812,17,99,1,0,0,31,509,657
2,15/11/2022,0211-Shenoy Nagar,49207,55939,500,1008,13206,0,0,63921,0,0,0,0,250,250,1519,491,2010,1714,451,2165,1745,7,94,0,0,2,36,439,578
2,15/11/2022,0213-Anna Nagar East,96196,121414,100,3536,29238,0,0,129070,0,0,0,0,0,0,3524,1127,4651,3608,958,4566,3653,39,179,0,0,2,113,974,1307
2,15/11/2022,0215-Anna Nagar Tower,100546,111504,202,2504,26352,0,0,129604,0,0,0,0,3500,3500,3194,975,4169,3254,864,4118,3316,22,170,0,0,1,85,867,1145
2,15/11/2022,0217-Thirumangalam,325757,333236,3277,7400,80904,0,0,417338,0,0,0,0,0,0,9194,2861,12055,9363,2518,11881,9486,63,494,1,0,3,282,2503,3346
2,15/11/2022,0219-Koyambedu,224791,263951,946,4568,80974,0,0,311279,0,0,0,0,12750,12750,6999,2784,9783,6243,2181,8424,6689,53,825,4,0,8,190,2502,3582
2,15/11/2022,0221-Puratchi Thalaivi Dr. J. Jayalalithaa CMBT,77092,171997,1250,3016,80584,0,0,161942,0,0,0,0,0,0,1884,2684,4568,3893,3024,6917,3614,32,415,7,0,4,127,2517,3102
2,15/11/2022,0223-Arumbakkam,68596,67292,500,1344,23566,0,0,94006,0,0,0,0,2500,2500,1866,849,2715,1959,691,2650,1816,34,0,2,0,3,37,784,860
2,15/11/2022,0225-Vadapalani,142600,229700,0,5480,76770,0,0,224850,0,0,0,0,6500,6500,5404,2729,8133,5812,2535,8347,5952,45,582,1,0,9,218,2411,3266
2,15/11/2022,0227-Ashok Nagar,99103,157688,3552,3992,47860,0,0,154507,0,0,0,0,0,0,4173,1694,5867,4290,1558,5848,4348,27,275,2,0,1,148,1493,1946
2,15/11/2022,0229-Ekkattuthangal,107965,147441,800,4344,26486,0,0,139595,0,0,0,0,1000,1000,4437,996,5433,4667,1021,5688,4855,26,358,1,0,8,112,833,1338
2,15/11/2022,0231-Arignar Anna Alandur,180797,209090,1200,3992,55612,0,0,241601,0,0,0,0,5500,5500,6091,1889,7980,5706,1590,7296,5990,44,488,7,0,3,148,1663,2353
2,15/11/2022,0233-St. Thomas Mount,84728,116916,700,3544,33868,0,0,122840,0,0,0,0,7325,7325,3177,1203,4380,3185,910,4095,3237,16,121,0,0,1,127,1035,1300
1,16/11/2022,01ED-Wimco Nagar Depot Metro,89508,80012,200,1280,24374,0,0,115362,0,0,0,0,1750,1750,2238,634,2872,1846,366,2212,1764,18,0,2,0,5,39,607,671
1,16/11/2022,01EF-Wimco Nagar Metro,130941,141203,100,4208,29286,0,0,164535,0,0,0,0,500,500,3790,831,4621,3499,716,4215,3495,42,105,6,0,8,101,715,977
1,16/11/2022,01F1-Thiruvotriyur Metro,123492,113613,0,1624,22538,0,0,147654,0,0,0,0,0,0,3181,639,3820,3121,421,3542,3042,40,0,0,0,6,45,599,690
1,16/11/2022,01F3-Thiruvotriyur Theradi Metro,102866,120175,600,2520,24972,0,0,130958,0,0,0,0,0,0,3045,742,3787,3311,679,3990,3260,30,29,5,0,0,67,653,784
1,16/11/2022,01F5-Kaladipet Metro,115480,105166,200,1176,20702,0,0,137558,10,0,10,0,0,0,3190,659,3849,3232,543,3775,3147,20,0,0,1,4,39,613,677
1,16/11/2022,01F7-Tollgate Metro,72007,59773,0,528,8236,0,0,80771,0,0,0,0,0,0,1976,276,2252,1757,330,2087,1867,19,164,0,0,4,16,249,452
1,16/11/2022,01F9-New Washermenpet Metro,105592,103010,0,792,21590,0,0,127974,0,0,0,0,0,0,3194,729,3923,3279,625,3904,3244,13,49,3,0,0,29,700,794
1,16/11/2022,01FB-Tondiarpet Metro,95554,106661,600,1456,24164,0,0,121774,0,0,0,0,1250,1250,3179,836,4015,3333,754,4087,3226,19,1,2,0,4,49,775,850
1,16/11/2022,01FD-Thiagaraya College Metro,115056,125844,700,1936,26260,0,0,143952,0,0,0,0,1000,1000,3843,970,4813,4222,877,5099,4107,33,11,0,0,2,69,885,1000
1,16/11/2022,0101-Washermanpet,117717,133387,1200,2648,34588,0,0,156153,0,0,0,0,5250,5250,4265,1224,5489,3879,1095,4974,4005,23,277,1,0,4,92,1117,1514
1,16/11/2022,0103-Mannadi,90725,117267,1500,1536,11424,0,0,105185,0,0,0,0,0,0,4064,423,4487,3833,1057,4890,4362,23,679,0,0,1,46,367,1116
1,16/11/2022,0105-High Court,155514,250572,100,3312,59336,0,0,218262,0,0,0,0,0,0,7495,2112,9607,7664,1900,9564,7838,52,379,1,0,5,97,1976,2510
1,16/11/2022,0109-Government Estate,109458,159600,620,2416,44940,0,0,157434,0,0,0,0,4250,4250,4481,1670,6151,4939,1555,6494,5032,25,344,6,0,2,107,1496,1980
1,16/11/2022,0111-LIC,90143,192242,1000,2664,32264,0,0,126071,0,0,0,0,0,0,5631,1202,6833,6465,1028,7493,6411,32,0,0,0,5,113,1032,1182
1,16/11/2022,0113-Thousand Lights,150560,283436,2010,6176,38942,0,0,197688,0,0,0,0,1250,1250,8740,1572,10312,9649,1584,11233,9824,30,284,2,0,8,254,1230,1808
1,16/11/2022,0115-AG-DMS,106435,162217,2120,2472,30326,0,0,141353,0,0,0,0,1250,1250,5191,1079,6270,5133,784,5917,5231,17,176,0,0,1,93,946,1233
1,16/11/2022,0117-Teynampet,111000,163120,900,2032,31996,0,0,145928,0,0,0,0,0,0,5144,1241,6385,5632,947,6579,5476,32,2,5,0,3,89,1120,1251
1,16/11/2022,0119-Nandanam,115290,139003,500,2224,26894,0,0,144908,0,0,0,0,250,250,4365,1073,5438,4889,763,5652,4833,22,39,2,0,2,95,918,1078
1,16/11/2022,0121-Saidapet,59150,92616,0,1568,24894,0,0,85612,0,0,0,0,2250,2250,2279,904,3183,2869,794,3663,2761,26,1,0,0,1,66,814,908
1,16/11/2022,0123-Little Mount,90788,104032,1250,1960,23826,0,0,117824,0,0,0,0,1000,1000,3855,893,4748,3137,642,3779,3248,27,188,0,0,2,79,773,1069
1,16/11/2022,0125-Guindy,155747,273136,2394,7304,65066,0,0,230511,0,0,0,0,5000,5000,8576,2384,10960,7894,2242,10136,8304,40,537,1,0,4,253,2017,2852
1,16/11/2022,0129-Nanganallur Road,62055,48732,200,624,10362,0,0,73241,0,0,0,0,0,0,1417,347,1764,1524,300,1824,1470,25,1,0,1,0,23,306,356
1,16/11/2022,0131-Meenambakkam,135942,137276,1160,2496,26950,0,0,166548,0,0,0,0,0,0,4352,834,5186,3526,768,4294,3748,24,346,3,0,2,82,734,1191
1,16/11/2022,0133-Chennai International Airport,187469,323466,550,12208,142914,0,0,343141,0,0,0,0,9750,9750,6090,4022,10112,5804,3522,9326,5864,62,665,13,1,2,280,3574,4597
2,16/11/2022,0201-Puratchi Thalaivar Dr. M.G. Ramachandran Central,293768,474392,700,12232,141414,0,0,448114,0,0,0,0,4000,4000,14312,5305,19617,12404,6826,19230,14128,143,2886,10,0,21,462,4617,8139
2,16/11/2022,0203-Egmore,95381,128710,250,2424,52046,0,0,150101,0,0,0,0,22000,22000,2866,1834,4700,3041,2446,5487,3142,22,671,4,0,7,98,1697,2499
2,16/11/2022,0205-Nehru Park,43174,51397,600,1032,16424,0,0,61230,0,0,0,0,0,0,1538,632,2170,1510,480,1990,1474,15,86,0,0,1,38,588,728
2,16/11/2022,0207-Kilpauk,45532,66250,100,1128,19468,0,0,66228,0,0,0,0,250,250,1808,722,2530,1912,555,2467,1899,18,128,0,0,3,39,654,842
2,16/11/2022,0209-Pachaiyappas College,58744,58938,500,488,14662,0,0,74394,0,0,0,0,10000,10000,1991,580,2571,1938,536,2474,1863,10,111,1,0,2,20,538,682
2,16/11/2022,0211-Shenoy Nagar,53489,55976,0,1512,12638,0,0,67639,0,0,0,0,0,0,1554,469,2023,1708,413,2121,1745,13,96,0,0,0,44,413,566
2,16/11/2022,0213-Anna Nagar East,100742,120170,400,2480,28068,0,0,131690,0,0,0,0,0,0,3480,1066,4546,3489,928,4417,3634,15,323,0,0,2,99,934,1373
2,16/11/2022,0215-Anna Nagar Tower,108459,119068,250,2208,26162,0,0,137079,0,0,0,0,250,250,3414,933,4347,3432,895,4327,3589,27,372,0,0,4,74,821,1298
2,16/11/2022,0217-Thirumangalam,280478,340857,200,8080,80798,0,0,369556,0,0,0,0,1500,1500,9494,2850,12344,9471,2522,11993,9709,59,627,3,0,8,280,2469,3446
2,16/11/2022,0219-Koyambedu,197889,257560,840,4816,74790,0,0,278335,0,0,0,0,11250,11250,6906,2605,9511,6212,2110,8322,6689,58,853,10,0,15,188,2319,3443
2,16/11/2022,0221-Puratchi Thalaivi Dr. J. Jayalalithaa CMBT,87303,168027,650,2640,60196,0,0,150789,0,0,0,0,0,0,2209,2031,4240,3985,3024,7009,4162,33,890,1,0,2,105,1859,2890
2,16/11/2022,0223-Arumbakkam,56628,68244,0,1344,23092,0,0,81064,0,0,0,0,3250,3250,1873,858,2731,2002,580,2582,1852,28,14,5,0,0,49,790,886
2,16/11/2022,0225-Vadapalani,140883,225364,1100,4912,60974,0,0,207869,0,0,0,0,8000,8000,5809,2241,8050,5825,2427,8252,6327,39,1038,11,0,4,198,1913,3203
2,16/11/2022,0227-Ashok Nagar,119758,158298,1344,3952,32604,0,0,157658,0,0,0,0,500,500,4701,1247,5948,4262,1512,5774,4863,30,827,3,0,0,150,1014,2024
2,16/11/2022,0229-Ekkattuthangal,104769,150283,380,3144,27448,0,0,135741,0,0,0,0,250,250,4559,1039,5598,4674,1004,5678,4938,31,395,0,0,3,136,831,1396
2,16/11/2022,0231-Arignar Anna Alandur,171777,206362,1864,3840,52514,0,0,229995,0,0,0,0,5750,5750,6075,1777,7852,5812,1538,7350,6040,33,439,7,0,1,140,1545,2165
2,16/11/2022,0233-St. Thomas Mount,101241,114014,200,3336,34578,0,0,139355,0,0,0,500,2950,3450,3155,1188,4343,3269,861,4130,3116,28,18,3,0,1,114,1029,1193
1,17/11/2022,01ED-Wimco Nagar Depot Metro,76352,75577,100,1240,23180,0,0,100872,0,0,0,0,1750,1750,2158,614,2772,1666,401,2067,1656,11,0,1,0,5,36,564,617
1,17/11/2022,01EF-Wimco Nagar Metro,138607,137315,100,2840,27304,0,0,168851,0,0,0,0,250,250,3770,768,4538,3408,820,4228,3466,67,71,4,0,5,83,664,894
1,17/11/2022,01F1-Thiruvotriyur Metro,119068,108516,0,1128,19926,0,0,140122,0,0,0,0,0,0,3208,566,3774,3003,498,3501,2965,25,0,0,0,10,34,536,605
1,17/11/2022,01F3-Thiruvotriyur Theradi Metro,103580,122013,200,1936,26102,0,0,131818,0,0,0,0,0,0,3110,771,3881,3307,735,4042,3328,24,46,2,0,1,60,694,827
1,17/11/2022,01F5-Kaladipet Metro,111058,105139,600,1008,19920,0,0,132586,0,0,0,0,0,0,3179,645,3824,3224,578,3802,3178,27,0,0,0,2,37,596,662
1,17/11/2022,01F7-Tollgate Metro,66748,58882,0,784,11680,0,0,79212,0,0,0,0,250,250,1762,388,2150,1748,335,2083,1725,25,1,0,0,5,25,350,406
1,17/11/2022,01F9-New Washermenpet Metro,98275,101786,500,1112,21008,0,0,120895,0,0,0,0,0,0,3178,706,3884,3153,657,3810,3172,15,66,1,0,1,38,667,788
1,17/11/2022,01FB-Tondiarpet Metro,102929,105856,935,1120,25324,0,0,130308,0,0,0,0,0,0,3164,827,3991,3227,784,4011,3173,26,0,0,0,3,34,776,839
1,17/11/2022,01FD-Thiagaraya College Metro,106998,127589,100,1656,28632,0,0,137386,0,0,0,0,1000,1000,3971,1028,4999,4095,850,4945,4094,41,23,0,0,2,52,962,1080
1,17/11/2022,0101-Washermanpet,108606,130759,372,2104,38270,0,0,149352,0,0,0,0,11500,11500,4100,1350,5450,3748,1140,4888,3795,25,111,0,0,4,72,1248,1460
1,17/11/2022,0103-Mannadi,99590,118062,2200,1240,30752,0,0,133782,0,0,0,0,1500,1500,3333,1074,4407,3764,1052,4816,3693,21,82,1,0,0,42,1019,1165
1,17/11/2022,0105-High Court,146089,245459,1986,2864,63428,0,0,214367,0,0,0,0,0,0,7265,2275,9540,7422,1921,9343,7519,38,234,0,0,2,125,2103,2502
1,17/11/2022,0109-Government Estate,89709,158515,1400,3064,51542,0,0,145715,0,0,0,0,1000,1000,4287,1909,6196,4712,1679,6391,4771,44,130,0,0,2,135,1692,2003
1,17/11/2022,0111-LIC,104746,189648,150,2728,32110,0,0,139734,0,0,0,0,0,0,5550,1207,6757,6373,1006,7379,6338,27,1,0,0,4,112,1064,1208
1,17/11/2022,0113-Thousand Lights,167041,279430,2552,6368,45114,0,0,221075,0,0,0,0,0,0,8647,1786,10433,9291,1612,10903,9453,35,120,0,0,9,254,1433,1851
1,17/11/2022,0115-AG-DMS,122831,156958,1900,3392,30034,0,0,158157,0,0,0,0,0,0,5000,1074,6074,4929,821,5750,5049,19,166,2,0,0,83,945,1215
1,17/11/2022,0117-Teynampet,97584,162215,416,2664,32938,0,0,133602,0,0,0,0,0,0,5085,1260,6345,5465,1050,6515,5435,23,0,1,0,4,96,1116,1240
1,17/11/2022,0119-Nandanam,103122,140345,900,2216,28400,0,0,134638,0,0,0,0,2000,2000,4338,1096,5434,4870,742,5612,4801,24,0,0,0,4,95,942,1065
1,17/11/2022,0121-Saidapet,45725,90098,0,1232,24808,0,0,71765,0,0,0,0,0,0,2228,882,3110,2729,779,3508,2663,18,0,1,0,1,54,812,886
1,17/11/2022,0123-Little Mount,92651,104123,700,2712,24462,0,0,120525,0,0,0,0,1250,1250,3777,951,4728,3076,705,3781,3234,24,198,4,0,1,89,804,1120
1,17/11/2022,0125-Guindy,154866,277927,2390,8376,72768,0,0,238400,0,0,0,0,3000,3000,8439,2639,11078,7840,2323,10163,8193,44,414,4,0,2,245,2256,2965
1,17/11/2022,0129-Nanganallur Road,47736,52183,150,696,12720,0,0,61302,0,0,0,0,0,0,1376,402,1778,1545,331,1876,1501,16,0,2,0,1,26,360,405
1,17/11/2022,0131-Meenambakkam,139128,141606,1200,2000,37812,0,0,180140,0,0,0,0,0,0,4241,1095,5336,3438,841,4279,3577,22,230,1,0,1,68,1007,1329
1,17/11/2022,0133-Chennai International Airport,208440,316638,2600,8280,111426,0,0,330746,0,0,0,0,8250,8250,6709,3195,9904,5672,3778,9450,6527,61,1293,17,0,8,255,2754,4388
2,17/11/2022,0201-Puratchi Thalaivar Dr. M.G. Ramachandran Central,294238,472773,680,11672,143370,0,0,449960,0,0,0,0,5700,5700,13792,5263,19055,12278,7085,19363,13992,109,2479,6,9,12,442,4600,7657
2,17/11/2022,0203-Egmore,79952,131941,0,2360,55452,0,0,137764,0,0,0,0,13000,13000,2616,2001,4617,3186,2546,5732,3174,26,452,4,0,5,109,1851,2447
2,17/11/2022,0205-Nehru Park,45042,49214,500,1336,14876,0,0,61754,0,0,0,0,5000,5000,1576,569,2145,1397,490,1887,1470,26,113,0,0,0,46,508,693
2,17/11/2022,0207-Kilpauk,41268,63012,0,1216,18316,0,0,60800,0,0,0,0,0,0,1715,688,2403,1822,625,2447,1809,17,85,1,0,0,54,600,757
2,17/11/2022,0209-Pachaiyappas College,46125,53596,200,616,13262,0,0,60203,0,0,0,0,4000,4000,1812,549,2361,1731,492,2223,1719,20,79,1,0,0,26,500,626
2,17/11/2022,0211-Shenoy Nagar,47948,55326,113,808,11424,0,0,60293,0,0,0,0,1000,1000,1574,426,2000,1700,471,2171,1762,15,124,0,0,2,31,390,562
2,17/11/2022,0213-Anna Nagar East,90648,127249,790,2728,30538,0,0,124704,0,0,0,0,0,0,3707,1182,4889,3705,956,4661,3825,27,230,0,0,2,101,1035,1395
2,17/11/2022,0215-Anna Nagar Tower,94712,118640,1090,2064,28204,0,0,126070,0,0,0,0,500,500,3371,1037,4408,3411,893,4304,3500,13,214,0,0,2,85,915,1229
2,17/11/2022,0217-Thirumangalam,260148,328961,1620,9568,76434,0,0,347770,0,0,0,0,500,500,9329,2736,12065,9122,2451,11573,9467,53,618,5,0,2,299,2348,3325
2,17/11/2022,0219-Koyambedu,206531,250387,900,4816,67384,0,0,279631,0,0,0,0,14750,14750,6964,2365,9329,6211,2071,8282,6659,50,792,5,0,15,153,2118,3133
2,17/11/2022,0221-Puratchi Thalaivi Dr. J. Jayalalithaa CMBT,73424,162857,520,2664,67448,0,0,144056,0,0,0,0,0,0,1810,2279,4089,3938,3398,7336,3766,27,455,1,0,2,113,2116,2714
2,17/11/2022,0223-Arumbakkam,61911,67768,100,1312,22624,0,0,85947,0,0,0,0,2750,2750,1824,853,2677,1978,625,2603,1848,27,0,3,0,1,48,777,856
2,17/11/2022,0225-Vadapalani,120390,215827,235,5352,68642,0,0,194619,0,0,0,0,4000,4000,5351,2463,7814,5500,2423,7923,5765,33,573,1,0,7,214,2139,2967
2,17/11/2022,0227-Ashok Nagar,109200,152904,910,4088,40616,0,0,154814,0,0,0,0,0,0,4196,1530,5726,4133,1385,5518,4414,33,424,8,0,0,161,1287,1913
2,17/11/2022,0229-Ekkattuthangal,102613,149193,1050,3568,27104,0,0,134335,0,0,0,0,0,0,4556,1039,5595,4578,1008,5586,4910,22,432,1,0,4,146,808,1413
2,17/11/2022,0231-Arignar Anna Alandur,182440,210314,0,5152,57828,0,0,245420,0,0,0,0,5250,5250,6076,1998,8074,5654,1652,7306,5960,44,463,4,0,9,150,1739,2409
2,17/11/2022,0233-St. Thomas Mount,81125,112003,1170,2904,34146,0,0,119345,0,0,0,3000,4200,7200,3132,1192,4324,3146,919,4065,3088,23,27,4,0,1,119,1040,1214
1,18/11/2022,01ED-Wimco Nagar Depot Metro,80555,75703,500,1440,22506,0,0,105001,0,0,0,0,5250,5250,2215,610,2825,1710,351,2061,1694,16,0,3,0,5,43,562,629
1,18/11/2022,01EF-Wimco Nagar Metro,129545,144071,500,3672,33850,0,0,167567,0,0,0,0,750,750,3696,942,4638,3351,857,4208,3452,46,91,7,0,6,102,817,1069
1,18/11/2022,01F1-Thiruvotriyur Metro,119493,102998,0,1544,19494,0,0,140531,0,0,0,0,0,0,3109,572,3681,2825,487,3312,2803,37,0,3,0,5,50,516,611
1,18/11/2022,01F3-Thiruvotriyur Theradi Metro,106394,125252,600,1968,24138,0,0,133100,0,0,0,0,0,0,3293,720,4013,3355,816,4171,3457,19,167,4,0,4,64,645,903
1,18/11/2022,01F5-Kaladipet Metro,99212,106806,0,1568,25862,0,0,126642,0,0,0,0,0,0,3169,792,3961,3085,651,3736,3028,15,0,1,0,3,47,736,802
1,18/11/2022,01F7-Tollgate Metro,60987,56425,0,648,13322,0,0,74957,0,0,0,0,0,0,1724,427,2151,1608,402,2010,1584,14,0,1,0,5,23,380,423
1,18/11/2022,01F9-New Washermenpet Metro,85799,101604,50,1368,22492,0,0,109709,0,0,0,0,0,0,3075,769,3844,3100,693,3793,3140,12,56,3,0,3,44,719,837
1,18/11/2022,01FB-Tondiarpet Metro,103592,110979,670,1344,28620,0,0,134226,0,0,0,0,500,500,3256,945,4201,3301,794,4095,3242,25,3,1,0,8,46,892,975
1,18/11/2022,01FD-Thiagaraya College Metro,106282,124918,1000,1904,28968,0,0,138154,0,0,0,0,2000,2000,3802,1049,4851,3910,829,4739,3880,22,35,6,0,5,68,964,1100
1,18/11/2022,0101-Washermanpet,104406,132216,2200,2352,39298,0,0,148256,0,0,0,0,15500,15500,3996,1388,5384,3686,1135,4821,3779,20,163,0,0,6,90,1290,1569
1,18/11/2022,0103-Mannadi,84847,119622,300,1688,31270,0,0,118105,0,0,0,0,0,0,3372,1107,4479,3680,1129,4809,3698,12,143,0,0,0,68,1016,1239
1,18/11/2022,0105-High Court,131063,253273,1650,2872,65780,0,0,201365,0,0,0,0,0,0,7281,2336,9617,7436,2089,9525,7703,24,406,0,0,2,107,2174,2713
1,18/11/2022,0109-Government Estate,90613,161093,450,2416,50076,0,0,143555,0,0,0,0,4000,4000,4443,1826,6269,4715,1675,6390,4888,24,309,4,0,3,109,1655,2104
1,18/11/2022,0111-LIC,84370,192044,1362,2736,33884,0,0,122352,0,0,0,0,0,0,5550,1226,6776,6344,1050,7394,6359,22,59,1,0,1,111,1073,1267
1,18/11/2022,0113-Thousand Lights,140801,277367,2200,6696,42106,0,0,191803,0,0,0,0,0,0,8691,1690,10381,9128,1564,10692,9441,34,292,0,0,9,270,1308,1913
1,18/11/2022,0115-AG-DMS,91810,142845,0,2040,26160,0,0,120010,0,0,0,0,250,250,4588,938,5526,4488,778,5266,4631,24,200,0,0,0,73,813,1110
1,18/11/2022,0117-Teynampet,95408,159188,1200,3008,33482,0,0,133098,0,0,0,0,1000,1000,4845,1318,6163,5269,1080,6349,5272,21,1,1,0,4,131,1128,1286
1,18/11/2022,0119-Nandanam,107499,139234,3496,3568,30712,0,0,145275,0,0,0,0,3000,3000,4278,1217,5495,4748,828,5576,4670,27,1,3,0,3,138,1023,1195
1,18/11/2022,0121-Saidapet,63057,88108,0,1760,24222,0,0,89039,0,0,0,500,7250,7750,2226,883,3109,2633,789,3422,2580,16,0,0,0,1,72,798,887
1,18/11/2022,0123-Little Mount,97534,107996,890,2920,27584,0,0,128928,0,0,0,0,0,0,3819,1084,4903,3096,716,3812,3276,29,214,0,0,6,114,897,1260
1,18/11/2022,0125-Guindy,140586,288421,2100,8688,84468,0,0,235842,0,0,0,0,3000,3000,8329,3158,11487,7543,2436,9979,8087,33,551,7,0,3,350,2615,3559
1,18/11/2022,0129-Nanganallur Road,47633,49866,550,832,11456,0,0,60471,0,0,0,0,0,0,1378,379,1757,1522,376,1898,1473,15,0,4,0,1,32,338,390
1,18/11/2022,0131-Meenambakkam,113734,138558,1700,2576,36084,0,0,154094,0,0,0,0,0,0,4056,1073,5129,3375,925,4300,3513,24,221,0,0,3,82,975,1305
1,18/11/2022,0133-Chennai International Airport,208799,316301,1090,8672,129180,0,0,347741,0,0,0,0,3000,3000,7267,3667,10934,4501,4023,8524,5811,65,1606,12,0,7,272,3113,5075
2,18/11/2022,0201-Puratchi Thalaivar Dr. M.G. Ramachandran Central,244439,492275,750,12488,176536,0,0,434213,0,0,0,0,4000,4000,12981,6459,19440,12981,7842,20823,13635,99,1752,3,0,19,477,5799,8149
2,18/11/2022,0203-Egmore,87520,145551,500,2816,55980,0,0,146816,0,0,0,0,14750,14750,2860,2060,4920,3519,2906,6425,3656,31,723,5,0,7,118,1895,2779
2,18/11/2022,0205-Nehru Park,33746,54036,14,1376,18866,0,0,54002,0,0,0,0,2000,2000,1508,696,2204,1465,515,1980,1491,8,97,0,0,1,53,620,779
2,18/11/2022,0207-Kilpauk,39864,62844,0,1088,18568,0,0,59520,0,0,0,0,0,0,1644,687,2331,1768,589,2357,1789,14,89,0,0,0,46,620,769
2,18/11/2022,0209-Pachaiyappas College,47312,53846,250,768,14268,0,0,62598,0,0,0,0,10250,10250,1825,579,2404,1676,495,2171,1685,15,86,3,0,0,32,534,670
2,18/11/2022,0211-Shenoy Nagar,45629,52213,500,896,14152,0,0,61177,0,0,0,0,0,0,1476,516,1992,1532,438,1970,1545,10,64,0,0,1,35,463,573
2,18/11/2022,0213-Anna Nagar East,88143,121746,300,2720,29068,0,0,120231,0,0,0,0,0,0,3523,1097,4620,3509,940,4449,3679,20,237,0,0,3,112,969,1341
2,18/11/2022,0215-Anna Nagar Tower,90543,114568,700,1904,28134,0,0,121281,0,0,0,0,500,500,3220,1035,4255,3235,895,4130,3346,19,264,2,0,4,79,919,1287
2,18/11/2022,0217-Thirumangalam,273546,337733,1000,7936,86060,0,0,368542,0,0,0,0,1500,1500,9411,3018,12429,9042,2715,11757,9394,67,703,0,0,5,284,2591,3650
2,18/11/2022,0219-Koyambedu,184558,263106,600,5752,83526,0,0,274436,0,0,0,0,7250,7250,6732,2991,9723,6049,2310,8359,6615,39,877,6,0,12,236,2604,3774
2,18/11/2022,0221-Puratchi Thalaivi Dr. J. Jayalalithaa CMBT,75265,190785,590,2928,71822,0,0,150605,0,0,0,0,0,0,1917,2402,4319,5138,4997,10135,4670,20,625,2,0,2,110,2238,2997
2,18/11/2022,0223-Arumbakkam,64280,65987,200,1400,23816,0,0,89696,0,0,0,0,4750,4750,1820,893,2713,1863,690,2553,1729,31,0,7,0,3,54,820,915
2,18/11/2022,0225-Vadapalani,122638,229062,300,6808,75770,0,0,205516,0,0,0,0,4500,4500,5590,2728,8318,5542,2650,8192,5984,36,791,2,0,3,263,2324,3419
2,18/11/2022,0227-Ashok Nagar,119302,161262,1900,5520,43586,0,0,170308,0,0,0,0,3000,3000,4425,1655,6080,4139,1592,5731,4583,43,560,5,0,2,212,1345,2167
2,18/11/2022,0229-Ekkattuthangal,97585,149134,1850,4656,32582,0,0,136673,0,0,0,0,1000,1000,4364,1264,5628,4225,1037,5262,4649,25,469,0,0,3,196,992,1685
2,18/11/2022,0231-Arignar Anna Alandur,165450,212229,1600,5072,61906,0,0,234028,0,0,0,0,5250,5250,6037,2111,8148,5457,1699,7156,5828,29,578,5,0,4,181,1790,2587
2,18/11/2022,0233-St. Thomas Mount,87993,119379,867,3824,41968,0,0,134652,0,0,0,9400,6250,15650,3124,1495,4619,3034,1049,4083,3029,20,77,1,0,2,144,1287,1531
1,19/11/2022,01ED-Wimco Nagar Depot Metro,66930,78048,0,2240,28642,0,0,97812,0,0,0,0,2500,2500,1888,751,2639,1572,435,2007,1567,19,0,2,0,12,62,681,776
1,19/11/2022,01EF-Wimco Nagar Metro,115952,131004,300,3896,35278,0,0,155426,0,0,0,0,0,0,3115,963,4078,2790,1007,3797,2945,51,216,3,0,6,109,837,1222
1,19/11/2022,01F1-Thiruvotriyur Metro,106486,102097,100,1688,26208,0,0,134482,0,0,0,0,0,0,2868,690,3558,2564,590,3154,2560,34,57,5,0,7,47,653,803
1,19/11/2022,01F3-Thiruvotriyur Theradi Metro,110016,137370,200,2192,46662,0,0,159070,0,0,0,0,0,0,3001,1274,4275,3097,1230,4327,3074,18,97,1,0,9,68,1193,1386
1,19/11/2022,01F5-Kaladipet Metro,96323,95438,0,2056,26226,0,0,124605,0,0,0,0,0,0,2714,829,3543,2608,837,3445,2582,34,8,1,0,3,64,749,859
1,19/11/2022,01F7-Tollgate Metro,49192,59059,0,984,19956,0,0,70132,0,0,0,0,0,0,1532,618,2150,1485,570,2055,1437,24,0,0,0,6,37,543,610
1,19/11/2022,01F9-New Washermenpet Metro,82197,96343,250,1936,27842,0,0,112225,0,0,0,0,1500,1500,2803,932,3735,2649,887,3536,2727,18,111,0,0,3,70,852,1054
1,19/11/2022,01FB-Tondiarpet Metro,93108,115574,700,1920,41876,0,0,137604,0,0,0,0,1000,1000,2870,1288,4158,2986,1079,4065,2897,21,3,1,0,9,60,1218,1312
1,19/11/2022,01FD-Thiagaraya College Metro,91470,122820,0,2592,38000,0,0,132062,0,0,0,0,1000,1000,3319,1351,4670,3494,1110,4604,3490,53,41,0,0,3,108,1217,1422
1,19/11/2022,0101-Washermanpet,100240,132475,150,2560,52822,0,0,155772,0,0,0,0,17500,17500,3320,1778,5098,3147,1632,4779,3218,22,205,2,0,7,89,1674,1999
1,19/11/2022,0103-Mannadi,89903,122095,660,2136,43208,0,0,135907,0,0,0,0,1500,1500,3062,1499,4561,3186,1593,4779,3292,24,253,0,0,3,78,1379,1737
1,19/11/2022,0105-High Court,114737,204395,0,3776,63856,0,0,182369,0,0,0,0,0,0,5426,2230,7656,5064,2232,7296,5618,26,767,6,0,7,150,1999,2955
1,19/11/2022,0109-Government Estate,75371,161128,350,3200,64382,0,0,143303,0,0,0,0,500,500,3713,2357,6070,4121,2149,6270,4253,25,342,2,0,3,143,2074,2589
1,19/11/2022,0111-LIC,72592,154456,0,3104,44620,0,0,120316,0,0,0,0,0,0,3703,1590,5293,4505,1324,5829,4404,17,1,1,0,9,131,1385,1544
1,19/11/2022,0113-Thousand Lights,91646,208090,1360,5504,59554,0,0,158064,0,0,0,0,0,0,5172,2192,7364,6026,1921,7947,5884,22,0,1,0,13,216,1852,2104
1,19/11/2022,0115-AG-DMS,61540,95363,220,2080,26408,0,0,90248,0,0,0,0,250,250,2517,910,3427,2503,716,3219,2661,19,192,2,0,2,89,768,1072
1,19/11/2022,0117-Teynampet,75318,167786,200,3152,67002,0,0,145672,0,0,0,0,0,0,3573,2384,5957,4197,1967,6164,4079,21,0,1,0,4,131,2216,2373
1,19/11/2022,0119-Nandanam,59920,94894,550,2432,33838,0,0,96740,0,0,0,0,1000,1000,2314,1256,3570,2611,983,3594,2550,17,26,1,0,4,97,1117,1262
1,19/11/2022,0121-Saidapet,34097,74868,0,1824,30834,0,0,66755,0,0,0,0,0,0,1422,1051,2473,1802,1014,2816,1711,15,0,1,0,4,65,966,1051
1,19/11/2022,0123-Little Mount,62589,79863,1324,2312,28860,0,0,95085,0,0,0,0,0,0,2283,1050,3333,1866,776,2642,1992,17,247,3,0,3,85,920,1275
1,19/11/2022,0125-Guindy,122798,264557,552,8680,107954,0,0,239984,0,0,0,0,1500,1500,5954,3728,9682,5462,3354,8816,5961,33,782,8,0,12,338,3177,4350
1,19/11/2022,0129-Nanganallur Road,34777,42721,1950,872,14714,0,0,52313,0,0,0,0,0,0,949,474,1423,1089,415,1504,1046,8,0,0,0,3,34,424,469
1,19/11/2022,0131-Meenambakkam,134206,139301,50,3264,48422,0,0,185942,0,0,0,0,0,0,3292,1392,4684,2810,1231,4041,3025,24,355,6,0,8,111,1293,1797
1,19/11/2022,0133-Chennai International Airport,209152,343006,2560,13584,162198,0,0,387494,0,0,0,0,5250,5250,6321,4697,11018,3840,5138,8978,5504,68,2006,35,0,17,416,3812,6354
2,19/11/2022,0201-Puratchi Thalaivar Dr. M.G. Ramachandran Central,209439,521020,1009,15784,246956,0,0,473188,0,0,0,0,3750,3750,10626,8939,19565,10577,8911,19488,11216,102,2228,27,0,30,641,7808,10836
2,19/11/2022,0203-Egmore,71823,139441,200,3816,63264,0,0,139103,0,0,0,0,11500,11500,2408,2294,4702,3034,3000,6034,3094,24,610,9,0,11,157,2060,2871
2,19/11/2022,0205-Nehru Park,48167,56541,0,1672,21722,0,0,71561,0,0,0,0,2000,2000,1432,827,2259,1363,656,2019,1446,16,192,3,0,1,66,732,1010
2,19/11/2022,0207-Kilpauk,32406,55586,51,1304,20520,0,0,54281,0,0,0,0,0,0,1367,753,2120,1365,752,2117,1409,10,125,0,0,2,61,679,877
2,19/11/2022,0209-Pachaiyappas College,40621,53700,0,936,16124,0,0,57681,0,0,0,0,2000,2000,1690,650,2340,1438,581,2019,1575,12,205,1,0,2,42,599,861
2,19/11/2022,0211-Shenoy Nagar,34692,48774,0,848,14688,0,0,50228,0,0,0,0,2000,2000,1274,537,1811,1374,511,1885,1389,10,90,0,0,4,37,486,627
2,19/11/2022,0213-Anna Nagar East,86049,121249,400,4032,40144,0,0,130625,0,0,0,0,0,0,3057,1494,4551,3033,1338,4371,3172,21,338,4,0,1,145,1296,1805
2,19/11/2022,0215-Anna Nagar Tower,83899,113874,1260,2832,31748,0,0,119739,0,0,0,0,1000,1000,2990,1200,4190,2772,1292,4064,3120,17,547,3,0,4,116,1029,1716
2,19/11/2022,0217-Thirumangalam,247563,334825,5637,13744,120680,0,0,387624,0,0,0,0,0,0,7666,4270,11936,7447,3889,11336,7952,75,972,11,0,6,500,3600,5164
2,19/11/2022,0219-Koyambedu,170612,235975,600,5792,86466,0,0,263470,0,0,0,0,7750,7750,5649,3013,8662,4359,2853,7212,5475,46,1546,7,0,12,240,2572,4423
2,19/11/2022,0221-Puratchi Thalaivi Dr. J. Jayalalithaa CMBT,68798,194650,300,3912,88060,0,0,161070,0,0,0,0,0,0,1843,2993,4836,4399,4883,9282,4168,22,769,8,0,2,175,2763,3739
2,19/11/2022,0223-Arumbakkam,46957,66180,350,1336,31968,0,0,80611,0,0,0,0,2000,2000,1464,1158,2622,1562,875,2437,1403,42,0,1,0,5,60,1075,1183
2,19/11/2022,0225-Vadapalani,128800,270446,900,10568,109196,0,0,249464,0,0,0,0,4000,4000,5485,4100,9585,5536,4039,9575,6140,40,1246,4,0,21,437,3360,5108
2,19/11/2022,0227-Ashok Nagar,104705,154037,1800,5576,47420,0,0,159501,0,0,0,0,1500,1500,3944,1775,5719,3492,2012,5504,4111,34,829,5,0,3,227,1453,2551
2,19/11/2022,0229-Ekkattuthangal,70268,90916,50,3200,27928,0,0,101446,0,0,0,0,0,0,2421,1072,3493,2251,1040,3291,2530,25,419,0,0,1,133,872,1450
2,19/11/2022,0231-Arignar Anna Alandur,150129,203235,830,6360,82220,0,0,239539,0,0,0,0,2500,2500,4613,2759,7372,4130,2440,6570,4524,51,736,14,0,8,223,2392,3424
2,19/11/2022,0233-St. Thomas Mount,62695,120801,1400,4088,59608,0,0,127791,0,0,0,6000,4650,10650,2423,2001,4424,2589,1464,4053,2365,31,41,2,0,5,144,1789,2012
1,20/11/2022,01ED-Wimco Nagar Depot Metro,40321,59947,0,1416,29598,0,0,71335,0,0,0,0,0,0,952,746,1698,938,491,1429,924,14,0,3,0,11,39,690,757
1,20/11/2022,01EF-Wimco Nagar Metro,57426,77270,0,4016,31744,0,0,93186,0,0,0,0,250,250,1307,830,2137,1294,962,2256,1341,56,85,2,0,16,78,734,971
1,20/11/2022,01F1-Thiruvotriyur Metro,61511,72237,0,2040,29008,0,0,92559,0,0,0,0,0,0,1306,776,2082,1413,672,2085,1381,49,0,0,0,13,59,729,850
1,20/11/2022,01F3-Thiruvotriyur Theradi Metro,56071,110828,500,1992,53360,0,0,111923,0,0,0,0,0,0,1597,1407,3004,1914,1478,3392,1862,19,31,1,0,21,64,1324,1460
1,20/11/2022,01F5-Kaladipet Metro,50762,67534,0,2480,30664,0,0,83906,0,0,0,0,0,0,1154,934,2088,1302,811,2113,1296,12,0,0,0,2,79,832,925
1,20/11/2022,01F7-Tollgate Metro,25269,40543,0,1096,18712,0,0,45077,0,0,0,0,0,0,721,568,1289,795,468,1263,784,21,0,1,0,13,33,513,581
1,20/11/2022,01F9-New Washermenpet Metro,41933,66541,50,952,30252,0,0,73187,0,0,0,0,0,0,1324,931,2255,1375,870,2245,1362,11,94,0,0,8,36,880,1029
1,20/11/2022,01FB-Tondiarpet Metro,50236,72242,58,960,36484,0,0,87738,0,0,0,0,1500,1500,1286,1085,2371,1418,1099,2517,1332,14,0,4,0,13,35,1038,1104
1,20/11/2022,01FD-Thiagaraya College Metro,63228,88826,0,1928,43504,0,0,108660,0,0,0,0,3000,3000,1684,1345,3029,1728,1148,2876,1733,45,57,0,0,4,72,1260,1438
1,20/11/2022,0101-Washermanpet,59436,90798,500,2000,49700,0,0,111636,0,0,0,0,12000,12000,1514,1614,3128,1471,1469,2940,1555,17,158,3,0,15,77,1523,1793
1,20/11/2022,0103-Mannadi,33864,69039,1000,2528,34486,0,0,71878,0,0,0,0,0,0,1123,1211,2334,1240,1374,2614,1354,7,190,1,0,5,89,1074,1366
1,20/11/2022,0105-High Court,32893,78704,200,2056,40736,0,0,75885,0,0,0,0,0,0,1410,1430,2840,1426,1178,2604,1521,6,226,5,0,13,77,1318,1645
1,20/11/2022,0109-Government Estate,44243,93857,0,2336,46032,0,0,92611,0,0,0,0,1000,1000,1750,1643,3393,1675,1616,3291,1934,18,409,1,0,6,94,1484,2012
1,20/11/2022,0111-LIC,22107,74139,500,2536,41844,0,0,66987,0,0,0,0,2000,2000,1064,1457,2521,1335,1086,2421,1254,11,0,0,0,6,96,1299,1412
1,20/11/2022,0113-Thousand Lights,36626,90173,200,3848,43380,0,0,84054,0,0,0,0,0,0,1466,1531,2997,1966,1603,3569,1823,15,0,2,0,27,146,1317,1507
1,20/11/2022,0115-AG-DMS,22473,40504,0,816,16604,0,0,39893,0,0,0,0,0,0,811,532,1343,813,519,1332,877,7,158,4,0,3,26,487,685
1,20/11/2022,0117-Teynampet,20627,48787,0,1048,26012,0,0,47687,0,0,0,0,0,0,754,916,1670,993,859,1852,919,10,26,0,0,4,43,857,940
1,20/11/2022,0119-Nandanam,18616,47553,450,2272,26168,0,0,47506,0,0,0,0,0,0,749,1015,1764,877,813,1690,849,16,0,2,0,6,86,895,1005
1,20/11/2022,0121-Saidapet,22028,46487,0,1008,24758,0,0,47794,0,0,0,0,4000,4000,647,836,1483,872,830,1702,793,8,1,0,0,6,41,783,839
1,20/11/2022,0123-Little Mount,36586,57518,250,1088,27044,0,0,64968,0,0,0,0,0,0,1226,930,2156,950,809,1759,1150,17,286,4,0,4,45,829,1185
1,20/11/2022,0125-Guindy,60093,183432,700,6672,106342,0,0,173807,0,0,0,0,0,0,2555,3476,6031,2494,3155,5649,2738,24,575,16,0,15,242,3076,3948
1,20/11/2022,0129-Nanganallur Road,12979,25579,0,960,13268,0,0,27207,0,0,0,0,0,0,347,413,760,472,393,865,419,7,0,3,0,3,34,371,418
1,20/11/2022,0131-Meenambakkam,50719,91005,300,2504,48478,0,0,102001,0,0,0,0,0,0,1384,1323,2707,1175,1143,2318,1341,21,248,0,0,13,75,1259,1616
1,20/11/2022,0133-Chennai International Airport,119066,311835,900,12192,189184,0,0,321342,0,0,0,0,3750,3750,3750,5264,9014,2818,4946,7764,3698,62,1276,7,0,30,351,4570,6296
2,20/11/2022,0201-Puratchi Thalaivar Dr. M.G. Ramachandran Central,145748,401419,530,14040,236800,0,0,397118,0,0,0,0,1650,1650,5674,8268,13942,5158,8029,13187,6120,86,1857,18,0,40,539,7448,9988
2,20/11/2022,0203-Egmore,60263,119058,100,4104,68254,0,0,132721,0,0,0,0,9000,9000,1710,2476,4186,1681,3031,4712,1976,26,616,7,0,10,168,2258,3085
2,20/11/2022,0205-Nehru Park,19080,35655,0,968,17826,0,0,37874,0,0,0,0,0,0,721,685,1406,644,589,1233,719,10,123,3,0,3,39,640,818
2,20/11/2022,0207-Kilpauk,12140,28503,20,960,14830,0,0,27950,0,0,0,0,0,0,513,531,1044,489,534,1023,534,5,87,0,0,4,37,481,614
2,20/11/2022,0209-Pachaiyappas College,25595,28087,0,616,12132,0,0,38343,0,0,0,0,6000,6000,630,439,1069,580,412,992,617,6,86,1,0,7,25,399,524
2,20/11/2022,0211-Shenoy Nagar,22677,27896,0,400,14256,0,0,37333,0,0,0,0,2000,2000,522,473,995,509,446,955,541,9,86,3,0,1,16,447,562
2,20/11/2022,0213-Anna Nagar East,37099,67248,0,2352,29234,0,0,68685,0,0,0,0,0,0,1453,1075,2528,1406,1018,2424,1515,11,227,6,0,4,91,951,1290
2,20/11/2022,0215-Anna Nagar Tower,38861,70599,500,2056,30062,0,0,71479,0,0,0,0,0,0,1393,1070,2463,1364,1083,2447,1513,12,280,0,1,3,75,948,1319
2,20/11/2022,0217-Thirumangalam,118734,217643,700,7904,107616,0,0,234954,0,0,0,0,0,0,3581,3630,7211,3802,3542,7344,3999,52,718,4,0,20,279,3186,4259
2,20/11/2022,0219-Koyambedu,78675,154145,100,4688,83206,0,0,166669,0,0,0,250,500,750,2629,2878,5507,2132,2563,4695,2606,34,738,5,0,20,193,2597,3587
2,20/11/2022,0221-Puratchi Thalaivi Dr. J. Jayalalithaa CMBT,54595,157412,100,3368,87946,0,0,146009,0,0,0,0,0,0,1565,2897,4462,2166,4420,6586,2548,19,919,5,0,20,147,2668,3778
2,20/11/2022,0223-Arumbakkam,26764,46700,235,1848,28222,0,0,57069,0,0,0,0,6000,6000,684,1010,1694,815,765,1580,743,14,1,2,0,7,45,935,1004
2,20/11/2022,0225-Vadapalani,81020,229532,850,10656,118506,0,0,211032,0,0,0,0,0,0,3649,4314,7963,3601,4257,7858,4149,35,972,9,0,26,380,3661,5083
2,20/11/2022,0227-Ashok Nagar,52709,99507,795,3616,51672,0,0,108792,0,0,0,0,1500,1500,1615,1787,3402,1696,1753,3449,1843,33,346,7,0,6,139,1584,2115
2,20/11/2022,0229-Ekkattuthangal,33875,55442,0,1600,25844,0,0,61319,0,0,0,0,1000,1000,1079,922,2001,1077,923,2000,1194,16,251,6,0,7,70,811,1161
2,20/11/2022,0231-Arignar Anna Alandur,64418,133600,150,5832,69070,0,0,139470,0,0,0,0,750,750,2234,2334,4568,2095,2169,4264,2357,29,469,7,0,4,194,1994,2697
2,20/11/2022,0233-St. Thomas Mount,33316,89191,405,4840,56588,0,0,95149,0,0,0,0,0,0,1072,1866,2938,1378,1313,2691,1234,15,40,1,0,7,142,1660,1865
1,21/11/2022,01ED-Wimco Nagar Depot Metro,99895,87341,0,992,24182,0,0,125069,0,0,0,0,5000,5000,2192,623,2815,1963,409,2372,1956,22,57,2,0,8,30,589,708
1,21/11/2022,01EF-Wimco Nagar Metro,146425,138647,400,2760,29388,0,0,178973,0,0,0,0,2250,2250,3861,794,4655,3200,854,4054,3377,64,215,0,0,3,85,708,1075
1,21/11/2022,01F1-Thiruvotriyur Metro,137210,107200,0,1008,20214,0,0,158432,0,0,0,0,0,0,3055,575,3630,2965,577,3542,2900,27,11,2,0,5,36,534,615
1,21/11/2022,01F3-Thiruvotriyur Theradi Metro,109976,110948,300,1760,25902,0,0,137938,0,0,0,0,0,0,2946,752,3698,2801,840,3641,2889,17,142,1,0,4,53,678,895
1,21/11/2022,01F5-Kaladipet Metro,133150,104434,0,2424,20438,0,0,156012,0,0,0,0,0,0,3215,624,3839,3072,613,3685,3105,32,86,1,1,3,40,583,746
1,21/11/2022,01F7-Tollgate Metro,77177,58983,940,768,12004,0,0,90889,0,0,0,0,0,0,1756,392,2148,1706,349,2055,1699,31,43,0,0,7,20,351,452
1,21/11/2022,01F9-New Washermenpet Metro,125169,94428,0,896,15766,0,0,141831,0,0,0,0,2250,2250,3071,544,3615,3054,623,3677,3101,17,136,1,0,2,32,511,699
1,21/11/2022,01FB-Tondiarpet Metro,120093,105956,2130,1680,25480,0,0,149383,0,0,0,0,1750,1750,3147,848,3995,3121,813,3934,3140,18,68,1,0,0,53,787,927
1,21/11/2022,01FD-Thiagaraya College Metro,130526,121022,250,1760,24528,0,0,157064,0,0,0,0,4250,4250,3882,892,4774,3928,900,4828,3920,48,66,0,0,4,62,817,997
1,21/11/2022,0101-Washermanpet,137100,132885,500,1912,35488,0,0,175000,0,0,0,0,10250,10250,4197,1230,5427,3747,1154,4901,3917,40,279,1,0,4,75,1139,1538
1,21/11/2022,0103-Mannadi,100674,114686,0,1192,28842,0,0,130708,0,0,0,0,0,0,3269,1023,4292,3687,1089,4776,3610,22,133,2,0,2,47,959,1165
1,21/11/2022,0105-High Court,156182,246899,800,1816,64400,0,0,223198,0,0,0,0,0,0,7156,2250,9406,7656,1792,9448,7526,34,291,0,0,3,84,2122,2534
1,21/11/2022,0109-Government Estate,108037,161010,565,2176,47720,0,0,158498,0,0,0,0,3500,3500,4420,1731,6151,4973,1595,6568,5014,32,270,4,0,0,95,1574,1975
1,21/11/2022,0111-LIC,111396,189587,2350,2496,33656,0,0,149898,0,0,0,0,250,250,5467,1231,6698,6455,957,7412,6265,23,8,2,0,1,106,1072,1212
1,21/11/2022,0113-Thousand Lights,176075,280575,6100,6400,47942,0,0,236517,0,0,0,0,0,0,8244,1869,10113,9610,1493,11103,9375,35,21,0,0,3,244,1539,1842
1,21/11/2022,0115-AG-DMS,149019,155752,630,2112,26692,0,0,178453,0,0,0,0,250,250,4948,972,5920,5090,822,5912,5106,32,186,3,0,2,86,842,1151
1,21/11/2022,0117-Teynampet,126390,156559,950,2056,29078,0,0,158474,0,0,0,0,5500,5500,4885,1144,6029,5553,1116,6669,5368,24,34,1,0,1,85,994,1139
1,21/11/2022,0119-Nandanam,101546,139756,1400,2040,30044,0,0,135030,0,0,0,0,0,0,4102,1142,5244,4858,949,5807,4741,35,21,2,0,2,92,1002,1154
1,21/11/2022,0121-Saidapet,69651,92379,400,1264,21716,0,0,93031,0,0,0,0,250,250,2212,753,2965,2873,828,3701,2839,11,65,0,0,1,51,679,807
1,21/11/2022,0123-Little Mount,113790,102272,1700,1976,22472,0,0,139938,0,0,0,0,1250,1250,3719,852,4571,3158,619,3777,3226,27,223,0,0,0,82,735,1067
1,21/11/2022,0125-Guindy,175533,276702,4742,7312,72818,0,0,260405,0,0,0,0,0,0,8489,2628,11117,7797,2578,10375,8159,45,558,5,0,1,267,2269,3145
1,21/11/2022,0129-Nanganallur Road,61583,49258,1250,784,12068,0,0,75685,0,0,0,0,0,0,1336,386,1722,1501,271,1772,1432,12,1,1,0,0,27,346,387
1,21/11/2022,0131-Meenambakkam,143488,136471,86,2040,31208,0,0,176822,0,0,0,0,0,0,4204,900,5104,3420,886,4306,3587,34,282,2,0,1,65,843,1227
1,21/11/2022,0133-Chennai International Airport,219888,322961,1448,7936,127782,0,0,357054,0,0,0,0,6750,6750,6956,3578,10534,5072,3777,8849,6132,65,1450,19,0,11,249,3117,4911
2,21/11/2022,0201-Puratchi Thalaivar Dr. M.G. Ramachandran Central,313960,507990,200,14544,195436,0,0,524140,0,0,0,0,6400,6400,14245,7041,21286,11955,7099,19054,13386,142,2150,16,1,9,603,6187,9108
2,21/11/2022,0203-Egmore,88137,140731,1100,3704,57602,0,0,150543,0,0,0,0,8350,8350,3369,2127,5496,3006,2627,5633,3385,24,782,3,0,9,154,1925,2897
2,21/11/2022,0205-Nehru Park,46305,49178,100,952,13592,0,0,60949,0,0,0,0,2000,2000,1481,516,1997,1479,441,1920,1507,21,117,0,0,1,39,476,654
2,21/11/2022,0207-Kilpauk,44910,62656,600,1152,18518,0,0,65180,0,0,0,0,0,0,1650,684,2334,1788,584,2372,1788,15,110,0,0,0,53,605,783
2,21/11/2022,0209-Pachaiyappas College,54730,53854,0,600,13298,0,0,68628,0,0,0,0,6000,6000,1830,521,2351,1755,466,2221,1713,14,103,1,0,0,24,485,627
2,21/11/2022,0211-Shenoy Nagar,54091,52783,0,480,11648,0,0,66219,0,0,0,0,0,0,1493,422,1915,1687,416,2103,1682,9,99,0,0,1,20,390,519
2,21/11/2022,0213-Anna Nagar East,105519,122346,200,2728,28506,0,0,136953,0,0,0,0,0,0,3509,1058,4567,3682,1106,4788,3709,24,225,1,0,3,95,937,1285
2,21/11/2022,0215-Anna Nagar Tower,103967,110284,800,1680,21622,0,0,128069,0,0,0,0,1250,1250,3231,798,4029,3293,871,4164,3408,24,280,0,0,4,65,708,1081
2,21/11/2022,0217-Thirumangalam,318673,334362,3800,8128,71918,0,0,402519,0,0,0,0,0,0,8836,2483,11319,9413,2624,12037,9803,60,842,5,0,3,213,2186,3309
2,21/11/2022,0219-Koyambedu,245927,264066,890,4768,77958,0,0,329543,0,0,0,0,16250,16250,7166,2637,9803,6030,2241,8271,6731,48,970,5,0,13,187,2401,3624
2,21/11/2022,0221-Puratchi Thalaivi Dr. J. Jayalalithaa CMBT,98221,193054,400,5056,81846,0,0,185523,0,0,0,0,0,0,2423,2810,5233,3673,3145,6818,4226,33,1019,3,0,8,207,2556,3826
2,21/11/2022,0223-Arumbakkam,64819,71229,0,1944,26596,0,0,93359,0,0,0,0,250,250,1750,928,2678,1923,714,2637,1845,28,49,1,0,2,46,868,994
2,21/11/2022,0225-Vadapalani,148339,212260,750,4160,66056,0,0,219305,0,0,0,0,5000,5000,5277,2322,7599,5579,2497,8076,5670,60,592,1,0,8,167,2065,2893
2,21/11/2022,0227-Ashok Nagar,104316,158491,850,4480,43680,0,0,153326,0,0,0,0,1000,1000,4153,1585,5738,4241,1571,5812,4462,31,428,0,0,4,154,1352,1969
2,21/11/2022,0229-Ekkattuthangal,116523,146022,2450,2272,26018,0,0,147263,0,0,0,0,500,500,4168,950,5118,4635,1106,5741,4733,29,396,3,0,4,96,801,1329
2,21/11/2022,0231-Arignar Anna Alandur,176440,207286,211,4192,59684,0,0,240527,0,0,0,0,5000,5000,5900,2024,7924,5578,1635,7213,5764,49,442,1,0,2,144,1796,2434
2,21/11/2022,0233-St. Thomas Mount,111139,112853,2300,2528,30512,0,0,146479,0,0,0,0,9450,9450,3231,1054,4285,3149,928,4077,3216,30,207,4,0,1,94,928,1264
1,22/11/2022,01ED-Wimco Nagar Depot Metro,80217,78733,200,1400,20358,0,0,102175,0,0,0,0,1250,1250,2137,546,2683,1819,357,2176,1847,15,11,4,0,4,43,491,568
1,22/11/2022,01EF-Wimco Nagar Metro,123041,119171,100,2696,21694,0,0,147531,0,0,0,0,2250,2250,3485,644,4129,2997,725,3722,3065,44,37,4,0,5,78,540,708
1,22/11/2022,01F1-Thiruvotriyur Metro,116922,98076,0,1776,16118,0,0,134816,0,0,0,0,0,0,2920,483,3403,2709,392,3101,2738,30,0,1,0,1,57,424,513
1,22/11/2022,01F3-Thiruvotriyur Theradi Metro,93193,113455,30,1784,24136,0,0,119143,0,0,0,0,0,0,2917,707,3624,3049,657,3706,3078,12,33,2,0,2,43,653,745
1,22/11/2022,01F5-Kaladipet Metro,119647,96852,0,1280,17670,0,0,138597,0,0,0,0,0,0,3045,556,3601,2947,527,3474,2953,16,0,2,0,4,42,510,574
1,22/11/2022,01F7-Tollgate Metro,60782,54333,44,744,9920,0,0,71490,0,0,0,0,0,0,1663,340,2003,1624,307,1931,1614,17,0,0,0,3,22,302,344
1,22/11/2022,01F9-New Washermenpet Metro,96348,94516,100,1336,18854,0,0,116638,0,0,0,0,250,250,3030,667,3697,2955,624,3579,3009,13,64,5,0,2,49,618,751
1,22/11/2022,01FB-Tondiarpet Metro,92837,99202,35,1544,22176,0,0,116592,0,0,0,0,2750,2750,3045,749,3794,3017,759,3776,3012,30,0,1,0,5,53,691,780
1,22/11/2022,01FD-Thiagaraya College Metro,124607,116709,1000,1664,23326,0,0,150597,0,0,0,0,1250,1250,3772,845,4617,3813,828,4641,3824,69,4,0,0,4,60,770,907
1,22/11/2022,0101-Washermanpet,97214,124212,1020,2528,34574,0,0,135336,0,0,0,0,10500,10500,3844,1215,5059,3552,1129,4681,3646,12,74,1,0,3,90,1115,1295
1,22/11/2022,0103-Mannadi,94280,113652,400,1776,27744,0,0,124200,0,0,0,0,0,0,3215,1013,4228,3502,1103,4605,3582,20,100,0,0,0,62,937,1119
1,22/11/2022,0105-High Court,157023,246647,1660,2592,63708,0,0,224983,0,0,0,0,0,0,7296,2262,9558,7405,2007,9412,7560,32,191,0,0,4,114,2104,2445
1,22/11/2022,0109-Government Estate,95136,159172,1800,2664,48588,0,0,148188,0,0,0,0,1250,1250,4274,1795,6069,4721,1663,6384,4898,28,175,2,0,3,119,1588,1915
1,22/11/2022,0111-LIC,96076,179761,4200,2440,28644,0,0,131360,0,0,0,0,2000,2000,5299,1047,6346,6063,928,6991,6084,26,0,0,0,3,99,903,1031
1,22/11/2022,0113-Thousand Lights,166787,271098,2870,6056,42109,0,0,217822,0,0,0,0,0,0,8289,1664,9953,9143,1574,10717,9231,33,0,1,0,0,244,1311,1589
1,22/11/2022,0115-AG-DMS,115567,151047,824,2080,25714,0,0,144185,0,0,0,0,0,0,4863,941,5804,4842,847,5689,4994,23,125,2,0,2,87,805,1044
1,22/11/2022,0117-Teynampet,111428,156004,1800,2008,30684,0,0,145920,0,0,0,0,0,0,4802,1189,5991,5287,1066,6353,5255,26,0,1,0,8,89,1041,1165
1,22/11/2022,0119-Nandanam,102143,135519,533,2624,25350,0,0,130650,0,0,0,0,2000,2000,4211,1032,5243,4731,957,5688,4761,18,4,1,0,3,114,861,1001
1,22/11/2022,0121-Saidapet,57439,87616,500,1592,21530,0,0,81061,0,0,0,0,2000,2000,2117,802,2919,2662,770,3432,2674,8,0,0,0,2,65,723,798
1,22/11/2022,0123-Little Mount,86614,99620,605,2312,20682,0,0,110213,0,0,0,0,0,0,3727,835,4562,3089,667,3756,3241,27,152,0,0,2,97,683,961
1,22/11/2022,0125-Guindy,138467,258843,1093,6840,63896,0,0,210296,0,0,0,0,0,0,8252,2407,10659,7489,2191,9680,7855,45,328,3,0,0,256,2029,2661
1,22/11/2022,0129-Nanganallur Road,61450,48398,1200,816,11510,0,0,74976,0,0,0,0,0,0,1369,376,1745,1444,325,1769,1421,16,0,1,0,0,20,340,377
1,22/11/2022,0131-Meenambakkam,132606,127325,1100,2632,30042,0,0,166380,0,0,0,0,0,0,3884,887,4771,3253,769,4022,3359,27,103,2,0,3,76,810,1021
1,22/11/2022,0133-Chennai International Airport,180875,305786,600,7728,139304,0,0,328507,0,0,0,0,4500,4500,6149,3910,10059,4954,3992,8946,5435,64,702,12,0,21,245,3498,4542
2,22/11/2022,0201-Puratchi Thalaivar Dr. M.G. Ramachandran Central,244699,446844,1630,10792,172534,0,0,429655,0,0,0,0,8400,8400,12329,6268,18597,11340,6652,17992,12062,94,1065,5,0,21,458,5615,7258
2,22/11/2022,0203-Egmore,91617,128168,800,2784,53788,0,0,148989,0,0,0,0,17500,17500,2808,1943,4751,2672,2315,4987,3034,24,571,10,0,10,119,1773,2507
2,22/11/2022,0205-Nehru Park,36017,49228,100,1256,15234,0,0,52607,0,0,0,0,4000,4000,1477,576,2053,1370,480,1850,1455,18,106,0,0,2,53,507,686
2,22/11/2022,0207-Kilpauk,39660,58229,100,1304,15422,0,0,56486,0,0,0,0,0,0,1603,609,2212,1672,598,2270,1739,14,82,2,0,0,59,527,684
2,22/11/2022,0209-Pachaiyappas College,49317,52016,100,728,13558,0,0,63703,0,0,0,0,10000,10000,1792,542,2334,1604,522,2126,1631,14,58,1,0,0,33,493,599
2,22/11/2022,0211-Shenoy Nagar,44543,52151,222,544,11124,0,0,56433,0,0,0,0,1000,1000,1499,420,1919,1635,466,2101,1677,12,70,0,0,3,22,385,492
2,22/11/2022,0213-Anna Nagar East,78804,116028,1100,2504,24882,0,0,107290,0,0,0,0,1500,1500,3512,979,4491,3524,947,4471,3649,23,168,0,0,2,109,842,1144
2,22/11/2022,0215-Anna Nagar Tower,99702,107069,2200,1600,23780,0,0,127282,0,0,0,0,0,0,3067,871,3938,3159,854,4013,3242,12,177,0,0,1,69,780,1039
2,22/11/2022,0217-Thirumangalam,267676,321858,1530,6688,75712,0,0,351606,0,0,0,0,0,0,8439,2671,11110,9083,2653,11736,9345,48,467,3,1,4,251,2321,3095
2,22/11/2022,0219-Koyambedu,200040,232523,300,3896,67802,0,0,272038,0,0,0,0,7500,7500,6385,2379,8764,5768,2109,7877,6070,42,471,4,0,13,157,2153,2840
2,22/11/2022,0221-Puratchi Thalaivi Dr. J. Jayalalithaa CMBT,68132,164203,620,2472,72900,0,0,144124,0,0,0,0,0,0,2739,2456,5195,3447,3267,6714,3624,26,467,6,0,7,113,2297,2916
2,22/11/2022,0223-Arumbakkam,69648,64712,255,1632,19854,0,0,91389,0,0,0,0,10750,10750,1803,755,2558,1878,640,2518,1846,20,1,0,0,5,65,672,763
2,22/11/2022,0225-Vadapalani,131059,216996,669,5480,69558,0,0,206766,0,0,0,0,2000,2000,5371,2500,7871,5462,2464,7926,5779,44,488,0,0,8,214,2210,2964
2,22/11/2022,0227-Ashok Nagar,104107,149496,1521,3560,46076,0,0,155264,0,0,0,0,1500,1500,3998,1619,5617,3960,1303,5263,4101,25,222,5,0,5,140,1395,1792
2,22/11/2022,0229-Ekkattuthangal,99671,145446,1100,3072,29214,0,0,133057,0,0,0,0,1000,1000,4277,1109,5386,4480,1065,5545,4679,24,256,0,0,8,134,917,1339
2,22/11/2022,0231-Arignar Anna Alandur,162644,194922,1000,3560,51174,0,0,218378,0,0,0,0,3250,3250,5767,1770,7537,5428,1548,6976,5665,44,309,1,0,1,142,1540,2037
2,22/11/2022,0233-St. Thomas Mount,89202,105824,1100,3384,28994,0,0,122680,0,0,0,6000,1825,7825,3030,1033,4063,3056,860,3916,3047,27,28,1,0,0,108,898,1062
1,22/11/2022,01ED-Wimco Nagar Depot Metro,80217,78733,200,1400,20358,0,0,102175,0,0,0,0,1250,1250,2137,546,2683,1819,357,2176,1847,15,11,4,0,4,43,491,568
1,22/11/2022,01EF-Wimco Nagar Metro,123041,119171,100,2696,21694,0,0,147531,0,0,0,0,2250,2250,3485,644,4129,2997,725,3722,3065,44,37,4,0,5,78,540,708
1,22/11/2022,01F1-Thiruvotriyur Metro,116922,98076,0,1776,16118,0,0,134816,0,0,0,0,0,0,2920,483,3403,2709,392,3101,2738,30,0,1,0,1,57,424,513
1,22/11/2022,01F3-Thiruvotriyur Theradi Metro,93193,113455,30,1784,24136,0,0,119143,0,0,0,0,0,0,2917,707,3624,3049,657,3706,3078,12,33,2,0,2,43,653,745
1,22/11/2022,01F5-Kaladipet Metro,119647,96852,0,1280,17670,0,0,138597,0,0,0,0,0,0,3045,556,3601,2947,527,3474,2953,16,0,2,0,4,42,510,574
1,22/11/2022,01F7-Tollgate Metro,60782,54333,44,744,9920,0,0,71490,0,0,0,0,0,0,1663,340,2003,1624,307,1931,1614,17,0,0,0,3,22,302,344
1,22/11/2022,01F9-New Washermenpet Metro,96348,94516,100,1336,18854,0,0,116638,0,0,0,0,250,250,3030,667,3697,2955,624,3579,3009,13,64,5,0,2,49,618,751
1,22/11/2022,01FB-Tondiarpet Metro,92837,99202,35,1544,22176,0,0,116592,0,0,0,0,2750,2750,3045,749,3794,3017,759,3776,3012,30,0,1,0,5,53,691,780
1,22/11/2022,01FD-Thiagaraya College Metro,124607,116709,1000,1664,23326,0,0,150597,0,0,0,0,1250,1250,3772,845,4617,3813,828,4641,3824,69,4,0,0,4,60,770,907
1,22/11/2022,0101-Washermanpet,97214,124212,1020,2528,34574,0,0,135336,0,0,0,0,10500,10500,3844,1215,5059,3552,1129,4681,3646,12,74,1,0,3,90,1115,1295
1,22/11/2022,0103-Mannadi,94280,113652,400,1776,27744,0,0,124200,0,0,0,0,0,0,3215,1013,4228,3502,1103,4605,3582,20,100,0,0,0,62,937,1119
1,22/11/2022,0105-High Court,157023,246647,1660,2592,63708,0,0,224983,0,0,0,0,0,0,7296,2262,9558,7405,2007,9412,7560,32,191,0,0,4,114,2104,2445
1,22/11/2022,0109-Government Estate,95136,159172,1800,2664,48588,0,0,148188,0,0,0,0,1250,1250,4274,1795,6069,4721,1663,6384,4898,28,175,2,0,3,119,1588,1915
1,22/11/2022,0111-LIC,96076,179761,4200,2440,28644,0,0,131360,0,0,0,0,2000,2000,5299,1047,6346,6063,928,6991,6084,26,0,0,0,3,99,903,1031
1,22/11/2022,0113-Thousand Lights,166787,271098,2870,6056,42109,0,0,217822,0,0,0,0,0,0,8289,1664,9953,9143,1574,10717,9231,33,0,1,0,0,244,1311,1589
1,22/11/2022,0115-AG-DMS,115567,151047,824,2080,25714,0,0,144185,0,0,0,0,0,0,4863,941,5804,4842,847,5689,4994,23,125,2,0,2,87,805,1044
1,22/11/2022,0117-Teynampet,111428,156004,1800,2008,30684,0,0,145920,0,0,0,0,0,0,4802,1189,5991,5287,1066,6353,5255,26,0,1,0,8,89,1041,1165
1,22/11/2022,0119-Nandanam,102143,135519,533,2624,25350,0,0,130650,0,0,0,0,2000,2000,4211,1032,5243,4731,957,5688,4761,18,4,1,0,3,114,861,1001
1,22/11/2022,0121-Saidapet,57439,87616,500,1592,21530,0,0,81061,0,0,0,0,2000,2000,2117,802,2919,2662,770,3432,2674,8,0,0,0,2,65,723,798
1,22/11/2022,0123-Little Mount,86614,99620,605,2312,20682,0,0,110213,0,0,0,0,0,0,3727,835,4562,3089,667,3756,3241,27,152,0,0,2,97,683,961
1,22/11/2022,0125-Guindy,138467,258843,1093,6840,63896,0,0,210296,0,0,0,0,0,0,8252,2407,10659,7489,2191,9680,7855,45,328,3,0,0,256,2029,2661
1,22/11/2022,0129-Nanganallur Road,61450,48398,1200,816,11510,0,0,74976,0,0,0,0,0,0,1369,376,1745,1444,325,1769,1421,16,0,1,0,0,20,340,377
1,22/11/2022,0131-Meenambakkam,132606,127325,1100,2632,30042,0,0,166380,0,0,0,0,0,0,3884,887,4771,3253,769,4022,3359,27,103,2,0,3,76,810,1021
1,22/11/2022,0133-Chennai International Airport,180875,305786,600,7728,139304,0,0,328507,0,0,0,0,4500,4500,6149,3910,10059,4954,3992,8946,5435,64,702,12,0,21,245,3498,4542
2,22/11/2022,0201-Puratchi Thalaivar Dr. M.G. Ramachandran Central,244699,446844,1630,10792,172534,0,0,429655,0,0,0,0,8400,8400,12329,6268,18597,11340,6652,17992,12062,94,1065,5,0,21,458,5615,7258
2,22/11/2022,0203-Egmore,91617,128168,800,2784,53788,0,0,148989,0,0,0,0,17500,17500,2808,1943,4751,2672,2315,4987,3034,24,571,10,0,10,119,1773,2507
2,22/11/2022,0205-Nehru Park,36017,49228,100,1256,15234,0,0,52607,0,0,0,0,4000,4000,1477,576,2053,1370,480,1850,1455,18,106,0,0,2,53,507,686
2,22/11/2022,0207-Kilpauk,39660,58229,100,1304,15422,0,0,56486,0,0,0,0,0,0,1603,609,2212,1672,598,2270,1739,14,82,2,0,0,59,527,684
2,22/11/2022,0209-Pachaiyappas College,49317,52016,100,728,13558,0,0,63703,0,0,0,0,10000,10000,1792,542,2334,1604,522,2126,1631,14,58,1,0,0,33,493,599
2,22/11/2022,0211-Shenoy Nagar,44543,52151,222,544,11124,0,0,56433,0,0,0,0,1000,1000,1499,420,1919,1635,466,2101,1677,12,70,0,0,3,22,385,492
2,22/11/2022,0213-Anna Nagar East,78804,116028,1100,2504,24882,0,0,107290,0,0,0,0,1500,1500,3512,979,4491,3524,947,4471,3649,23,168,0,0,2,109,842,1144
2,22/11/2022,0215-Anna Nagar Tower,99702,107069,2200,1600,23780,0,0,127282,0,0,0,0,0,0,3067,871,3938,3159,854,4013,3242,12,177,0,0,1,69,780,1039
2,22/11/2022,0217-Thirumangalam,267676,321858,1530,6688,75712,0,0,351606,0,0,0,0,0,0,8439,2671,11110,9083,2653,11736,9345,48,467,3,1,4,251,2321,3095
2,22/11/2022,0219-Koyambedu,200040,232523,300,3896,67802,0,0,272038,0,0,0,0,7500,7500,6385,2379,8764,5768,2109,7877,6070,42,471,4,0,13,157,2153,2840
2,22/11/2022,0221-Puratchi Thalaivi Dr. J. Jayalalithaa CMBT,68132,164203,620,2472,72900,0,0,144124,0,0,0,0,0,0,2739,2456,5195,3447,3267,6714,3624,26,467,6,0,7,113,2297,2916
2,22/11/2022,0223-Arumbakkam,69648,64712,255,1632,19854,0,0,91389,0,0,0,0,10750,10750,1803,755,2558,1878,640,2518,1846,20,1,0,0,5,65,672,763
2,22/11/2022,0225-Vadapalani,131059,216996,669,5480,69558,0,0,206766,0,0,0,0,2000,2000,5371,2500,7871,5462,2464,7926,5779,44,488,0,0,8,214,2210,2964
2,22/11/2022,0227-Ashok Nagar,104107,149496,1521,3560,46076,0,0,155264,0,0,0,0,1500,1500,3998,1619,5617,3960,1303,5263,4101,25,222,5,0,5,140,1395,1792
2,22/11/2022,0229-Ekkattuthangal,99671,145446,1100,3072,29214,0,0,133057,0,0,0,0,1000,1000,4277,1109,5386,4480,1065,5545,4679,24,256,0,0,8,134,917,1339
2,22/11/2022,0231-Arignar Anna Alandur,162644,194922,1000,3560,51174,0,0,218378,0,0,0,0,3250,3250,5767,1770,7537,5428,1548,6976,5665,44,309,1,0,1,142,1540,2037
2,22/11/2022,0233-St. Thomas Mount,89202,105824,1100,3384,28994,0,0,122680,0,0,0,6000,1825,7825,3030,1033,4063,3056,860,3916,3047,27,28,1,0,0,108,898,1062
1,23/11/2022,01ED-Wimco Nagar Depot Metro,84730,78361,200,840,21876,0,0,107646,0,0,0,0,2500,2500,2179,573,2752,1793,396,2189,1789,14,2,3,0,1,27,542,589
1,23/11/2022,01EF-Wimco Nagar Metro,110084,126338,100,2896,26820,0,0,139900,0,0,0,0,3000,3000,3413,756,4169,3091,773,3864,3140,46,51,2,0,6,85,651,841
1,23/11/2022,01F1-Thiruvotriyur Metro,113117,103017,0,1616,20018,0,0,134751,0,0,0,0,0,0,3000,586,3586,2775,459,3234,2771,38,0,0,0,1,51,535,625
1,23/11/2022,01F3-Thiruvotriyur Theradi Metro,100050,117365,400,1656,26822,0,0,128928,0,0,0,0,0,0,2898,786,3684,3096,822,3918,3116,22,38,2,0,1,51,712,826
1,23/11/2022,01F5-Kaladipet Metro,103414,97400,0,1296,19440,0,0,124150,0,0,0,0,0,0,3074,633,3707,2912,612,3524,2897,17,0,1,0,1,46,581,646
1,23/11/2022,01F7-Tollgate Metro,56208,53486,0,592,10906,0,0,67706,0,0,0,0,0,0,1671,358,2029,1560,330,1890,1556,18,0,0,0,5,21,326,370
1,23/11/2022,01F9-New Washermenpet Metro,95921,95152,500,2688,19028,0,0,118137,0,0,0,0,0,0,3025,670,3695,2972,598,3570,3024,20,56,7,0,1,48,621,753
1,23/11/2022,01FB-Tondiarpet Metro,88043,103000,850,1928,22836,0,0,113657,0,0,0,0,500,500,3073,803,3876,3161,802,3963,3171,15,0,0,0,7,65,727,814
1,23/11/2022,01FD-Thiagaraya College Metro,109475,116362,1200,1200,25824,0,0,137699,0,0,0,0,250,250,3671,916,4587,3744,817,4561,3739,54,5,1,0,2,40,862,964
1,23/11/2022,0101-Washermanpet,86848,126785,2700,1944,37068,0,0,128560,0,0,0,0,4750,4750,3933,1304,5237,3540,1221,4761,3638,20,118,0,0,4,74,1224,1440
1,23/11/2022,0103-Mannadi,91320,117708,264,1336,30720,0,0,123640,0,0,0,0,3000,3000,3324,1068,4392,3518,1207,4725,3604,20,174,0,0,0,51,1010,1255
1,23/11/2022,0105-High Court,148775,240918,1050,2336,62886,0,0,215047,0,0,0,0,0,0,6978,2225,9203,7181,1899,9080,7303,30,201,0,0,1,94,2093,2419
1,23/11/2022,0109-Government Estate,111669,156338,1900,3032,44680,0,0,161281,0,0,0,0,6500,6500,4402,1674,6076,4678,1663,6341,4929,29,295,0,0,2,115,1503,1944
1,23/11/2022,0111-LIC,94901,183710,680,2792,31692,0,0,130065,0,0,0,0,0,0,5287,1153,6440,6123,1055,7178,6127,25,0,0,0,0,115,991,1131
1,23/11/2022,0113-Thousand Lights,141898,266869,2251,5744,43226,0,0,193119,0,0,0,0,0,0,8238,1701,9939,9009,1583,10592,9030,33,0,0,0,4,227,1362,1626
1,23/11/2022,0115-AG-DMS,106453,141338,100,2072,25066,0,0,133691,0,0,0,0,1000,1000,4507,921,5428,4513,818,5331,4658,27,174,3,0,2,82,807,1095
1,23/11/2022,0117-Teynampet,88320,153506,800,2448,28486,0,0,120054,0,0,0,0,0,0,4784,1126,5910,5258,1071,6329,5255,20,0,1,0,3,108,977,1109
1,23/11/2022,0119-Nandanam,94868,136391,3162,2384,27994,0,0,128408,0,0,0,0,0,0,4277,1125,5402,4726,968,5694,4709,23,0,0,0,3,101,972,1099
1,23/11/2022,0121-Saidapet,54328,87606,300,1528,21730,0,0,77886,0,0,0,750,2000,2750,2188,804,2992,2689,759,3448,2672,14,0,1,0,0,63,719,797
1,23/11/2022,0123-Little Mount,91615,104014,1100,1704,24316,0,0,118735,0,0,0,0,1000,1000,3794,918,4712,3073,720,3793,3229,20,222,4,0,3,70,788,1107
1,23/11/2022,0125-Guindy,137802,268671,1376,8136,71950,0,0,219264,0,0,0,0,3000,3000,8249,2621,10870,7442,2469,9911,7871,34,412,3,0,4,255,2219,2927
1,23/11/2022,0129-Nanganallur Road,52919,49489,500,672,11984,0,0,66075,0,0,0,0,0,0,1373,381,1754,1467,369,1836,1431,8,1,2,0,0,24,347,382
1,23/11/2022,0131-Meenambakkam,131043,131439,120,2472,30714,0,0,164349,0,0,0,0,0,0,3984,937,4921,3300,809,4109,3454,17,165,1,0,2,83,836,1104
1,23/11/2022,0133-Chennai International Airport,179874,299647,1650,8616,144852,0,0,334992,0,0,0,0,6000,6000,6383,4059,10442,4293,3829,8122,4953,74,742,22,0,13,260,3604,4715
2,23/11/2022,0201-Puratchi Thalaivar Dr. M.G. Ramachandran Central,215059,449380,1600,10368,180910,0,0,407937,0,0,0,0,5850,5850,11910,6572,18482,11486,6833,18319,11772,101,946,5,0,16,403,5922,7393
2,23/11/2022,0203-Egmore,73644,128517,50,3072,60682,0,0,137448,0,0,0,0,11000,11000,2441,2186,4627,2766,2564,5330,2855,23,351,8,0,4,137,2042,2565
2,23/11/2022,0205-Nehru Park,36055,47230,200,1016,13710,0,0,50981,0,0,0,0,2000,2000,1486,513,1999,1348,488,1836,1418,24,99,0,0,0,36,471,630
2,23/11/2022,0207-Kilpauk,39630,61545,200,1224,17672,0,0,58726,0,0,0,0,0,0,1637,659,2296,1675,602,2277,1742,9,94,0,0,0,44,586,733
2,23/11/2022,0209-Pachaiyappas College,44121,51257,0,480,13224,0,0,57825,0,0,0,0,2000,2000,1765,501,2266,1616,522,2138,1636,16,75,1,0,3,21,468,584
2,23/11/2022,0211-Shenoy Nagar,42491,52107,550,1152,11760,0,0,55953,0,0,0,0,2000,2000,1455,432,1887,1558,442,2000,1663,7,112,1,0,1,33,392,546
2,23/11/2022,0213-Anna Nagar East,86600,114054,4275,2816,29352,0,0,123043,0,0,0,0,3000,3000,3225,1112,4337,3230,1047,4277,3383,27,190,0,0,0,117,974,1308
2,23/11/2022,0215-Anna Nagar Tower,94942,105280,0,1832,24420,0,0,121194,0,0,0,0,1250,1250,3091,885,3976,3045,917,3962,3122,22,163,0,0,2,67,771,1025
2,23/11/2022,0217-Thirumangalam,260338,329290,632,7200,79346,0,0,347516,0,0,0,0,0,0,9042,2785,11827,9086,2676,11762,9374,65,466,5,0,3,262,2424,3225
2,23/11/2022,0219-Koyambedu,211178,236344,500,6000,62364,0,0,280042,0,0,0,0,6500,6500,6563,2182,8745,5579,2097,7676,6304,53,841,3,0,4,173,1918,2992
2,23/11/2022,0221-Puratchi Thalaivi Dr. J. Jayalalithaa CMBT,71910,168130,850,2184,72414,0,0,147358,0,0,0,0,0,0,2804,2381,5185,3605,3443,7048,3728,24,540,1,0,3,90,2242,2900
2,23/11/2022,0223-Arumbakkam,55047,65848,40,1368,21900,0,0,78355,0,0,0,0,4000,4000,1762,826,2588,1885,680,2565,1799,33,0,1,0,4,57,748,843
2,23/11/2022,0225-Vadapalani,126036,207886,1000,4824,63520,0,0,195380,0,0,0,0,5000,5000,5314,2293,7607,5302,2418,7720,5682,33,504,3,0,9,197,1985,2731
2,23/11/2022,0227-Ashok Nagar,91686,150443,1080,4024,46180,0,0,142970,0,0,0,0,0,0,3998,1672,5670,3958,1402,5360,4127,36,240,1,0,4,157,1432,1870
2,23/11/2022,0229-Ekkattuthangal,91746,144790,2120,3576,27694,0,0,125136,0,0,0,0,0,0,4299,1075,5374,4468,1032,5500,4740,25,283,1,0,2,146,853,1310
2,23/11/2022,0231-Arignar Anna Alandur,153434,203724,110,4136,53578,0,0,211258,0,0,0,0,500,500,5863,1862,7725,5590,1594,7184,5878,37,419,2,1,3,150,1570,2182
2,23/11/2022,0233-St. Thomas Mount,95401,108541,500,3248,31426,0,0,130575,0,0,0,3000,3400,6400,3018,1077,4095,3032,837,3869,3043,18,71,0,0,1,99,936,1125
1,24/11/2022,01ED-Wimco Nagar Depot Metro,79168,75499,120,1160,20130,0,0,100578,0,0,0,0,4250,4250,0,0,0,1767,373,2140,1769,14,0,2,0,3,32,493,544
1,24/11/2022,01EF-Wimco Nagar Metro,115502,130307,1200,3456,27870,0,0,148028,0,0,0,0,250,250,0,0,0,3129,796,3925,3212,57,57,4,0,1,90,663,872
1,24/11/2022,01F1-Thiruvotriyur Metro,111322,99740,100,2032,18164,0,0,131618,0,0,0,0,0,0,0,0,0,2726,402,3128,2735,27,0,1,0,3,56,473,560
1,24/11/2022,01F3-Thiruvotriyur Theradi Metro,100056,121031,770,2272,25344,0,0,128442,0,0,0,0,0,0,0,0,0,3222,818,4040,3293,24,54,3,0,5,73,662,821
1,24/11/2022,01F5-Kaladipet Metro,97553,99160,300,1424,19694,0,0,118971,0,0,0,0,0,0,0,0,0,2942,554,3496,2953,19,0,3,0,1,46,579,648
1,24/11/2022,01F7-Tollgate Metro,66376,55734,0,1184,13004,0,0,80564,0,0,0,0,0,0,0,0,0,1572,409,1981,1572,16,1,0,0,4,28,384,433
1,24/11/2022,01F9-New Washermenpet Metro,102505,98139,100,1232,21850,0,0,125687,0,0,0,0,500,500,0,0,0,2945,704,3649,2998,19,59,2,0,2,48,680,810
1,24/11/2022,01FB-Tondiarpet Metro,89025,104077,300,1424,25070,0,0,115819,0,0,0,0,250,250,0,0,0,3089,814,3903,3107,21,1,1,0,5,52,767,847
1,24/11/2022,01FD-Thiagaraya College Metro,105695,114150,140,1824,22732,0,0,130391,0,0,0,0,500,500,0,0,0,3718,760,4478,3744,44,26,0,0,1,57,774,902
1,24/11/2022,0101-Washermanpet,104965,126069,458,2088,36408,0,0,143919,0,0,0,0,10500,10500,0,0,0,3545,1164,4709,3652,17,100,4,0,2,82,1154,1359
1,24/11/2022,0103-Mannadi,72159,112138,0,1704,32072,0,0,105935,0,0,0,0,500,500,0,0,0,3362,1066,4428,3376,16,53,0,0,2,72,1052,1195
1,24/11/2022,0105-High Court,141414,238836,1600,2312,62166,0,0,207492,0,0,0,0,0,0,0,0,0,7113,1844,8957,7256,20,193,3,0,3,95,2074,2388
1,24/11/2022,0109-Government Estate,86189,155151,230,2960,45474,0,0,134853,0,0,0,0,500,500,0,0,0,4563,1645,6208,4817,19,287,2,0,0,110,1490,1908
1,24/11/2022,0111-LIC,87193,182720,1230,2472,32730,0,0,123625,0,0,0,0,250,250,0,0,0,6002,1076,7078,6029,27,0,1,0,3,105,1044,1180
1,24/11/2022,0113-Thousand Lights,154300,262004,3400,5016,41464,0,0,204180,0,0,0,0,0,0,0,0,0,8867,1440,10307,8909,25,4,4,0,2,213,1306,1554
1,24/11/2022,0115-AG-DMS,103767,148334,590,2104,26574,0,0,133035,0,0,0,0,1000,1000,0,0,0,4678,847,5525,4832,28,153,0,0,1,83,827,1092
1,24/11/2022,0117-Teynampet,102499,145671,900,2304,29576,0,0,135279,0,0,0,0,4500,4500,0,0,0,4887,1084,5971,4901,21,1,2,0,5,105,1012,1146
1,24/11/2022,0119-Nandanam,100729,130162,1300,2176,26904,0,0,131109,0,0,0,0,4000,4000,0,0,0,4510,889,5399,4492,21,0,3,0,0,94,915,1033
1,24/11/2022,0121-Saidapet,55525,88179,200,1736,23414,0,0,80875,0,0,0,0,4250,4250,0,0,0,2649,802,3451,2627,12,0,0,0,2,75,765,854
1,24/11/2022,0123-Little Mount,98565,104259,300,1632,24094,0,0,124591,0,0,0,0,1500,1500,0,0,0,3048,746,3794,3226,26,222,0,0,6,69,779,1102
1,24/11/2022,0125-Guindy,122178,273821,2440,6872,73184,0,0,204674,0,0,0,0,1500,1500,0,0,0,7509,2377,9886,8000,24,438,9,0,6,259,2290,3026
1,24/11/2022,0129-Nanganallur Road,49651,49671,500,656,11214,0,0,62021,0,0,0,0,0,0,0,0,0,1515,362,1877,1481,14,1,0,0,2,25,344,386
1,24/11/2022,0131-Meenambakkam,123731,132655,500,2464,32096,0,0,158791,0,0,0,0,0,0,0,0,0,3240,835,4075,3422,26,189,2,0,3,84,852,1156
1,24/11/2022,0133-Chennai International Airport,191887,293275,500,8352,140438,0,0,341177,0,0,0,0,6000,6000,0,0,0,4266,4164,8430,4903,56,757,22,0,10,256,3453,4554
2,24/11/2022,0201-Puratchi Thalaivar Dr. M.G. Ramachandran Central,214453,466880,4160,10048,192010,0,0,420671,0,0,0,0,7000,7000,0,0,0,11769,7345,19114,11998,117,922,4,0,16,417,6163,7639
2,24/11/2022,0203-Egmore,72475,131878,200,2704,57806,0,0,133185,0,0,0,0,3600,3600,0,0,0,2923,2759,5682,3043,17,406,8,0,8,118,1922,2479
2,24/11/2022,0205-Nehru Park,39535,51564,500,1688,13956,0,0,55679,0,0,0,0,250,250,0,0,0,1431,455,1886,1565,11,139,0,0,0,61,453,664
2,24/11/2022,0207-Kilpauk,37562,58790,0,1120,15040,0,0,53722,0,0,0,0,0,0,0,0,0,1696,574,2270,1774,18,101,0,0,1,53,492,665
2,24/11/2022,0209-Pachaiyappas College,47739,49908,60,560,10902,0,0,59261,0,0,0,0,4500,4500,0,0,0,1599,476,2075,1657,12,86,2,0,0,23,399,522
2,24/11/2022,0211-Shenoy Nagar,51625,55790,0,848,14106,0,0,66579,0,0,0,0,6000,6000,0,0,0,1632,522,2154,1692,3,88,1,0,1,32,473,598
2,24/11/2022,0213-Anna Nagar East,91999,117313,1200,2848,26004,0,0,122051,0,0,0,0,3000,3000,0,0,0,3463,895,4358,3632,24,201,3,0,1,121,860,1210
2,24/11/2022,0215-Anna Nagar Tower,92054,104925,50,2320,23176,0,0,117600,0,0,0,0,1000,1000,0,0,0,3063,860,3923,3168,17,185,5,0,1,67,767,1042
2,24/11/2022,0217-Thirumangalam,280665,329721,2900,8680,82128,0,0,374373,0,0,0,0,0,0,0,0,0,8944,2621,11565,9340,47,481,8,0,2,308,2481,3327
2,24/11/2022,0219-Koyambedu,177865,237479,2100,5536,76168,0,0,261669,0,0,0,0,10500,10500,0,0,0,5628,2081,7709,5960,41,434,5,0,9,196,2353,3038
2,24/11/2022,0221-Puratchi Thalaivi Dr. J. Jayalalithaa CMBT,56229,164961,1022,3024,74054,0,0,134329,0,0,0,0,0,0,0,0,0,3794,3837,7631,3646,22,289,2,0,3,124,2299,2739
2,24/11/2022,0223-Arumbakkam,60538,65297,100,1296,22216,0,0,84150,0,0,0,0,10000,10000,0,0,0,1829,671,2500,1796,20,0,1,0,2,52,735,810
2,24/11/2022,0225-Vadapalani,129409,214185,100,5384,66530,0,0,201423,0,0,0,0,3000,3000,0,0,0,5269,2340,7609,5683,31,601,1,0,11,199,2017,2860
2,24/11/2022,0227-Ashok Nagar,94713,151113,1630,4136,42792,0,0,143271,0,0,0,0,0,0,0,0,0,3937,1437,5374,4205,25,315,3,0,1,151,1335,1830
2,24/11/2022,0229-Ekkattuthangal,89897,149909,600,4424,31202,0,0,126123,0,0,0,0,0,0,0,0,0,4352,1075,5427,4746,25,383,4,0,1,168,965,1546
2,24/11/2022,0231-Arignar Anna Alandur,143780,210833,900,5536,58740,0,0,208956,0,0,0,0,4000,4000,0,0,0,5521,1676,7197,5913,38,442,2,0,4,192,1707,2385
2,24/11/2022,0233-St. Thomas Mount,87707,109753,600,3104,33822,0,0,125233,0,0,0,0,7250,7250,0,0,0,2981,923,3904,2985,15,42,1,0,2,103,1015,1178
1,25/11/2022,01ED-Wimco Nagar Depot Metro,84257,81855,0,976,24422,0,0,109655,0,0,0,0,500,500,2270,616,2886,1838,424,2262,1822,16,7,2,0,4,29,591,649
1,25/11/2022,01EF-Wimco Nagar Metro,104842,131495,600,3072,30300,0,0,138814,0,0,0,0,2250,2250,3469,837,4306,3101,772,3873,3147,40,59,4,0,9,84,732,928
1,25/11/2022,01F1-Thiruvotriyur Metro,102785,103282,0,1624,19912,0,0,124321,0,0,0,0,0,0,3065,585,3650,2837,490,3327,2796,47,0,4,0,6,51,538,646
1,25/11/2022,01F3-Thiruvotriyur Theradi Metro,102870,130050,200,2344,30180,0,0,135594,0,0,0,0,0,0,3294,870,4164,3328,834,4162,3400,13,122,8,0,4,68,783,998
1,25/11/2022,01F5-Kaladipet Metro,106538,102660,250,1560,21636,0,0,129984,0,0,0,0,0,0,3188,703,3891,3027,575,3602,3000,31,21,4,0,3,52,645,756
1,25/11/2022,01F7-Tollgate Metro,57224,58395,200,880,13892,0,0,72196,0,0,0,0,0,0,1721,448,2169,1638,401,2039,1617,19,10,1,0,6,29,396,461
1,25/11/2022,01F9-New Washermenpet Metro,92456,96464,40,1136,22738,0,0,116370,0,0,0,0,0,0,2946,770,3716,2955,658,3613,2928,11,49,1,0,1,42,723,827
1,25/11/2022,01FB-Tondiarpet Metro,82974,105095,180,1504,28010,0,0,112668,0,0,0,0,2000,2000,2881,921,3802,3109,855,3964,3044,13,0,0,0,7,51,858,929
1,25/11/2022,01FD-Thiagaraya College Metro,113304,117821,380,1520,28112,0,0,143316,0,0,0,0,250,250,3722,963,4685,3707,882,4589,3693,44,33,0,0,1,56,900,1034
1,25/11/2022,0101-Washermanpet,89423,129867,364,2216,36862,0,0,128865,0,0,0,0,6500,6500,3970,1265,5235,3574,1226,4800,3756,18,263,1,0,6,84,1173,1545
1,25/11/2022,0103-Mannadi,81793,118518,300,1480,32344,0,0,115917,0,0,0,0,1500,1500,3263,1117,4380,3527,1129,4656,3612,16,194,1,0,0,64,1031,1306
1,25/11/2022,0105-High Court,130918,250161,200,2464,67478,0,0,201060,0,0,0,0,0,0,7176,2378,9554,7274,2016,9290,7482,30,347,0,0,4,109,2224,2714
1,25/11/2022,0109-Government Estate,98050,159060,200,2568,46166,0,0,146984,0,0,0,0,2250,2250,4447,1704,6151,4613,1722,6335,4932,16,434,1,0,1,104,1507,2063
1,25/11/2022,0111-LIC,91867,183807,1100,2488,32884,0,0,128339,0,0,0,0,0,0,5295,1210,6505,6027,1094,7121,6081,16,97,0,0,0,108,1056,1277
1,25/11/2022,0113-Thousand Lights,144147,261262,2242,6184,38700,0,0,191273,0,0,0,0,250,250,8005,1558,9563,8572,1556,10128,8875,34,287,3,0,4,254,1179,1761
1,25/11/2022,0115-AG-DMS,110310,156588,1800,2720,30004,0,0,144834,0,0,0,0,1250,1250,4921,1065,5986,4782,840,5622,4997,28,230,0,0,2,103,917,1280
1,25/11/2022,0117-Teynampet,86819,146448,700,2840,28080,0,0,118439,0,0,0,0,0,0,4486,1126,5612,4862,1035,5897,4959,22,145,2,0,6,122,950,1247
1,25/11/2022,0119-Nandanam,83042,140610,616,3168,35284,0,0,122110,0,0,0,0,1000,1000,4147,1346,5493,4556,966,5522,4521,28,0,3,0,2,127,1174,1334
1,25/11/2022,0121-Saidapet,56307,91760,100,1392,27620,0,0,85419,0,0,0,0,8750,8750,2194,989,3183,2607,778,3385,2559,25,0,0,0,1,60,915,1001
1,25/11/2022,0123-Little Mount,83223,109217,832,2880,29336,0,0,116271,0,0,0,0,500,500,3732,1139,4871,3003,708,3711,3226,10,257,0,0,3,125,954,1349
1,25/11/2022,0125-Guindy,138937,288947,2370,9104,74098,0,0,224509,0,0,0,0,0,0,8747,2756,11503,7481,2556,10037,8421,23,979,0,0,5,348,2243,3598
1,25/11/2022,0129-Nanganallur Road,39302,50181,200,552,13122,0,0,53176,0,0,0,0,0,0,1356,414,1770,1470,369,1839,1416,6,0,0,0,0,20,379,405
1,25/11/2022,0131-Meenambakkam,122639,130498,3100,2168,36202,0,0,164109,0,0,0,0,0,0,3813,1048,4861,3085,954,4039,3198,12,195,1,0,2,75,975,1260
1,25/11/2022,0133-Chennai International Airport,199248,316886,3500,11320,150164,0,0,364232,0,0,0,0,7500,7500,6758,4292,11050,4508,4125,8633,5284,65,1072,9,0,11,331,3689,5177
2,25/11/2022,0201-Puratchi Thalaivar Dr. M.G. Ramachandran Central,230164,524510,1540,13128,204280,0,0,449112,0,0,0,0,11900,11900,12493,7464,19957,13540,8149,21689,13682,71,1461,15,0,27,546,6742,8862
2,25/11/2022,0203-Egmore,81728,150921,600,3312,64170,0,0,149810,0,0,0,0,17000,17000,2689,2308,4997,3675,2995,6670,3555,20,465,6,0,7,129,2141,2768
2,25/11/2022,0205-Nehru Park,38373,53157,200,1656,17284,0,0,57513,0,0,0,0,0,0,1544,682,2226,1456,544,2000,1531,16,105,1,0,0,68,587,777
2,25/11/2022,0207-Kilpauk,36199,63284,200,1008,19592,0,0,56999,0,0,0,0,0,0,1633,737,2370,1696,614,2310,1757,10,119,1,0,0,46,672,848
2,25/11/2022,0209-Pachaiyappas College,50300,54212,0,912,10098,0,0,61310,0,0,0,0,4500,4500,1950,405,2355,1626,527,2153,1832,10,250,2,0,1,40,360,663
2,25/11/2022,0211-Shenoy Nagar,37560,60579,0,632,16486,0,0,54678,0,0,0,0,0,0,1620,582,2202,1731,516,2247,1791,10,136,3,0,6,29,539,723
2,25/11/2022,0213-Anna Nagar East,89133,119599,400,2960,28402,0,0,120895,0,0,0,0,6000,6000,3556,1096,4652,3523,974,4497,3638,15,225,0,0,1,117,954,1312
2,25/11/2022,0215-Anna Nagar Tower,88689,111632,0,2384,27246,0,0,118319,0,0,0,0,1250,1250,3225,1016,4241,3094,923,4017,3248,18,259,0,0,1,97,892,1267
2,25/11/2022,0217-Thirumangalam,254588,343098,2257,9536,82964,0,0,349345,0,0,0,0,0,0,9700,2969,12669,9132,2715,11847,9726,70,921,11,0,4,323,2532,3861
2,25/11/2022,0219-Koyambedu,183382,242719,2768,4888,77772,0,0,268810,0,0,0,0,10750,10750,6314,2737,9051,5777,2345,8122,6101,38,691,5,0,10,199,2447,3390
2,25/11/2022,0221-Puratchi Thalaivi Dr. J. Jayalalithaa CMBT,64540,197285,1320,3104,75766,0,0,144730,0,0,0,0,0,0,2847,2544,5391,5474,5040,10514,4794,26,571,6,0,3,115,2373,3094
2,25/11/2022,0223-Arumbakkam,50718,66198,0,1296,24654,0,0,76668,0,0,0,0,500,500,1811,910,2721,1813,668,2481,1706,11,2,1,0,2,52,846,914
2,25/11/2022,0225-Vadapalani,133751,233225,300,6256,76052,0,0,216359,0,0,0,0,7000,7000,5822,2725,8547,5414,2721,8135,6028,43,941,8,0,8,242,2355,3597
2,25/11/2022,0227-Ashok Nagar,100496,169174,2050,6112,51818,0,0,160476,0,0,0,0,3000,3000,4395,1920,6315,4050,1560,5610,4520,19,586,3,0,2,235,1560,2405
2,25/11/2022,0229-Ekkattuthangal,95862,150591,1900,3888,31626,0,0,133276,0,0,0,0,1250,1250,4562,1182,5744,4154,1014,5168,4687,17,651,1,0,3,151,952,1775
2,25/11/2022,0231-Arignar Anna Alandur,160099,217639,0,5600,64084,0,0,229783,0,0,0,0,1750,1750,6163,2214,8377,5331,1847,7178,5896,36,745,1,0,2,210,1883,2877
2,25/11/2022,0233-St. Thomas Mount,78181,119908,400,3776,40848,0,0,123205,0,0,0,6000,2000,8000,3163,1413,4576,3051,952,4003,3083,17,185,6,0,1,126,1231,1566
1,26/11/2022,01ED-Wimco Nagar Depot Metro,65755,75123,0,1344,29938,0,0,97037,0,0,0,0,2000,2000,1803,742,2545,1434,487,1921,1424,12,0,2,0,6,36,715,771
1,26/11/2022,01EF-Wimco Nagar Metro,98024,117364,200,3848,36574,0,0,138646,0,0,0,0,1250,1250,2728,1023,3751,2421,1080,3501,2511,54,94,5,0,9,113,889,1164
1,26/11/2022,01F1-Thiruvotriyur Metro,91919,93742,25,2312,25140,0,0,119396,0,0,0,0,0,0,2428,728,3156,2291,661,2952,2317,33,0,4,0,4,64,660,765
1,26/11/2022,01F3-Thiruvotriyur Theradi Metro,90109,123276,700,2320,39496,0,0,132625,0,0,0,0,0,0,2797,1128,3925,2856,1084,3940,2852,21,53,4,0,12,76,1022,1188
1,26/11/2022,01F5-Kaladipet Metro,77657,90741,700,1808,26102,0,0,106267,0,0,0,0,0,0,2551,827,3378,2393,751,3144,2380,13,0,5,0,1,59,757,835
1,26/11/2022,01F7-Tollgate Metro,51515,52290,200,640,17244,0,0,69599,0,0,0,0,0,0,1424,552,1976,1319,480,1799,1296,32,0,1,0,6,27,500,566
1,26/11/2022,01F9-New Washermenpet Metro,87843,87123,100,1680,26448,0,0,116071,0,0,0,0,1500,1500,2392,881,3273,2312,821,3133,2382,17,46,1,1,5,60,814,944
1,26/11/2022,01FB-Tondiarpet Metro,76460,93582,700,2104,31794,0,0,111058,0,0,0,0,250,250,2481,1026,3507,2449,1005,3454,2419,17,0,6,0,9,59,955,1046
1,26/11/2022,01FD-Thiagaraya College Metro,93420,114264,0,2976,37150,0,0,133546,0,0,0,0,2500,2500,3072,1274,4346,3081,1135,4216,3125,50,41,1,0,0,104,1146,1342
1,26/11/2022,0101-Washermanpet,80670,118502,200,1824,47570,0,0,130264,0,0,0,0,11000,11000,2988,1574,4562,2801,1471,4272,2869,22,153,3,0,14,76,1486,1754
1,26/11/2022,0103-Mannadi,73039,109252,150,1720,39084,0,0,113993,0,0,0,0,0,0,2642,1345,3987,2893,1367,4260,2933,13,144,4,0,5,73,1241,1480
1,26/11/2022,0105-High Court,88989,187420,600,5528,75814,0,0,170931,0,0,0,0,0,0,4404,2655,7059,4357,2195,6552,4576,23,361,2,0,5,151,2391,2933
1,26/11/2022,0109-Government Estate,78532,155514,510,4424,61968,0,0,145434,0,0,0,0,5750,5750,3484,2282,5766,3716,2118,5834,4003,18,366,0,0,4,173,2010,2571
1,26/11/2022,0111-LIC,32992,98896,100,2120,34538,0,0,69750,0,0,0,0,2000,2000,2064,1214,3278,2619,1012,3631,2560,17,0,0,0,9,79,1089,1194
1,26/11/2022,0113-Thousand Lights,83223,176369,2807,5008,50528,0,0,141566,0,0,0,0,1000,1000,4347,1839,6186,5108,1692,6800,5025,32,0,2,0,6,193,1557,1790
1,26/11/2022,0115-AG-DMS,61585,92951,500,2880,24622,0,0,89587,0,0,0,0,0,0,2381,873,3254,2391,670,3061,2590,12,226,0,0,2,99,737,1076
1,26/11/2022,0117-Teynampet,50915,110351,2500,1896,38094,0,0,93405,0,0,0,0,0,0,2662,1367,4029,3043,1149,4192,2955,10,2,0,0,3,83,1244,1342
1,26/11/2022,0119-Nandanam,49886,89784,200,2600,33188,0,0,85874,0,0,0,0,0,0,2076,1226,3302,2374,943,3317,2318,19,3,0,0,2,102,1087,1213
1,26/11/2022,0121-Saidapet,34857,63502,200,1624,26638,0,0,63319,0,0,0,0,4000,4000,1137,916,2053,1474,851,2325,1419,15,0,2,0,0,63,832,912
1,26/11/2022,0123-Little Mount,63192,79432,360,2824,28798,0,0,95174,0,0,0,0,0,0,2250,1053,3303,1727,833,2560,1973,18,315,2,0,3,109,913,1360
1,26/11/2022,0125-Guindy,103038,227901,1780,7632,98666,0,0,211116,0,0,0,0,0,0,4950,3408,8358,4380,3180,7560,4900,27,708,1,0,6,279,2980,4001
1,26/11/2022,0129-Nanganallur Road,34674,39003,0,880,14830,0,0,50384,0,0,0,0,0,0,802,462,1264,938,427,1365,875,13,0,0,0,1,29,419,462
1,26/11/2022,0131-Meenambakkam,92475,114057,844,3480,47264,0,0,144063,0,0,0,0,0,0,2193,1368,3561,2017,1176,3193,2203,14,234,11,0,10,102,1250,1621
1,26/11/2022,0133-Chennai International Airport,162756,318757,1320,11880,175620,0,0,351576,0,0,0,0,2250,2250,5174,4996,10170,3441,5164,8605,4408,59,1233,7,0,24,347,4232,5902
2,26/11/2022,0201-Puratchi Thalaivar Dr. M.G. Ramachandran Central,188489,499420,1500,12816,258260,0,0,461065,0,0,0,0,2100,2100,9252,9047,18299,9123,8950,18073,9842,69,1630,45,0,28,518,8256,10546
2,26/11/2022,0203-Egmore,70785,142216,200,2864,73554,0,0,147403,0,0,0,0,18850,18850,2080,2574,4654,2652,3345,5997,2708,18,515,17,0,8,120,2405,3083
2,26/11/2022,0205-Nehru Park,61682,49464,200,1344,19368,0,0,82594,0,0,0,0,30000,30000,1252,715,1967,1113,623,1736,1236,10,163,1,0,0,50,644,868
2,26/11/2022,0207-Kilpauk,30091,54392,100,1424,20606,0,0,52221,0,0,0,0,0,0,1286,762,2048,1303,674,1977,1363,8,119,0,0,2,63,685,877
2,26/11/2022,0209-Pachaiyappas College,44082,62043,0,960,26104,0,0,71146,0,0,0,0,8000,8000,1511,940,2451,1429,799,2228,1462,3,135,0,0,5,41,884,1068
2,26/11/2022,0211-Shenoy Nagar,33202,46337,100,1088,15796,0,0,50186,0,0,0,0,0,0,1144,561,1705,1149,548,1697,1236,11,145,3,0,5,46,506,716
2,26/11/2022,0213-Anna Nagar East,70246,112677,500,3696,36788,0,0,111230,0,0,0,0,0,0,2855,1366,4221,2778,1256,4034,2974,20,287,0,0,2,148,1175,1632
2,26/11/2022,0215-Anna Nagar Tower,76607,106177,400,2000,37212,0,0,116219,0,0,0,0,0,0,2584,1314,3898,2439,1353,3792,2616,16,344,3,0,5,81,1169,1618
2,26/11/2022,0217-Thirumangalam,212955,301512,1330,10888,117168,0,0,342341,0,0,0,0,0,0,6524,4065,10589,6345,3896,10241,6867,64,804,15,0,7,387,3526,4803
2,26/11/2022,0219-Koyambedu,140567,220277,500,5272,99050,0,0,245389,0,0,0,5000,4500,9500,4579,3413,7992,3954,2835,6789,4461,53,781,6,0,19,210,3042,4111
2,26/11/2022,0221-Puratchi Thalaivi Dr. J. Jayalalithaa CMBT,64680,188690,406,3464,90404,0,0,158954,0,0,0,0,0,0,2494,3062,5556,3674,5054,8728,3788,23,769,1,0,8,146,2816,3763
2,26/11/2022,0223-Arumbakkam,50040,59261,100,1648,29156,0,0,80944,0,0,0,0,11750,11750,1272,1107,2379,1343,834,2177,1257,19,0,0,0,4,67,1014,1104
2,26/11/2022,0225-Vadapalani,101876,246602,550,9760,113084,0,0,225270,0,0,0,0,3000,3000,4705,4243,8948,4835,3989,8824,5178,32,751,6,0,6,402,3520,4717
2,26/11/2022,0227-Ashok Nagar,78093,133474,559,4888,54062,0,0,137602,0,0,0,0,0,0,3000,2012,5012,2835,1868,4703,3101,29,357,2,0,1,190,1683,2262
2,26/11/2022,0229-Ekkattuthangal,62656,88311,650,2712,30686,0,0,96704,0,0,0,0,0,0,2193,1136,3329,2046,1065,3111,2277,12,374,1,0,7,117,969,1480
2,26/11/2022,0231-Arignar Anna Alandur,128266,197944,850,6200,80958,0,0,216274,0,0,0,0,1250,1250,4252,2740,6992,3801,2778,6579,4277,52,716,11,0,16,227,2314,3336
2,26/11/2022,0233-St. Thomas Mount,68153,114483,300,4264,54096,0,0,126813,0,0,0,9000,5300,14300,2280,1771,4051,2191,1581,3772,2270,34,214,8,0,3,143,1558,1960
1,27/11/2022,01ED-Wimco Nagar Depot Metro,49071,63695,0,2296,30408,0,0,81775,0,0,0,0,1000,1000,1059,760,1819,985,509,1494,1004,6,0,1,0,14,57,690,768
1,27/11/2022,01EF-Wimco Nagar Metro,61485,83311,100,2280,34150,0,0,98015,0,0,0,0,2000,2000,1483,881,2364,1238,1025,2263,1436,42,229,3,0,11,63,774,1122
1,27/11/2022,01F1-Thiruvotriyur Metro,58070,76535,0,1768,32558,0,0,92396,0,0,0,0,0,0,1396,898,2294,1437,803,2240,1414,30,0,0,0,16,48,845,939
1,27/11/2022,01F3-Thiruvotriyur Theradi Metro,57269,104462,20,2360,47926,0,0,107575,0,0,0,0,0,0,1622,1291,2913,1812,1375,3187,1854,15,90,1,0,16,70,1207,1399
1,27/11/2022,01F5-Kaladipet Metro,51747,69817,200,1488,34326,0,0,87761,0,0,0,0,0,0,1232,983,2215,1299,946,2245,1271,20,0,0,0,4,49,938,1011
1,27/11/2022,01F7-Tollgate Metro,32315,43691,200,1016,21816,0,0,55347,0,0,0,0,0,0,783,670,1453,807,573,1380,795,38,0,0,0,12,34,610,694
1,27/11/2022,01F9-New Washermenpet Metro,47354,64321,0,1912,28492,0,0,77758,0,0,0,0,0,0,1268,898,2166,1295,848,2143,1320,11,60,5,1,9,63,827,976
1,27/11/2022,01FB-Tondiarpet Metro,42621,68203,100,2128,34218,0,0,79067,0,0,0,0,0,0,1205,1037,2242,1316,977,2293,1269,12,0,0,0,12,68,966,1058
1,27/11/2022,01FD-Thiagaraya College Metro,57185,86945,0,2456,39252,0,0,98893,0,0,0,0,1500,1500,1698,1253,2951,1788,1066,2854,1801,33,69,4,0,14,89,1157,1366
1,27/11/2022,0101-Washermanpet,60115,81893,550,1952,42210,0,0,104827,0,0,0,0,14000,14000,1515,1392,2907,1438,1406,2844,1486,19,165,7,0,14,74,1305,1584
1,27/11/2022,0103-Mannadi,39738,63620,0,1312,33200,0,0,74250,0,0,0,0,1500,1500,1111,1108,2219,1111,1174,2285,1184,10,166,2,0,12,54,1041,1285
1,27/11/2022,0105-High Court,27067,79942,240,2528,43006,0,0,72841,0,0,0,0,0,0,1421,1539,2960,1426,1305,2731,1513,16,171,0,0,9,98,1422,1716
1,27/11/2022,0109-Government Estate,28015,93861,0,2384,48928,0,0,79327,0,0,0,0,0,0,1630,1740,3370,1650,1581,3231,1804,12,316,0,0,8,89,1576,2001
1,27/11/2022,0111-LIC,21286,51171,250,1384,24726,0,0,47646,0,0,0,0,0,0,851,844,1695,1153,746,1899,1046,4,8,1,0,12,55,752,832
1,27/11/2022,0113-Thousand Lights,33523,83707,170,2864,38728,0,0,75285,0,0,0,0,0,0,1439,1385,2824,1893,1346,3239,1769,16,0,1,0,14,100,1178,1309
1,27/11/2022,0115-AG-DMS,17294,43198,500,1736,18114,0,0,37644,0,0,0,0,0,0,823,624,1447,751,644,1395,907,5,212,7,0,0,58,544,826
1,27/11/2022,0117-Teynampet,22373,52892,150,1640,27220,0,0,51383,0,0,0,0,0,0,849,1003,1852,1084,1012,2096,1033,8,0,0,0,14,66,907,995
1,27/11/2022,0119-Nandanam,21114,42951,500,1264,24378,0,0,47256,0,0,0,0,0,0,690,898,1588,843,808,1651,752,14,0,4,0,1,48,824,891
1,27/11/2022,0121-Saidapet,24807,51048,500,1472,27832,0,0,54611,0,0,0,0,4000,4000,702,916,1618,929,861,1790,849,12,0,2,0,10,54,850,928
1,27/11/2022,0123-Little Mount,31703,57745,420,2208,26216,0,0,60547,0,0,0,0,0,0,1163,957,2120,1048,802,1850,1183,7,225,0,0,6,86,822,1146
1,27/11/2022,0125-Guindy,62507,183606,100,6392,106698,0,0,175697,0,0,0,0,0,0,2478,3539,6017,2338,3056,5394,2709,27,628,10,0,6,217,3151,4039
1,27/11/2022,0129-Nanganallur Road,12773,25327,200,600,13516,0,0,27089,0,0,0,0,0,0,351,417,768,485,380,865,421,9,0,0,0,4,20,392,425
1,27/11/2022,0131-Meenambakkam,53493,87367,200,3216,46552,0,0,103461,0,0,0,0,0,0,1321,1309,2630,1141,1165,2306,1300,17,219,15,0,14,101,1217,1583
1,27/11/2022,0133-Chennai International Airport,124934,310488,990,15568,184500,0,0,325992,0,0,0,0,750,750,3933,5193,9126,2713,5184,7897,3718,43,1336,18,0,29,395,4280,6101
2,27/11/2022,0201-Puratchi Thalaivar Dr. M.G. Ramachandran Central,140539,411727,800,12616,261012,0,0,414967,0,0,0,0,1650,1650,5631,8872,14503,5140,8319,13459,5702,99,1470,9,0,37,467,8111,10193
2,27/11/2022,0203-Egmore,55244,122888,100,4944,74766,0,0,135054,0,0,0,0,7500,7500,1648,2689,4337,1744,3084,4828,1870,22,431,8,0,15,200,2458,3134
2,27/11/2022,0205-Nehru Park,21826,36643,0,664,19602,0,0,42092,0,0,0,0,0,0,677,681,1358,670,632,1302,672,9,116,0,0,5,25,631,786
2,27/11/2022,0207-Kilpauk,14795,34003,0,1168,15706,0,0,31669,0,0,0,0,0,0,626,574,1200,659,550,1209,712,7,95,0,0,5,46,512,665
2,27/11/2022,0209-Pachaiyappas College,16944,34508,0,736,17226,0,0,34906,0,0,0,0,2000,2000,673,611,1284,656,526,1182,691,6,105,0,0,1,29,569,710
2,27/11/2022,0211-Shenoy Nagar,21712,29732,278,464,12628,0,0,35082,0,0,0,0,2000,2000,641,451,1092,618,455,1073,675,8,119,3,0,10,23,408,571
2,27/11/2022,0213-Anna Nagar East,43270,69882,800,2096,30416,0,0,76582,0,0,0,0,3000,3000,1436,1117,2553,1449,1107,2556,1553,13,228,0,0,4,89,986,1320
2,27/11/2022,0215-Anna Nagar Tower,46607,78700,200,3008,36396,0,0,86211,0,0,0,0,3750,3750,1482,1304,2786,1395,1218,2613,1598,11,316,0,0,4,107,1145,1583
2,27/11/2022,0217-Thirumangalam,130481,230982,350,9424,109742,0,0,249997,0,0,0,0,0,0,4005,3683,7688,3870,3568,7438,4386,60,928,11,0,18,324,3241,4582
2,27/11/2022,0219-Koyambedu,87318,161669,300,5216,92470,0,0,185304,0,0,0,0,1250,1250,2726,3188,5914,2149,2722,4871,2617,39,678,37,0,25,214,2833,3826
2,27/11/2022,0221-Puratchi Thalaivi Dr. J. Jayalalithaa CMBT,56618,170200,20,5336,96412,0,0,158386,0,0,0,0,0,0,2096,3225,5321,2439,4477,6916,2721,24,837,4,0,14,207,2953,4039
2,27/11/2022,0223-Arumbakkam,24291,48780,0,1744,30710,0,0,56745,0,0,0,0,8500,8500,675,1131,1806,842,800,1642,748,10,0,4,0,7,68,1041,1130
2,27/11/2022,0225-Vadapalani,81057,206841,200,8784,111424,0,0,201465,0,0,0,0,2000,2000,3190,4001,7191,3156,3814,6970,3550,36,843,1,0,22,330,3376,4608
2,27/11/2022,0227-Ashok Nagar,49487,97934,1300,3272,52570,0,0,106629,0,0,0,0,0,0,1619,1800,3419,1603,1760,3363,1739,24,337,10,0,4,125,1617,2117
2,27/11/2022,0229-Ekkattuthangal,36921,55878,500,1616,22612,0,0,61649,0,0,0,0,0,0,1220,801,2021,1120,865,1985,1319,14,353,5,0,8,70,688,1138
2,27/11/2022,0231-Arignar Anna Alandur,87935,165685,1010,6888,86252,0,0,182085,0,0,0,0,250,250,2582,2773,5355,2273,2621,4894,2766,41,701,7,0,21,213,2455,3438
2,27/11/2022,0233-St. Thomas Mount,52728,87012,100,4024,49660,0,0,106512,0,0,0,9000,6800,15800,1400,1631,3031,1168,1477,2645,1314,24,314,2,0,14,137,1434,1925
1,28/11/2022,01ED-Wimco Nagar Depot Metro,101490,83105,100,1720,24138,0,0,127448,0,0,0,0,2750,2750,2180,639,2819,1860,444,2304,1844,11,0,0,0,6,37,594,648
1,28/11/2022,01EF-Wimco Nagar Metro,139359,135241,100,3408,30580,0,0,173447,0,0,0,0,500,500,3553,862,4415,3103,950,4053,3234,34,128,2,0,8,91,744,1007
1,28/11/2022,01F1-Thiruvotriyur Metro,142177,105718,0,2256,20948,0,0,165381,0,0,0,0,0,0,2925,621,3546,2845,558,3403,2831,29,1,2,0,2,54,552,640
1,28/11/2022,01F3-Thiruvotriyur Theradi Metro,118206,124777,100,2152,30526,0,0,150984,0,0,0,0,0,0,2978,900,3878,3171,927,4098,3205,11,56,1,0,4,69,819,960
1,28/11/2022,01F5-Kaladipet Metro,138356,103881,1060,2032,23010,0,0,164458,0,0,0,0,0,0,3024,761,3785,3022,695,3717,2995,20,0,0,1,5,48,709,783
1,28/11/2022,01F7-Tollgate Metro,72372,56198,1000,504,12650,0,0,86526,0,0,0,0,0,0,1667,408,2075,1611,413,2024,1594,25,1,0,0,6,16,374,422
1,28/11/2022,01F9-New Washermenpet Metro,107543,95258,600,1144,19268,0,0,128555,0,0,0,0,500,500,2904,667,3571,2953,716,3669,2987,18,62,2,0,0,42,624,748
1,28/11/2022,01FB-Tondiarpet Metro,112111,100629,0,1760,25216,0,0,139087,0,0,0,0,1250,1250,2986,846,3832,2978,883,3861,2940,26,0,2,0,2,47,795,872
1,28/11/2022,01FD-Thiagaraya College Metro,130860,117938,0,1280,24582,0,0,156722,0,0,0,0,1500,1500,3661,880,4541,3764,933,4697,3799,48,59,0,0,3,44,822,976
1,28/11/2022,0101-Washermanpet,115201,130470,1720,2840,41174,0,0,160935,0,0,0,0,15500,15500,3831,1422,5253,3519,1275,4794,3608,23,111,4,0,8,89,1313,1548
1,28/11/2022,0103-Mannadi,92736,110722,1200,1096,30386,0,0,125418,0,0,0,0,0,0,3078,1052,4130,3379,1034,4413,3405,20,84,0,0,3,44,991,1142
1,28/11/2022,0105-High Court,142932,246627,1210,2928,69232,0,0,216302,0,0,0,0,0,0,6901,2459,9360,7236,2135,9371,7313,33,181,0,0,3,109,2289,2615
1,28/11/2022,0109-Government Estate,111596,160038,800,2880,50528,0,0,165804,0,0,0,0,6750,6750,4181,1825,6006,4644,1854,6498,4845,27,255,4,0,4,116,1635,2041
1,28/11/2022,0111-LIC,109583,181534,1250,2616,31144,0,0,144593,0,0,0,0,0,0,5202,1164,6366,6085,1162,7247,6060,28,0,7,0,3,111,1017,1166
1,28/11/2022,0113-Thousand Lights,180177,259937,7740,5176,43724,0,0,236817,0,0,0,0,1250,1250,7702,1703,9405,8727,1747,10474,8684,29,0,2,0,2,212,1388,1633
1,28/11/2022,0115-AG-DMS,122010,149065,200,2240,25728,0,0,150178,0,0,0,0,500,500,4681,936,5617,4699,864,5563,4855,24,188,0,0,1,89,810,1112
1,28/11/2022,0117-Teynampet,119074,143652,3660,1704,27284,0,0,151722,0,0,0,0,250,250,4361,1057,5418,4992,1063,6055,4908,31,1,1,0,2,75,929,1039
1,28/11/2022,0119-Nandanam,118868,136240,3579,1936,29282,0,0,153665,0,0,0,0,500,500,3978,1110,5088,4641,1100,5741,4566,29,0,4,0,1,83,971,1088
1,28/11/2022,0121-Saidapet,59797,90279,0,1672,25752,0,0,87221,0,0,0,0,4500,4500,2023,923,2946,2658,892,3550,2604,17,0,3,0,1,69,836,926
1,28/11/2022,0123-Little Mount,102283,103158,800,1816,24214,0,0,129113,0,0,0,0,1000,1000,3643,925,4568,3092,791,3883,3208,20,166,2,0,0,79,790,1057
1,28/11/2022,0125-Guindy,152671,274371,2398,7232,77260,0,0,239561,0,0,0,0,1500,1500,8071,2795,10866,7474,2680,10154,7873,38,447,3,0,0,250,2428,3166
1,28/11/2022,0129-Nanganallur Road,67507,49619,300,984,12790,0,0,81581,0,0,0,0,0,0,1308,404,1712,1428,375,1803,1406,6,0,1,0,2,32,359,400
1,28/11/2022,0131-Meenambakkam,155833,139108,50,1520,38066,0,0,195469,0,0,0,0,0,0,4015,1065,5080,3280,920,4200,3421,32,208,4,0,5,52,1001,1302
1,28/11/2022,0133-Chennai International Airport,208638,333419,2400,9952,136998,0,0,357988,0,0,0,0,9000,9000,6502,3892,10394,5443,4053,9496,6297,66,1025,29,0,19,308,3366,4813
2,28/11/2022,0201-Puratchi Thalaivar Dr. M.G. Ramachandran Central,259120,494769,1130,18424,214294,0,0,492968,0,0,0,0,10550,10550,13146,7896,21042,11145,7233,18378,12140,97,1330,17,0,19,705,6915,9083
2,28/11/2022,0203-Egmore,86454,133663,50,3920,65688,0,0,156112,0,0,0,0,16250,16250,2828,2389,5217,2727,2663,5390,2839,26,391,7,0,10,161,2200,2795
2,28/11/2022,0205-Nehru Park,43076,45812,0,848,14882,0,0,58806,0,0,0,0,3000,3000,1352,549,1901,1304,492,1796,1334,14,67,2,0,2,35,496,616
2,28/11/2022,0207-Kilpauk,44776,61252,0,1272,17974,0,0,64022,0,0,0,0,0,0,1586,689,2275,1699,741,2440,1741,15,108,0,0,1,56,591,771
2,28/11/2022,0209-Pachaiyappas College,50994,53006,0,600,14040,0,0,65634,0,0,0,0,8000,8000,1774,551,2325,1638,470,2108,1657,15,87,1,0,0,29,508,640
2,28/11/2022,0211-Shenoy Nagar,37832,53640,0,832,14052,0,0,52716,0,0,0,0,0,0,1365,514,1879,1580,498,2078,1602,9,79,0,0,1,36,466,591
2,28/11/2022,0213-Anna Nagar East,87099,118300,800,2312,29154,0,0,119365,0,0,0,0,1500,1500,3298,1068,4366,3461,1053,4514,3534,16,158,2,0,2,86,956,1220
2,28/11/2022,0215-Anna Nagar Tower,118694,105403,200,1920,21734,0,0,142548,0,0,0,0,12750,12750,3068,829,3897,3116,902,4018,3249,20,227,0,0,2,74,735,1058
2,28/11/2022,0217-Thirumangalam,302157,324447,1260,7552,76508,0,0,387477,0,0,0,0,0,0,8918,2712,11630,8982,2825,11807,9332,51,592,9,0,6,286,2329,3273
2,28/11/2022,0219-Koyambedu,229374,254110,1150,4976,88960,0,0,324460,0,0,0,5000,15000,20000,6548,3037,9585,5588,2349,7937,6087,40,652,5,0,6,207,2733,3643
2,28/11/2022,0221-Puratchi Thalaivi Dr. J. Jayalalithaa CMBT,98051,199529,822,4504,91780,0,0,195157,0,0,0,0,0,0,3473,3077,6550,3510,3452,6962,4069,26,876,27,0,7,187,2815,3938
2,28/11/2022,0223-Arumbakkam,71566,62888,500,1272,21872,0,0,95210,0,0,0,0,7250,7250,1730,800,2530,1776,697,2473,1701,13,1,1,0,1,51,717,784
2,28/11/2022,0225-Vadapalani,147421,200379,0,5224,65310,0,0,217955,0,0,0,0,8500,8500,4736,2315,7051,5021,2346,7367,5247,54,472,3,0,9,205,2001,2744
2,28/11/2022,0227-Ashok Nagar,105315,153484,200,4744,47986,0,0,158245,0,0,0,0,3000,3000,3844,1725,5569,3985,1673,5658,4149,27,254,3,0,0,150,1462,1896
2,28/11/2022,0229-Ekkattuthangal,107614,143071,2650,3816,24278,0,0,138358,0,0,0,0,0,0,4078,957,5035,4511,1192,5703,4728,26,352,1,0,6,143,749,1277
2,28/11/2022,0231-Arignar Anna Alandur,200300,206052,0,5048,56884,0,0,262232,0,0,0,0,7250,7250,5895,1988,7883,5452,1813,7265,5802,52,445,7,0,7,188,1726,2425
2,28/11/2022,0233-St. Thomas Mount,95536,110964,100,2976,32346,0,0,130958,0,0,0,3400,5700,9100,3102,1127,4229,3020,1016,4036,3071,20,159,2,0,2,111,972,1266
1,29/11/2022,01ED-Wimco Nagar Depot Metro,84270,77270,0,976,20858,0,0,106104,0,0,0,0,5750,5750,2186,541,2727,1789,389,2178,1787,8,7,3,0,7,28,506,559
1,29/11/2022,01EF-Wimco Nagar Metro,128170,127397,670,3032,28578,0,0,160450,0,0,0,0,3250,3250,3318,814,4132,3044,778,3822,3106,35,50,2,0,7,91,709,894
1,29/11/2022,01F1-Thiruvotriyur Metro,125201,101351,0,1864,18720,0,0,145785,0,0,0,0,0,0,2897,559,3456,2757,452,3209,2767,23,0,2,0,1,57,501,584
1,29/11/2022,01F3-Thiruvotriyur Theradi Metro,104631,117990,650,2136,27226,0,0,134643,0,0,0,0,0,0,2888,783,3671,3098,779,3877,3134,29,33,3,0,1,54,710,830
1,29/11/2022,01F5-Kaladipet Metro,117347,101782,600,1232,22420,0,0,141599,0,0,0,0,0,0,3052,693,3745,2959,613,3572,2944,24,0,3,0,2,41,637,707
1,29/11/2022,01F7-Tollgate Metro,60455,53177,100,1928,12182,0,0,74665,0,0,0,0,1000,1000,1618,401,2019,1489,394,1883,1504,12,0,1,0,5,30,366,414
1,29/11/2022,01F9-New Washermenpet Metro,88772,91828,1500,1112,19932,0,0,111316,0,0,0,0,500,500,2914,664,3578,2826,684,3510,2858,16,41,2,0,2,40,621,722
1,29/11/2022,01FB-Tondiarpet Metro,97085,98654,190,1400,23560,0,0,122235,0,0,0,0,0,0,2995,785,3780,2950,760,3710,2958,22,1,0,0,2,50,728,803
1,29/11/2022,01FD-Thiagaraya College Metro,112301,110804,200,2144,21926,0,0,136571,0,0,0,0,500,500,3528,794,4322,3587,842,4429,3666,58,55,4,0,1,63,721,902
1,29/11/2022,0101-Washermanpet,123504,122456,617,2728,35804,0,0,162653,0,0,0,0,18250,18250,3691,1283,4974,3417,1224,4641,3535,19,110,1,0,2,95,1165,1392
1,29/11/2022,0103-Mannadi,75008,107649,0,1248,29916,0,0,106172,0,0,0,0,0,0,3048,1075,4123,3260,1009,4269,3300,15,68,2,0,1,50,1006,1142
1,29/11/2022,0105-High Court,154867,259205,100,3200,72674,0,0,230841,0,0,0,0,0,0,7367,2559,9926,7499,2244,9743,7678,27,221,2,0,3,146,2351,2750
1,29/11/2022,0109-Government Estate,98627,152535,2350,2504,43342,0,0,146823,0,0,0,0,500,500,4218,1629,5847,4606,1716,6322,4816,19,273,1,1,2,110,1457,1863
1,29/11/2022,0111-LIC,102033,179148,2400,2960,29222,0,0,136615,0,0,0,0,0,0,5213,1094,6307,6002,930,6932,6045,16,4,0,0,1,124,925,1070
1,29/11/2022,0113-Thousand Lights,161936,255762,4972,5432,39618,0,0,211958,0,0,0,0,1000,1000,7899,1577,9476,8674,1537,10211,8710,42,4,1,0,4,225,1242,1518
1,29/11/2022,0115-AG-DMS,111458,144073,2200,2328,24130,0,0,140116,0,0,0,0,0,0,4544,869,5413,4585,798,5383,4762,17,173,2,0,0,74,735,1001
1,29/11/2022,0117-Teynampet,94882,137515,3200,1560,24334,0,0,123976,0,0,0,0,0,0,4242,947,5189,4814,1042,5856,4785,22,0,3,0,1,67,836,929
1,29/11/2022,0119-Nandanam,93654,135232,2050,2216,27688,0,0,125608,0,0,0,0,250,250,4110,1074,5184,4692,938,5630,4669,26,0,2,0,0,94,929,1051
1,29/11/2022,0121-Saidapet,62638,85545,100,1240,24252,0,0,88230,0,0,0,0,4250,4250,2099,889,2988,2499,816,3315,2486,14,0,1,1,1,56,824,897
1,29/11/2022,0123-Little Mount,97222,99721,2100,2896,21760,0,0,123978,0,0,0,0,250,250,3689,876,4565,3065,687,3752,3187,11,155,0,0,3,89,731,989
1,29/11/2022,0125-Guindy,146675,265013,550,6440,72808,0,0,226473,0,0,0,0,1500,1500,7971,2630,10601,7424,2316,9740,7707,39,294,8,0,1,259,2265,2866
1,29/11/2022,0129-Nanganallur Road,48196,48816,1100,304,11750,0,0,61350,0,0,0,0,0,0,1372,365,1737,1453,333,1786,1420,7,0,0,0,2,12,338,359
1,29/11/2022,0131-Meenambakkam,136990,132584,1210,2392,32914,0,0,173506,0,0,0,0,0,0,3894,968,4862,3264,860,4124,3420,23,174,0,1,3,78,902,1181
1,29/11/2022,0133-Chennai International Airport,169255,316597,3630,10448,137218,0,0,320551,0,0,0,0,7500,7500,5895,3875,9770,5328,3738,9066,5815,52,697,6,0,7,261,3372,4395
2,29/11/2022,0201-Puratchi Thalaivar Dr. M.G. Ramachandran Central,228132,439441,1510,13000,178770,0,0,421412,0,0,0,0,6150,6150,11801,6559,18360,10794,7017,17811,11529,108,969,7,0,9,537,5811,7441
2,29/11/2022,0203-Egmore,74111,129797,100,3576,64330,0,0,142117,0,0,0,0,8500,8500,2494,2284,4778,2528,2530,5058,2712,20,369,6,0,4,140,2099,2638
2,29/11/2022,0205-Nehru Park,35390,45324,200,1120,12752,0,0,49462,0,0,0,0,2000,2000,1385,485,1870,1317,447,1764,1377,8,99,0,0,0,41,437,585
2,29/11/2022,0207-Kilpauk,43415,58070,300,616,16912,0,0,61243,0,0,0,0,1500,1500,1562,609,2171,1613,589,2202,1665,9,80,0,0,1,30,563,683
2,29/11/2022,0209-Pachaiyappas College,64631,50828,0,896,12664,0,0,78191,0,0,0,0,18000,18000,1744,503,2247,1552,483,2035,1612,9,91,2,0,1,36,454,593
2,29/11/2022,0211-Shenoy Nagar,45696,49068,300,1032,11960,0,0,58988,0,0,0,0,2000,2000,1361,461,1822,1436,502,1938,1525,6,96,0,0,0,40,403,545
2,29/11/2022,0213-Anna Nagar East,101825,114874,0,2368,26600,0,0,130793,0,0,0,0,3000,3000,3336,1019,4355,3458,984,4442,3568,33,172,3,0,0,92,899,1199
2,29/11/2022,0215-Anna Nagar Tower,83222,105771,0,1720,24556,0,0,109498,0,0,0,0,250,250,3022,906,3928,3034,822,3856,3153,20,183,0,0,0,71,800,1074
2,29/11/2022,0217-Thirumangalam,288953,319460,2000,9328,74462,0,0,374743,0,0,0,0,0,0,8987,2676,11663,8926,2760,11686,9310,53,474,5,0,2,296,2306,3136
2,29/11/2022,0219-Koyambedu,184569,233910,3910,4864,75910,0,0,269253,0,0,0,0,10000,10000,6143,2634,8777,5496,2185,7681,5840,39,464,4,0,2,196,2368,3073
2,29/11/2022,0221-Puratchi Thalaivi Dr. J. Jayalalithaa CMBT,62599,163153,1150,2616,77022,0,0,143387,0,0,0,0,0,0,2627,2564,5191,3423,3304,6727,3414,17,336,7,0,6,111,2401,2878
2,29/11/2022,0223-Arumbakkam,54339,62933,150,1424,21306,0,0,77219,0,0,0,0,4250,4250,1676,803,2479,1763,663,2426,1717,18,4,7,0,1,59,721,810
2,29/11/2022,0225-Vadapalani,142488,218213,1200,6192,74430,0,0,224310,0,0,0,0,2000,2000,5213,2654,7867,5092,2723,7815,5599,32,622,4,0,7,257,2305,3227
2,29/11/2022,0227-Ashok Nagar,96289,144167,620,3568,44756,0,0,145233,0,0,0,0,0,0,3788,1582,5370,3813,1424,5237,3933,22,195,1,0,1,127,1390,1736
2,29/11/2022,0229-Ekkattuthangal,105240,146074,1332,3768,27112,0,0,137452,0,0,0,0,0,0,4317,1064,5381,4489,1058,5547,4786,27,322,2,0,1,168,822,1342
2,29/11/2022,0231-Arignar Anna Alandur,167654,197698,860,3808,52372,0,0,224694,0,0,0,0,4250,4250,5870,1838,7708,5345,1712,7057,5660,40,401,4,0,4,149,1585,2183
2,29/11/2022,0233-St. Thomas Mount,97807,107056,325,2672,31306,0,0,132110,0,0,0,7000,4300,11300,3073,1104,4177,2924,925,3849,3006,24,115,2,0,1,104,947,1193
1,30/11/2022,01ED-Wimco Nagar Depot Metro,80355,77941,500,912,21492,0,0,103259,0,0,0,0,4750,4750,2220,544,2764,1800,367,2167,1777,14,6,2,0,5,25,519,571
1,30/11/2022,01EF-Wimco Nagar Metro,131698,127554,700,3248,27734,0,0,163380,0,0,0,0,0,0,3288,797,4085,3058,831,3889,3126,37,55,1,0,6,99,682,880
1,30/11/2022,01F1-Thiruvotriyur Metro,125559,101185,50,944,18818,0,0,145371,0,0,0,0,0,0,2968,531,3499,2749,511,3260,2753,30,21,0,0,2,32,506,591
1,30/11/2022,01F3-Thiruvotriyur Theradi Metro,105621,119639,0,1384,28610,0,0,135615,0,0,0,0,0,0,2973,814,3787,3084,795,3879,3110,13,72,1,0,2,44,757,889
1,30/11/2022,01F5-Kaladipet Metro,119649,97777,100,1248,19378,0,0,140375,0,0,0,0,0,0,3085,634,3719,2913,575,3488,2922,21,7,1,0,2,47,577,655
1,30/11/2022,01F7-Tollgate Metro,63766,55331,0,1048,12362,0,0,77176,0,0,0,0,0,0,1644,406,2050,1586,362,1948,1581,25,12,1,0,4,25,363,430
1,30/11/2022,01F9-New Washermenpet Metro,111366,96324,0,992,20170,0,0,132528,0,0,0,0,1250,1250,3000,673,3673,2976,665,3641,3013,16,78,2,0,5,33,639,773
1,30/11/2022,01FB-Tondiarpet Metro,94117,103321,700,1616,26514,0,0,122947,0,0,0,0,500,500,2997,878,3875,3029,791,3820,3012,13,9,2,0,7,57,810,898
1,30/11/2022,01FD-Thiagaraya College Metro,98672,115249,190,1632,24534,0,0,125028,0,0,0,0,2000,2000,3643,898,4541,3658,914,4572,3713,52,52,0,0,6,60,820,990
1,30/11/2022,0101-Washermanpet,116882,123820,297,2048,34712,0,0,153939,0,0,0,0,11250,11250,3800,1200,5000,3485,1171,4656,3589,23,139,0,0,6,73,1098,1339
1,30/11/2022,0103-Mannadi,87709,105292,1000,1864,27024,0,0,117597,0,0,0,0,0,0,3054,978,4032,3243,971,4214,3279,19,89,0,0,0,48,912,1068
1,30/11/2022,0105-High Court,164493,240268,0,2864,64940,0,0,232297,0,0,0,0,0,0,6942,2309,9251,7054,2006,9060,7202,30,238,1,0,2,115,2138,2524
1,30/11/2022,0109-Government Estate,108965,153334,450,2560,43068,0,0,155043,0,0,0,0,500,500,4224,1584,5808,4624,1664,6288,4844,11,296,2,0,0,111,1414,1834
1,30/11/2022,0111-LIC,117927,180510,58,2312,31448,0,0,151745,0,0,0,0,0,0,5234,1176,6410,6009,980,6989,6006,15,4,0,0,3,103,1032,1157
1,30/11/2022,0113-Thousand Lights,209324,266201,1631,5224,45356,0,0,261535,0,0,0,0,0,0,7960,1737,9697,8860,1565,10425,8863,24,13,1,0,6,210,1433,1687
1,30/11/2022,0115-AG-DMS,128692,143981,1070,2064,24708,0,0,156534,0,0,0,0,3000,3000,4552,900,5452,4589,714,5303,4728,18,179,1,0,0,84,770,1052
1,30/11/2022,0117-Teynampet,124981,142109,1100,2040,27584,0,0,155705,0,0,0,0,0,0,4269,1077,5346,4880,1011,5891,4849,16,12,0,0,2,79,943,1052
1,30/11/2022,0119-Nandanam,118711,140188,1300,1992,29810,0,0,151813,0,0,0,0,250,250,4244,1153,5397,4781,930,5711,4736,25,8,0,0,4,89,1005,1131
1,30/11/2022,0121-Saidapet,60366,87043,100,1096,25000,0,0,86562,0,0,0,0,4250,4250,2108,871,2979,2567,818,3385,2513,14,2,2,1,1,52,810,882
1,30/11/2022,0123-Little Mount,108854,105896,800,3032,25072,0,0,137758,0,0,0,0,250,250,3744,1022,4766,3107,754,3861,3292,23,170,0,0,5,114,824,1136
1,30/11/2022,0125-Guindy,168614,264484,700,8104,69806,0,0,247224,0,0,0,0,1500,1500,8108,2605,10713,7464,2384,9848,7849,32,404,4,0,1,265,2194,2900
1,30/11/2022,0129-Nanganallur Road,60986,50545,900,864,12534,0,0,75284,0,0,0,0,0,0,1416,391,1807,1482,373,1855,1457,6,4,0,1,1,21,360,393
1,30/11/2022,0131-Meenambakkam,133997,134805,3140,3056,34768,0,0,174961,0,0,0,0,0,0,3884,1005,4889,3237,840,4077,3410,16,207,3,0,2,69,935,1232
1,30/11/2022,0133-Chennai International Airport,195289,321367,1000,9112,134542,0,0,339943,0,0,0,0,6000,6000,6183,3855,10038,5566,3746,9312,5998,56,812,10,0,7,269,3350,4504
2,30/11/2022,0201-Puratchi Thalaivar Dr. M.G. Ramachandran Central,236366,453825,1850,12592,177738,0,0,428546,0,0,0,0,5200,5200,12199,6566,18765,11312,7046,18358,12060,100,1295,9,0,22,504,5844,7774
2,30/11/2022,0203-Egmore,108136,133875,0,2832,55610,0,0,166578,0,0,0,0,30500,30500,2817,2024,4841,2858,2621,5479,3176,19,637,16,1,8,117,1874,2672
2,30/11/2022,0205-Nehru Park,44801,46503,250,1000,13176,0,0,59227,0,0,0,0,2250,2250,1452,498,1950,1345,469,1814,1407,13,108,1,0,1,41,447,611
2,30/11/2022,0207-Kilpauk,43637,60704,0,1144,17534,0,0,62315,0,0,0,0,0,0,1640,652,2292,1695,586,2281,1744,9,64,0,0,2,51,577,703
2,30/11/2022,0209-Pachaiyappas College,55519,49776,0,800,12102,0,0,68421,0,0,0,0,5000,5000,1764,480,2244,1528,493,2021,1595,17,91,1,0,0,34,427,570
2,30/11/2022,0211-Shenoy Nagar,45436,50036,100,680,12078,0,0,58294,0,0,0,0,1000,1000,1429,451,1880,1537,479,2016,1564,10,70,0,0,3,29,420,532
2,30/11/2022,0213-Anna Nagar East,100897,115362,250,2456,27060,0,0,130663,0,0,0,0,0,0,3303,1051,4354,3328,1001,4329,3477,20,185,0,0,10,104,898,1217
2,30/11/2022,0215-Anna Nagar Tower,93740,108376,0,1864,24546,0,0,120150,0,0,0,0,750,750,3039,889,3928,3121,852,3973,3242,20,233,0,0,1,76,788,1118
2,30/11/2022,0217-Thirumangalam,306962,327589,2672,9320,78732,0,0,397686,0,0,0,0,0,0,9098,2838,11936,9001,2748,11749,9350,51,535,8,0,6,316,2417,3333
2,30/11/2022,0219-Koyambedu,204975,240389,800,7648,78308,0,0,291731,0,0,0,0,12750,12750,6192,2714,8906,5646,2124,7770,5951,38,472,4,0,11,193,2421,3139
2,30/11/2022,0221-Puratchi Thalaivi Dr. J. Jayalalithaa CMBT,84787,170423,800,3488,69476,0,0,158551,0,0,0,0,0,0,2943,2336,5279,3678,3468,7146,3880,14,588,3,0,18,122,2150,2895
2,30/11/2022,0223-Arumbakkam,68367,64976,100,1288,22722,0,0,92477,0,0,0,0,7500,7500,1800,820,2620,1813,659,2472,1756,25,10,1,0,1,51,759,847
2,30/11/2022,0225-Vadapalani,128856,203349,100,5368,69632,0,0,203956,0,0,0,0,7000,7000,4832,2432,7264,4985,2473,7458,5238,31,496,4,0,5,184,2159,2879
2,30/11/2022,0227-Ashok Nagar,102643,143750,630,3560,45602,0,0,152435,0,0,0,0,1500,1500,3814,1623,5437,3731,1462,5193,3891,29,233,1,0,2,137,1382,1784
2,30/11/2022,0229-Ekkattuthangal,102548,143812,1200,3408,25818,0,0,132974,0,0,0,0,250,250,4224,1017,5241,4483,968,5451,4740,15,318,4,0,4,133,801,1275
2,30/11/2022,0231-Arignar Anna Alandur,188003,200465,1300,4944,53804,0,0,248051,0,0,0,0,2500,2500,5951,1853,7804,5338,1721,7059,5700,35,473,1,0,1,147,1585,2242
2,30/11/2022,0233-St. Thomas Mount,87546,104928,300,4144,30058,0,0,122048,0,0,0,3000,7900,10900,3007,1081,4088,2884,881,3765,2955,14,109,4,0,0,111,911,1149
1,01/12/2022,01ED-Wimco Nagar Depot Metro,104081,80390,0,1032,24036,0,0,129149,0,0,0,0,2250,2250,2181,622,2803,1815,423,2238,1797,9,0,8,0,5,30,589,641
1,01/12/2022,01EF-Wimco Nagar Metro,161245,129265,0,2632,30708,0,0,194585,0,0,0,0,3000,3000,3376,856,4232,3025,746,3771,3101,45,81,3,0,6,76,759,970
1,01/12/2022,01F1-Thiruvotriyur Metro,138561,97130,0,1024,18352,0,0,157937,0,0,0,0,0,0,2906,517,3423,2699,467,3166,2666,25,0,3,0,2,32,487,549
1,01/12/2022,01F3-Thiruvotriyur Theradi Metro,145177,123465,2500,2440,30028,0,0,180145,0,0,0,0,0,0,2973,895,3868,3163,837,4000,3194,25,26,3,0,5,78,805,942
1,01/12/2022,01F5-Kaladipet Metro,130466,101081,500,2000,21888,0,0,154854,0,0,0,0,0,0,3070,702,3772,2946,588,3534,2942,23,0,0,0,2,59,629,713
1,01/12/2022,01F7-Tollgate Metro,86222,59103,100,584,16084,0,0,102990,0,0,0,0,0,0,1655,492,2147,1628,427,2055,1578,21,3,0,0,7,18,453,502
1,01/12/2022,01F9-New Washermenpet Metro,136360,96058,200,1816,20960,0,0,159336,0,0,0,0,250,250,2963,677,3640,2914,691,3605,2947,16,64,0,0,6,33,639,758
1,01/12/2022,01FB-Tondiarpet Metro,143648,100341,500,2264,24202,0,0,170614,0,0,0,0,500,500,3030,824,3854,2983,848,3831,3004,18,28,1,0,4,51,764,866
1,01/12/2022,01FD-Thiagaraya College Metro,122560,114455,150,1840,25964,0,0,150514,0,0,0,0,1750,1750,3480,914,4394,3599,855,4454,3623,36,22,0,0,3,70,825,956
1,01/12/2022,0101-Washermanpet,132585,125387,700,1912,37860,0,0,173057,0,0,0,0,12250,12250,3874,1333,5207,3491,1197,4688,3550,22,135,0,0,7,74,1223,1461
1,01/12/2022,0103-Mannadi,107618,104454,100,1536,25832,0,0,135086,0,0,0,0,7500,7500,3045,935,3980,3335,931,4266,3322,22,91,0,0,2,54,864,1033
1,01/12/2022,0105-High Court,179906,280897,200,3432,89802,0,0,273340,0,0,0,0,0,0,7541,3197,10738,7559,2628,10187,7787,26,372,1,0,5,149,2990,3543
1,01/12/2022,0109-Government Estate,126666,158619,1700,2000,43680,0,0,174046,0,0,0,0,1000,1000,4469,1627,6096,4641,1847,6488,5003,27,454,3,0,2,95,1440,2021
1,01/12/2022,0111-LIC,124955,178164,1494,2600,28562,0,0,157611,0,0,0,0,1000,1000,5310,1051,6361,5906,1034,6940,6010,17,99,0,0,3,109,912,1140
1,01/12/2022,0113-Thousand Lights,254517,262624,1520,5664,45742,0,0,307443,0,0,0,0,0,0,7917,1766,9683,8747,1564,10311,8761,57,0,0,0,6,221,1451,1735
1,01/12/2022,0115-AG-DMS,145122,147944,500,2264,29516,0,0,177402,0,0,0,0,3250,3250,4468,1054,5522,4515,790,5305,4676,26,180,1,0,3,92,915,1217
1,01/12/2022,0117-Teynampet,130191,146793,1300,2408,31366,0,0,165265,0,0,0,0,0,0,4303,1218,5521,4912,1115,6027,4890,28,0,3,0,4,97,1056,1188
1,01/12/2022,0119-Nandanam,128322,134222,200,2384,26700,0,0,157606,0,0,0,0,1250,1250,4206,1055,5261,4629,950,5579,4628,29,5,0,0,0,95,897,1026
1,01/12/2022,0121-Saidapet,83212,87602,50,1168,25216,0,0,109646,0,0,0,0,4000,4000,2100,914,3014,2556,791,3347,2521,22,0,0,0,2,54,846,924
1,01/12/2022,0123-Little Mount,129891,102262,600,2656,23370,0,0,156517,0,0,0,0,2250,2250,3660,924,4584,3022,708,3730,3198,13,202,0,0,0,102,786,1103
1,01/12/2022,0125-Guindy,184895,274008,1284,8384,80744,0,0,275307,0,0,0,0,0,0,8045,2925,10970,7340,2459,9799,7738,33,361,2,0,4,274,2521,3195
1,01/12/2022,0129-Nanganallur Road,65194,50205,100,2216,12928,0,0,80438,0,0,0,0,0,0,1372,434,1806,1463,372,1835,1436,5,0,0,0,3,29,387,424
1,01/12/2022,0131-Meenambakkam,171474,136866,2000,3728,35226,0,0,212428,0,0,0,0,0,0,4011,1039,5050,3271,895,4166,3456,25,248,2,0,2,77,969,1323
1,01/12/2022,0133-Chennai International Airport,226175,321819,1620,8040,138664,0,0,374499,0,0,0,0,2250,2250,6033,3908,9941,5388,3952,9340,5898,58,823,11,3,14,254,3405,4568
2,01/12/2022,0201-Puratchi Thalaivar Dr. M.G. Ramachandran Central,283572,465729,1000,12368,192060,0,0,489000,0,0,0,0,8250,8250,11949,6930,18879,11554,7301,18855,11926,117,1132,8,0,13,434,6300,8004
2,01/12/2022,0203-Egmore,88307,137874,0,2568,64230,0,0,155105,0,0,0,0,22500,22500,2584,2289,4873,2903,2838,5741,3025,23,508,3,0,7,104,2140,2785
2,01/12/2022,0205-Nehru Park,53612,46137,0,1136,14188,0,0,68936,0,0,0,0,0,0,1437,533,1970,1284,456,1740,1368,22,97,0,0,1,43,472,635
2,01/12/2022,0207-Kilpauk,53711,60058,0,1032,16028,0,0,70771,0,0,0,0,0,0,1701,594,2295,1734,608,2342,1771,15,100,1,0,3,29,550,698
2,01/12/2022,0209-Pachaiyappas College,65748,50764,0,952,12336,0,0,79036,0,0,0,0,4500,4500,1741,487,2228,1589,403,1992,1640,13,77,1,0,1,39,435,566
2,01/12/2022,0211-Shenoy Nagar,54444,49385,0,600,11378,0,0,66422,0,0,0,0,0,0,1402,433,1835,1531,435,1966,1562,16,104,0,0,1,26,391,538
2,01/12/2022,0213-Anna Nagar East,119614,122268,400,2864,28758,0,0,151636,0,0,0,0,0,0,3515,1115,4630,3539,949,4488,3681,27,216,0,0,14,101,956,1314
2,01/12/2022,0215-Anna Nagar Tower,115625,109106,400,1576,25864,0,0,143465,0,0,0,0,1750,1750,3084,923,4007,3098,932,4030,3235,21,234,0,0,1,67,831,1154
2,01/12/2022,0217-Thirumangalam,365158,321448,220,9224,77634,0,0,452236,0,0,0,0,0,0,8983,2752,11735,8762,2503,11265,9164,59,603,7,0,2,281,2367,3319
2,01/12/2022,0219-Koyambedu,218617,243810,100,4160,81872,0,0,304749,0,0,0,10000,15750,25750,6246,2819,9065,5736,2353,8089,5983,43,501,5,0,16,165,2547,3277
2,01/12/2022,0221-Puratchi Thalaivi Dr. J. Jayalalithaa CMBT,74186,176781,1546,2872,80100,0,0,158704,0,0,0,0,0,0,2573,2607,5180,4007,3968,7975,3788,32,440,8,0,4,115,2447,3046
2,01/12/2022,0223-Arumbakkam,81375,72154,0,1184,28116,0,0,110675,0,0,0,0,13000,13000,1831,982,2813,1916,736,2652,1794,22,0,1,0,5,46,910,984
2,01/12/2022,0225-Vadapalani,202412,199832,2300,4136,65236,0,0,274084,0,0,0,0,66500,66500,4939,2264,7203,4907,2411,7318,5257,42,682,2,0,8,181,1984,2899
2,01/12/2022,0227-Ashok Nagar,129137,153452,900,3328,38144,0,0,171509,0,0,0,0,4000,4000,4304,1373,5677,3888,1534,5422,4397,29,659,3,0,2,134,1150,1977
2,01/12/2022,0229-Ekkattuthangal,143069,145490,2632,3632,27310,0,0,176643,0,0,0,0,0,0,4449,1030,5479,4335,944,5279,4722,28,462,0,0,3,146,827,1466
2,01/12/2022,0231-Arignar Anna Alandur,198500,205884,1450,4936,57038,0,0,261924,0,0,0,0,6250,6250,5902,1945,7847,5361,1805,7166,5769,46,520,4,0,3,167,1674,2414
2,01/12/2022,0233-St. Thomas Mount,105234,116000,1100,4048,34576,0,0,144958,0,0,0,3000,7250,10250,3107,1236,4343,3074,1001,4075,3153,19,132,2,0,7,137,1053,1350
1,02/12/2022,01ED-Wimco Nagar Depot Metro,93828,82137,200,1128,22990,0,0,118146,0,0,0,0,3750,3750,2236,457,2693,1885,398,2283,1864,13,53,1,0,6,31,561,665
1,02/12/2022,01EF-Wimco Nagar Metro,140762,134143,800,3248,32992,0,0,177802,0,0,0,0,500,500,3465,662,4127,3117,789,3906,3160,42,125,4,0,8,94,790,1063
1,02/12/2022,01F1-Thiruvotriyur Metro,150845,106699,500,1080,21902,0,0,174327,0,0,0,0,0,0,3061,405,3466,2876,448,3324,2819,42,39,1,0,5,34,590,711
1,02/12/2022,01F3-Thiruvotriyur Theradi Metro,133317,128312,3290,2336,30370,0,0,169313,0,0,0,0,0,0,3245,630,3875,3336,839,4175,3360,33,181,3,0,7,75,810,1109
1,02/12/2022,01F5-Kaladipet Metro,121699,102529,0,1896,23038,0,0,146633,0,0,0,0,0,0,3092,495,3587,3041,514,3555,2956,20,0,0,0,6,70,667,763
1,02/12/2022,01F7-Tollgate Metro,73355,54825,100,792,11058,0,0,85305,0,0,0,0,0,0,1713,262,1975,1586,311,1897,1597,33,58,2,0,9,27,329,458
1,02/12/2022,01F9-New Washermenpet Metro,125272,93632,3200,1176,18756,0,0,148404,0,0,0,0,250,250,2965,507,3472,2908,624,3532,2950,16,149,6,0,4,41,595,811
1,02/12/2022,01FB-Tondiarpet Metro,96001,104328,200,3408,28160,0,0,127769,0,0,0,0,250,250,3010,611,3621,3100,752,3852,3005,18,14,3,0,3,51,893,982
1,02/12/2022,01FD-Thiagaraya College Metro,122720,117848,700,1688,28238,0,0,153346,0,0,0,0,1000,1000,3657,647,4304,3728,818,4546,3686,34,109,1,0,4,62,905,1115
1,02/12/2022,0101-Washermanpet,148903,127529,1000,2832,37002,0,0,189737,0,0,0,0,32000,32000,3824,940,4764,3500,1027,4527,3614,22,277,0,0,5,88,1166,1558
1,02/12/2022,0103-Mannadi,104097,110723,1200,1408,24904,0,0,131609,0,0,0,0,1500,1500,3310,630,3940,3412,948,4360,3580,22,318,1,0,3,53,807,1204
1,02/12/2022,0105-High Court,176788,277003,700,3136,70856,0,0,251480,0,0,0,0,0,0,7930,1471,9401,7559,2469,10028,8278,37,1012,3,0,6,135,2349,3542
1,02/12/2022,0109-Government Estate,136583,165320,2000,2808,39906,0,0,181297,0,0,0,0,6500,6500,4887,1038,5925,4736,1666,6402,5278,39,773,0,0,3,123,1279,2217
1,02/12/2022,0111-LIC,123232,189035,800,2200,31356,0,0,157588,0,0,0,0,0,0,5549,643,6192,6014,1018,7032,6224,19,300,1,0,5,88,986,1399
1,02/12/2022,0113-Thousand Lights,191147,259554,1750,6104,38658,0,0,237659,0,0,0,0,3000,3000,8095,844,8939,8598,1447,10045,8827,33,310,0,0,9,234,1207,1793
1,02/12/2022,0115-AG-DMS,136233,138940,0,2304,23682,0,0,162219,0,0,0,0,250,250,4461,476,4937,4239,771,5010,4550,27,384,2,0,6,85,731,1235
1,02/12/2022,0117-Teynampet,130736,144492,1900,1864,25984,0,0,160484,0,0,0,0,0,0,4544,654,5198,4824,1015,5839,4957,29,257,2,0,4,84,876,1252
1,02/12/2022,0119-Nandanam,111902,139004,200,4776,28140,0,0,145018,0,0,0,0,0,0,4360,644,5004,4602,939,5541,4742,32,225,1,1,2,133,944,1338
1,02/12/2022,0121-Saidapet,52333,92736,800,2096,28882,0,0,84111,0,0,0,0,4000,4000,2203,632,2835,2604,754,3358,2578,12,85,2,0,1,82,934,1116
1,02/12/2022,0123-Little Mount,114728,107225,1038,2800,25300,0,0,143866,0,0,0,0,3000,3000,3899,589,4488,3012,710,3722,3295,31,357,2,0,2,106,843,1341
1,02/12/2022,0125-Guindy,186650,297502,940,7696,89372,0,0,284658,0,0,0,0,1500,1500,8573,2032,10605,7640,2219,9859,8204,39,904,3,1,5,322,2824,4098
1,02/12/2022,0129-Nanganallur Road,67132,50967,800,920,13040,0,0,81892,0,0,0,0,0,0,1350,257,1607,1566,345,1911,1470,9,0,0,0,1,35,393,438
1,02/12/2022,0131-Meenambakkam,153934,140362,2160,2016,43702,0,0,201812,0,0,0,0,0,0,3942,807,4749,3276,856,4132,3295,17,224,1,0,3,68,1155,1468
1,02/12/2022,0133-Chennai International Airport,240008,367149,1650,9648,126932,0,0,378238,0,0,0,0,3750,3750,7215,2576,9791,6842,3678,10520,7558,66,1763,17,0,11,302,3073,5232
2,02/12/2022,0201-Puratchi Thalaivar Dr. M.G. Ramachandran Central,271932,500077,2600,16344,185126,0,0,476002,0,0,0,0,4900,4900,12812,4964,17776,12708,7615,20323,13257,104,2264,24,0,24,560,6029,9005
2,02/12/2022,0203-Egmore,124696,160905,600,2904,61794,0,0,189994,0,0,0,0,19350,19350,3147,1631,4778,3950,2885,6835,3954,34,1012,7,0,5,116,2083,3257
2,02/12/2022,0205-Nehru Park,54724,48077,51,1520,13774,0,0,70069,0,0,0,0,4000,4000,1511,309,1820,1390,461,1851,1433,13,174,0,0,5,52,469,713
2,02/12/2022,0207-Kilpauk,49500,62648,450,888,19040,0,0,69878,0,0,0,0,0,0,1665,424,2089,1744,603,2347,1756,11,131,1,0,3,43,625,814
2,02/12/2022,0209-Pachaiyappas College,53850,49426,0,1040,11904,0,0,66794,0,0,0,0,10000,10000,1748,287,2035,1535,416,1951,1591,7,145,1,0,1,42,430,626
2,02/12/2022,0211-Shenoy Nagar,52891,51930,0,784,12232,0,0,65907,0,0,0,0,250,250,1498,288,1786,1533,445,1978,1591,12,154,0,0,2,33,398,599
2,02/12/2022,0213-Anna Nagar East,115004,120560,150,2808,28452,0,0,146414,0,0,0,0,3000,3000,3572,710,4282,3517,927,4444,3621,23,298,2,0,13,106,923,1365
2,02/12/2022,0215-Anna Nagar Tower,106159,108269,1000,2632,26558,0,0,136349,0,0,0,0,1000,1000,3091,626,3717,3024,877,3901,3164,22,335,0,0,2,72,868,1299
2,02/12/2022,0217-Thirumangalam,326113,333035,2800,11240,78054,0,0,418207,0,0,0,0,0,0,9556,1944,11500,9005,2469,11474,9537,70,1164,3,0,1,351,2389,3978
2,02/12/2022,0219-Koyambedu,208333,256653,2280,5408,85424,0,0,301445,0,0,0,0,9500,9500,6587,2110,8697,6152,2246,8398,6359,66,922,12,0,17,222,2689,3928
2,02/12/2022,0221-Puratchi Thalaivi Dr. J. Jayalalithaa CMBT,85813,214219,850,3136,71954,0,0,161753,0,0,0,0,0,0,3160,1768,4928,7220,5210,12430,5523,16,986,4,0,7,130,2229,3372
2,02/12/2022,0223-Arumbakkam,73740,75714,0,1296,30810,0,0,105846,0,0,0,0,8250,8250,1875,599,2474,2105,688,2793,1843,23,26,2,0,8,52,1016,1127
2,02/12/2022,0225-Vadapalani,155221,216083,643,5824,65936,0,0,227624,0,0,0,0,7500,7500,5423,1536,6959,5300,2512,7812,5798,33,1129,2,0,14,236,2054,3468
2,02/12/2022,0227-Ashok Nagar,116748,160183,2572,5176,44254,0,0,168750,0,0,0,0,0,0,4456,1164,5620,3999,1475,5474,4478,34,767,3,0,4,215,1386,2409
2,02/12/2022,0229-Ekkattuthangal,138507,151378,1300,4296,27118,0,0,171221,0,0,0,0,0,0,4734,566,5300,4098,942,5040,4859,12,873,1,0,5,180,806,1877
2,02/12/2022,0231-Arignar Anna Alandur,211434,223590,2292,5712,56436,0,0,275874,0,0,0,0,3000,3000,6526,1285,7811,5555,1774,7329,6347,42,1132,3,2,4,220,1667,3070
2,02/12/2022,0233-St. Thomas Mount,114187,123599,1020,3632,35876,0,0,154715,0,0,0,0,7700,7700,3493,883,4376,3086,909,3995,3362,22,502,4,0,2,133,1061,1724
1,03/12/2022,01ED-Wimco Nagar Depot Metro,90778,78240,600,2000,29348,0,0,122726,0,0,0,0,9250,9250,1950,715,2665,1540,470,2010,1538,15,45,2,0,7,59,701,829
1,03/12/2022,01EF-Wimco Nagar Metro,127843,127233,200,2936,37834,0,0,168813,0,0,0,0,250,250,3063,993,4056,2721,980,3701,2752,45,128,1,1,13,84,888,1160
1,03/12/2022,01F1-Thiruvotriyur Metro,107238,100632,100,2032,30118,0,0,139488,0,0,0,0,0,0,2733,825,3558,2400,668,3068,2356,41,0,1,0,15,64,771,892
1,03/12/2022,01F3-Thiruvotriyur Theradi Metro,103900,133425,10,4328,45394,0,0,153632,0,0,0,0,0,0,2899,1304,4203,3017,1099,4116,3022,21,138,1,1,9,107,1186,1463
1,03/12/2022,01F5-Kaladipet Metro,107208,98510,740,2208,29960,0,0,140116,0,0,0,0,0,0,2752,960,3712,2681,761,3442,2549,17,0,2,0,9,69,880,977
1,03/12/2022,01F7-Tollgate Metro,53871,63655,0,1200,25892,0,0,80963,0,0,0,0,0,0,1477,771,2248,1488,581,2069,1397,28,0,0,0,11,37,719,795
1,03/12/2022,01F9-New Washermenpet Metro,86686,90506,0,1904,28528,0,0,117118,0,0,0,0,750,750,2574,937,3511,2473,725,3198,2453,19,75,1,0,5,68,873,1041
1,03/12/2022,01FB-Tondiarpet Metro,87412,107003,0,2176,40144,0,0,129732,0,0,0,0,250,250,2638,1267,3905,2715,1099,3814,2598,17,41,5,0,11,78,1175,1327
1,03/12/2022,01FD-Thiagaraya College Metro,113093,130142,2310,3240,42286,0,0,160929,0,0,0,0,750,750,3438,1418,4856,3448,1262,4710,3470,68,187,0,0,2,110,1299,1666
1,03/12/2022,0101-Washermanpet,101523,127201,1400,2968,46872,0,0,152763,0,0,0,0,9000,9000,3303,1604,4907,3026,1572,4598,3177,21,319,1,0,12,112,1464,1929
1,03/12/2022,0103-Mannadi,75937,114868,540,2024,39860,0,0,118361,0,0,0,0,0,0,2804,1398,4202,3083,1236,4319,3128,8,193,2,0,7,79,1278,1567
1,03/12/2022,0105-High Court,112467,216212,900,4024,85862,0,0,203253,0,0,0,0,0,0,5013,2916,7929,5239,2252,7491,5279,26,332,0,0,10,163,2698,3229
1,03/12/2022,0109-Government Estate,95588,160501,1493,3616,56068,0,0,156765,0,0,0,0,750,750,3964,2059,6023,3993,1919,5912,4383,26,682,0,0,7,161,1812,2688
1,03/12/2022,0111-LIC,99141,133431,150,2624,32988,0,0,134903,0,0,0,0,1000,1000,3355,1150,4505,3969,1003,4972,3991,16,139,0,0,7,80,1029,1271
1,03/12/2022,0113-Thousand Lights,148638,201433,700,4720,50430,0,0,204488,0,0,0,0,250,250,5376,1536,6912,6081,1591,7672,6032,34,148,2,0,8,195,1579,1966
1,03/12/2022,0115-AG-DMS,79186,93547,140,2624,25630,0,0,107580,0,0,0,0,2000,2000,2463,923,3386,2416,781,3197,2625,19,294,4,0,2,95,782,1196
1,03/12/2022,0117-Teynampet,90647,114074,700,2584,33796,0,0,127727,0,0,0,0,3000,3000,3010,1252,4262,3381,1013,4394,3313,30,53,2,0,4,88,1114,1291
1,03/12/2022,0119-Nandanam,74466,100478,700,2184,35552,0,0,112902,0,0,0,0,0,0,2427,1219,3646,2725,884,3609,2691,19,76,0,0,10,77,1152,1334
1,03/12/2022,0121-Saidapet,51315,68598,100,1440,29950,0,0,82805,0,0,0,0,10250,10250,1288,1027,2315,1664,804,2468,1513,11,1,1,0,0,59,952,1024
1,03/12/2022,0123-Little Mount,75597,78463,1050,2136,28010,0,0,106793,0,0,0,0,4000,4000,2211,1034,3245,1813,711,2524,1950,16,258,1,0,4,85,916,1280
1,03/12/2022,0125-Guindy,149888,255937,300,8472,96470,0,0,255130,0,0,0,0,6000,6000,5850,3390,9240,5375,2890,8265,5976,46,1023,8,0,6,331,2945,4359
1,03/12/2022,0129-Nanganallur Road,49296,46012,100,1416,17180,0,0,67992,0,0,0,0,0,0,950,528,1478,1202,484,1686,1066,9,1,0,0,3,22,499,534
1,03/12/2022,0131-Meenambakkam,127692,139246,400,5112,51190,0,0,184394,0,0,0,0,0,0,3174,1471,4645,2668,1199,3867,2900,31,370,4,0,8,124,1359,1896
1,03/12/2022,0133-Chennai International Airport,233587,376560,1550,13296,148182,0,0,396615,0,0,0,0,3000,3000,6568,4266,10834,5632,4668,10300,6918,63,2254,42,0,18,394,3596,6367
2,03/12/2022,0201-Puratchi Thalaivar Dr. M.G. Ramachandran Central,256060,509833,150,16888,227552,0,0,500650,0,0,0,0,6550,6550,10841,8163,19004,10099,8567,18666,11308,96,2644,17,0,38,658,7209,10662
2,03/12/2022,0203-Egmore,79157,158701,230,3360,74478,0,0,157225,0,0,0,0,7500,7500,2549,2599,5148,3514,3518,7032,3361,22,723,10,0,17,127,2393,3292
2,03/12/2022,0205-Nehru Park,39829,50452,0,1120,19426,0,0,60375,0,0,0,0,2000,2000,1332,741,2073,1196,627,1823,1291,21,199,1,0,5,47,667,940
2,03/12/2022,0207-Kilpauk,38081,51186,400,1000,17492,0,0,56973,0,0,0,0,0,0,1244,647,1891,1336,649,1985,1352,15,126,2,0,2,45,588,778
2,03/12/2022,0209-Pachaiyappas College,49937,47506,0,992,14384,0,0,65313,0,0,0,0,10000,10000,1439,553,1992,1340,483,1823,1381,10,140,1,0,1,44,498,694
2,03/12/2022,0211-Shenoy Nagar,42614,46869,40,1584,14370,0,0,58608,0,0,0,0,2500,2500,1214,571,1785,1220,492,1712,1304,13,149,0,0,1,67,486,716
2,03/12/2022,0213-Anna Nagar East,83836,115248,515,2712,38930,0,0,125993,0,0,0,0,0,0,2991,1420,4411,2978,1046,4024,3014,19,305,0,0,4,118,1289,1735
2,03/12/2022,0215-Anna Nagar Tower,78986,104340,400,2416,30632,0,0,112434,0,0,0,0,250,250,2673,1126,3799,2589,1121,3710,2789,21,448,0,0,6,98,986,1559
2,03/12/2022,0217-Thirumangalam,272301,319147,900,10032,103812,0,0,387045,0,0,0,0,0,0,7779,3672,11451,6935,3425,10360,7849,65,1603,10,0,6,388,3163,5235
2,03/12/2022,0219-Koyambedu,179141,240176,1100,6480,105106,0,0,291827,0,0,0,0,4000,4000,5129,3649,8778,4545,2749,7294,4960,61,984,8,0,30,260,3254,4597
2,03/12/2022,0221-Puratchi Thalaivi Dr. J. Jayalalithaa CMBT,97237,226055,700,3880,80776,0,0,182593,0,0,0,0,0,0,3463,2751,6214,5657,6209,11866,5387,31,1478,9,0,15,163,2530,4226
2,03/12/2022,0223-Arumbakkam,71683,74034,300,2080,35768,0,0,109831,0,0,0,0,6000,6000,1573,1306,2879,1754,935,2689,1542,22,0,0,0,10,66,1212,1310
2,03/12/2022,0225-Vadapalani,138100,244314,200,10360,94192,0,0,242852,40,0,40,0,3500,3500,5132,3507,8639,4994,3418,8412,5705,41,1339,5,0,12,419,2925,4741
2,03/12/2022,0227-Ashok Nagar,97132,155690,100,4912,55830,0,0,157974,0,0,0,0,3000,3000,3715,2015,5730,3371,1799,5170,3863,42,818,1,0,3,215,1714,2793
2,03/12/2022,0229-Ekkattuthangal,74954,93245,360,3608,27590,0,0,106512,0,0,0,0,0,0,2534,1055,3589,2215,863,3078,2593,15,596,4,0,3,143,878,1639
2,03/12/2022,0231-Arignar Anna Alandur,173220,231302,620,7448,85122,0,0,266410,0,0,0,0,2750,2750,5259,2865,8124,4553,2628,7181,5250,62,1164,4,0,9,265,2460,3964
2,03/12/2022,0233-St. Thomas Mount,93459,126496,500,4976,48556,0,0,147491,0,0,0,3000,2300,5300,2795,1664,4459,2632,1421,4053,2857,28,499,4,0,8,171,1433,2143
1,04/12/2022,01ED-Wimco Nagar Depot Metro,58768,69522,0,1648,36710,0,0,97126,0,0,0,0,2250,2250,1083,935,2018,1047,662,1709,998,9,0,1,0,17,47,879,953
1,04/12/2022,01EF-Wimco Nagar Metro,62488,94011,100,1952,42992,0,0,107532,0,0,0,0,0,0,1524,1072,2596,1564,1198,2762,1550,48,75,1,0,36,59,993,1212
1,04/12/2022,01F1-Thiruvotriyur Metro,84835,88917,516,2336,39904,0,0,127591,0,0,0,0,0,0,1528,1049,2577,1600,956,2556,1545,56,0,3,0,17,68,983,1127
1,04/12/2022,01F3-Thiruvotriyur Theradi Metro,61629,124446,274,3832,66070,0,0,131805,0,0,0,0,0,0,1719,1814,3533,1991,1760,3751,1937,31,27,3,0,30,112,1648,1851
1,04/12/2022,01F5-Kaladipet Metro,59719,87418,600,2392,46140,0,0,108851,0,0,0,0,0,0,1377,1304,2681,1500,1166,2666,1445,14,6,0,0,5,72,1213,1310
1,04/12/2022,01F7-Tollgate Metro,38189,55016,0,1248,26028,0,0,65465,0,0,0,0,0,0,962,775,1737,1044,692,1736,1033,34,22,1,0,34,46,698,835
1,04/12/2022,01F9-New Washermenpet Metro,61006,68367,6,1560,31198,0,0,93770,0,0,0,0,1000,1000,1247,982,2229,1327,934,2261,1363,24,90,0,0,9,57,898,1078
1,04/12/2022,01FB-Tondiarpet Metro,50385,79384,0,2440,43650,0,0,96475,0,0,0,0,250,250,1237,1309,2546,1333,1200,2533,1308,22,5,2,0,9,78,1216,1332
1,04/12/2022,01FD-Thiagaraya College Metro,70176,103669,500,2312,52110,0,0,125098,0,0,0,0,1000,1000,1912,1588,3500,1940,1414,3354,1929,93,84,0,0,10,79,1488,1754
1,04/12/2022,0101-Washermanpet,74834,96220,50,1784,49650,0,0,126318,0,0,0,0,16500,16500,1721,1600,3321,1683,1531,3214,1730,22,189,0,0,24,66,1514,1815
1,04/12/2022,0103-Mannadi,48972,78459,0,1168,43284,0,0,93424,0,0,0,0,3000,3000,1292,1421,2713,1392,1384,2776,1376,8,169,0,0,13,51,1338,1579
1,04/12/2022,0105-High Court,34581,89147,0,1944,47182,0,0,83707,0,0,0,0,0,0,1552,1660,3212,1512,1365,2877,1663,5,262,2,0,14,81,1548,1912
1,04/12/2022,0109-Government Estate,53390,93746,1200,2488,44984,0,0,102062,0,0,0,0,5000,5000,1753,1619,3372,1669,1586,3255,1958,18,435,6,0,14,95,1457,2025
1,04/12/2022,0111-LIC,16814,54473,0,2000,29648,0,0,48462,0,0,0,0,2000,2000,774,1042,1816,1002,833,1835,963,8,1,0,0,7,68,916,1000
1,04/12/2022,0113-Thousand Lights,38923,74166,500,1936,38316,0,0,79675,0,0,0,0,0,0,1214,1303,2517,1634,1193,2827,1422,15,1,0,0,14,79,1188,1297
1,04/12/2022,0115-AG-DMS,28943,46647,300,1312,19594,0,0,50149,0,0,0,0,0,0,904,646,1550,811,653,1464,963,8,252,0,0,2,40,571,873
1,04/12/2022,0117-Teynampet,25382,49662,100,1000,23830,0,0,50312,0,0,0,0,2000,2000,788,835,1623,1135,873,2008,1009,15,0,1,0,9,43,774,842
1,04/12/2022,0119-Nandanam,21601,50086,200,1656,27490,0,0,50947,0,0,0,0,0,0,794,974,1768,941,777,1718,883,11,0,0,0,7,62,887,967
1,04/12/2022,0121-Saidapet,21689,48614,0,1336,29422,0,0,52447,0,0,0,0,6250,6250,610,975,1585,792,974,1766,715,9,0,2,0,0,50,922,983
1,04/12/2022,0123-Little Mount,41086,62446,280,2312,30088,0,0,73766,0,0,0,0,0,0,1275,1091,2366,1091,905,1996,1241,23,253,5,0,5,95,960,1341
1,04/12/2022,0125-Guindy,68693,192105,1400,6848,113474,0,0,190415,0,0,0,0,1500,1500,2663,3647,6310,2475,3311,5786,2786,22,596,3,0,5,230,3312,4168
1,04/12/2022,0129-Nanganallur Road,11921,30508,0,1416,16976,0,0,30313,0,0,0,0,0,0,366,526,892,522,427,949,470,4,0,0,0,5,37,481,527
1,04/12/2022,0131-Meenambakkam,59023,109365,700,3320,62474,0,0,125517,0,0,0,0,0,0,1483,1605,3088,1168,1298,2466,1431,24,358,0,0,12,92,1559,2045
1,04/12/2022,0133-Chennai International Airport,156964,340850,1400,13616,172586,0,0,344566,0,0,0,0,0,0,4213,4834,9047,3618,5287,8905,5004,58,1963,20,0,19,394,4036,6490
2,04/12/2022,0201-Puratchi Thalaivar Dr. M.G. Ramachandran Central,151524,435024,500,15864,281042,0,0,448930,0,0,0,0,2350,2350,5964,9664,15628,5191,8802,13993,5834,118,1518,9,0,63,579,8726,11013
2,04/12/2022,0203-Egmore,62146,132034,400,4176,73566,0,0,140288,0,0,0,0,7500,7500,1923,2636,4559,1868,3158,5026,2195,24,752,15,0,10,169,2395,3365
2,04/12/2022,0205-Nehru Park,19607,30868,0,752,16194,0,0,36553,0,0,0,0,2250,2250,619,584,1203,522,541,1063,601,15,138,0,0,3,29,527,712
2,04/12/2022,0207-Kilpauk,14158,31269,0,712,13862,0,0,28732,0,0,0,0,0,0,613,500,1113,618,561,1179,698,6,111,0,0,10,32,454,613
2,04/12/2022,0209-Pachaiyappas College,24060,30730,0,728,13414,0,0,38202,0,0,0,0,4000,4000,715,480,1195,636,464,1100,690,7,84,0,0,5,29,444,569
2,04/12/2022,0211-Shenoy Nagar,22602,29791,0,1360,14888,0,0,38850,0,0,0,0,5500,5500,526,529,1055,580,492,1072,587,10,76,4,0,0,50,473,613
2,04/12/2022,0213-Anna Nagar East,49241,74070,1858,1632,32094,0,0,84825,0,0,0,0,0,0,1562,1165,2727,1575,1052,2627,1665,29,278,8,0,6,71,1055,1447
2,04/12/2022,0215-Anna Nagar Tower,53063,81692,800,2816,35320,0,0,91999,0,0,0,0,0,0,1681,1292,2973,1598,1222,2820,1767,13,329,4,0,6,109,1141,1602
2,04/12/2022,0217-Thirumangalam,119519,237379,982,8424,120182,0,0,249107,0,0,0,0,0,0,3894,3969,7863,3886,3728,7614,4267,51,863,7,0,14,300,3511,4746
2,04/12/2022,0219-Koyambedu,104869,195205,100,6160,109844,0,0,220973,0,0,0,0,1250,1250,3135,3709,6844,2644,2929,5573,3107,25,846,11,0,27,230,3327,4466
2,04/12/2022,0221-Puratchi Thalaivi Dr. J. Jayalalithaa CMBT,73820,202642,50,4224,116024,0,0,194118,0,0,0,0,0,0,2561,3768,6329,3047,5620,8667,3128,35,993,3,0,20,172,3529,4752
2,04/12/2022,0223-Arumbakkam,37767,57091,0,1240,35082,0,0,74089,0,0,0,0,8000,8000,826,1225,2051,997,962,1959,870,21,0,0,0,15,54,1148,1238
2,04/12/2022,0225-Vadapalani,100814,226741,500,9232,115184,0,0,225730,0,0,0,0,5000,5000,3709,4079,7788,3432,4056,7488,4102,37,1165,3,0,32,354,3499,5090
2,04/12/2022,0227-Ashok Nagar,63308,102514,300,3464,52012,0,0,119084,0,0,0,0,0,0,1725,1782,3507,1749,1800,3549,1907,23,441,3,0,5,128,1558,2158
2,04/12/2022,0229-Ekkattuthangal,41592,58912,190,1600,26102,0,0,69484,0,0,0,0,1000,1000,1166,915,2081,1141,1005,2146,1314,20,366,4,0,1,69,804,1264
2,04/12/2022,0231-Arignar Anna Alandur,94586,165176,300,4968,86976,0,0,186830,0,0,0,0,0,0,2674,2787,5461,2295,2682,4977,2735,43,780,8,0,18,186,2453,3488
2,04/12/2022,0233-St. Thomas Mount,47965,102202,100,4616,61264,0,0,113945,0,0,0,3400,2550,5950,1334,1997,3331,1440,1646,3086,1492,17,234,5,0,8,144,1779,2187
1,05/12/2022,01ED-Wimco Nagar Depot Metro,119946,88340,400,1456,29072,0,0,150874,0,0,0,0,7000,7000,2156,752,2908,1889,473,2362,1864,24,0,2,0,10,45,700,781
1,05/12/2022,01EF-Wimco Nagar Metro,172130,132634,0,2552,34088,0,0,208770,0,0,0,0,2000,2000,3378,916,4294,3111,955,4066,3086,51,52,3,0,8,73,824,1011
1,05/12/2022,01F1-Thiruvotriyur Metro,145466,107463,0,1456,21820,0,0,168742,0,0,0,0,0,0,2865,614,3479,2870,598,3468,2857,27,0,2,1,8,46,571,655
1,05/12/2022,01F3-Thiruvotriyur Theradi Metro,125287,129508,700,1816,33638,0,0,161441,0,0,0,0,0,0,3004,957,3961,3295,1062,4357,3272,17,40,3,0,3,48,893,1004
1,05/12/2022,01F5-Kaladipet Metro,162626,108179,200,2000,24330,0,0,189156,0,0,0,0,0,0,3120,784,3904,3122,723,3845,3100,28,0,1,0,3,62,715,809
1,05/12/2022,01F7-Tollgate Metro,85077,63334,0,712,16524,0,0,102313,0,0,0,0,250,250,1716,534,2250,1725,485,2210,1702,37,0,0,0,14,26,486,563
1,05/12/2022,01F9-New Washermenpet Metro,138905,102645,1300,1096,26496,0,0,167797,0,0,0,0,1000,1000,2920,875,3795,2981,849,3830,2989,15,50,1,0,1,42,821,930
1,05/12/2022,01FB-Tondiarpet Metro,128244,112069,474,1608,30254,0,0,160580,0,0,0,0,0,0,3085,965,4050,3193,994,4187,3185,23,54,7,0,7,46,918,1055
1,05/12/2022,01FD-Thiagaraya College Metro,142881,129900,643,2592,35644,0,0,181760,0,0,0,0,1250,1250,3578,1224,4802,3845,1190,5035,3823,31,34,0,0,5,76,1135,1281
1,05/12/2022,0101-Washermanpet,136462,129187,1348,2648,40436,0,0,180894,0,0,0,0,16000,16000,3760,1411,5171,3478,1297,4775,3589,25,145,0,0,5,98,1282,1555
1,05/12/2022,0103-Mannadi,102644,111318,1510,1312,30418,0,0,135884,0,0,0,0,0,0,3136,1071,4207,3409,1156,4565,3428,17,77,1,0,2,56,1008,1161
1,05/12/2022,0105-High Court,176703,251008,2000,2776,72764,0,0,254243,0,0,0,0,0,0,7112,2543,9655,7204,2168,9372,7348,41,217,0,0,0,119,2373,2750
1,05/12/2022,0109-Government Estate,120581,165541,1000,2808,54806,0,0,179195,0,0,0,0,3000,3000,4264,1989,6253,4617,1842,6459,4846,35,335,2,0,6,122,1804,2304
1,05/12/2022,0111-LIC,141300,189811,2328,3584,38140,0,0,185352,0,0,0,0,0,0,5369,1389,6758,6168,1179,7347,6144,24,0,3,0,4,109,1248,1388
1,05/12/2022,0113-Thousand Lights,213611,257209,2090,5760,44578,0,0,266039,0,0,0,0,0,0,7717,1731,9448,8592,1768,10360,8607,32,0,2,1,4,233,1403,1675
1,05/12/2022,0115-AG-DMS,157016,151959,3750,2472,24974,0,0,188212,0,0,0,0,2000,2000,4905,901,5806,4866,953,5819,5024,42,179,0,0,2,94,772,1089
1,05/12/2022,0117-Teynampet,139542,142904,800,2216,31096,0,0,173654,0,0,0,0,2000,2000,4152,1162,5314,4784,1165,5949,4722,22,4,3,0,1,84,1042,1156
1,05/12/2022,0119-Nandanam,147571,135984,1350,2768,29130,0,0,180819,0,0,0,0,3500,3500,3996,1147,5143,4652,1210,5862,4617,36,0,1,0,3,108,980,1128
1,05/12/2022,0121-Saidapet,64832,86705,0,1872,25802,0,0,92506,0,0,0,0,4000,4000,1983,927,2910,2535,941,3476,2481,9,1,0,0,1,66,843,920
1,05/12/2022,0123-Little Mount,127421,102045,2200,2264,23948,0,0,155833,0,0,0,0,1500,1500,3569,929,4498,3009,872,3881,3175,28,207,3,0,0,98,791,1127
1,05/12/2022,0125-Guindy,187677,279381,3400,8768,86390,0,0,286235,0,0,0,0,500,500,8028,3113,11141,7387,2892,10279,7735,44,378,5,0,3,316,2686,3432
1,05/12/2022,0129-Nanganallur Road,70350,50821,0,760,12236,0,0,83346,0,0,0,0,0,0,1322,406,1728,1504,374,1878,1466,8,1,0,0,0,32,354,395
1,05/12/2022,0131-Meenambakkam,188263,142223,650,3264,38948,0,0,231125,0,0,0,0,0,0,3929,1089,5018,3152,992,4144,3470,25,347,0,0,5,97,1016,1490
1,05/12/2022,0133-Chennai International Airport,236067,361645,5340,12672,156768,0,0,410847,0,0,0,0,24750,24750,5690,4372,10062,6144,4226,10370,6640,74,834,10,1,16,300,3854,5089
2,05/12/2022,0201-Puratchi Thalaivar Dr. M.G. Ramachandran Central,348886,498364,2900,17144,230048,0,0,598978,0,0,0,0,9650,9650,13401,8311,21712,10163,7810,17973,11448,136,1590,13,7,19,701,7315,9781
2,05/12/2022,0203-Egmore,93100,148152,560,4672,75438,0,0,173770,0,0,0,0,8250,8250,2903,2691,5594,2635,2835,5470,2920,26,496,14,0,6,177,2458,3177
2,05/12/2022,0205-Nehru Park,51652,48979,50,1872,15476,0,0,69050,0,0,0,0,4000,4000,1434,562,1996,1356,523,1879,1442,15,135,0,0,2,38,503,693
2,05/12/2022,0207-Kilpauk,45417,63696,0,1008,18742,0,0,65167,0,0,0,0,0,0,1603,675,2278,1758,654,2412,1826,12,108,0,0,3,44,609,776
2,05/12/2022,0209-Pachaiyappas College,58583,49324,0,624,12096,0,0,71303,0,0,0,0,12000,12000,1658,482,2140,1599,516,2115,1583,16,55,11,0,4,25,454,565
2,05/12/2022,0211-Shenoy Nagar,55555,55089,200,1128,14200,0,0,71083,0,0,0,0,1000,1000,1394,522,1916,1677,571,2248,1697,14,83,0,0,2,42,468,609
2,05/12/2022,0213-Anna Nagar East,143506,118561,2850,2256,29814,0,0,178426,0,0,0,0,6000,6000,3293,1108,4401,3430,1076,4506,3486,34,181,0,0,7,86,979,1287
2,05/12/2022,0215-Anna Nagar Tower,120584,107047,2308,2144,23892,0,0,148928,0,0,0,0,1250,1250,3049,876,3925,3109,953,4062,3214,24,222,0,0,2,73,776,1097
2,05/12/2022,0217-Thirumangalam,374505,335767,6300,8536,87100,0,0,476441,0,0,0,0,0,0,8948,3036,11984,9004,3255,12259,9357,75,570,8,0,7,286,2657,3603
2,05/12/2022,0219-Koyambedu,249262,266424,3950,5520,98818,0,0,357550,0,0,0,0,16000,16000,6578,3378,9956,5693,2509,8202,6177,55,601,1,0,14,245,3016,3932
2,05/12/2022,0221-Puratchi Thalaivi Dr. J. Jayalalithaa CMBT,117374,226751,1281,5224,105726,0,0,229605,0,0,0,0,0,0,4005,3543,7548,3787,4224,8011,4486,36,1197,11,0,7,210,3228,4689
2,05/12/2022,0223-Arumbakkam,77748,69725,100,1864,26444,0,0,106156,0,0,0,0,6250,6250,1634,959,2593,1818,829,2647,1776,16,2,2,0,5,72,872,969
2,05/12/2022,0225-Vadapalani,152877,206353,0,4760,72368,0,0,230005,0,0,0,0,4000,4000,4751,2491,7242,4940,2600,7540,5228,36,514,0,0,6,188,2177,2921
2,05/12/2022,0227-Ashok Nagar,116540,155288,2450,3968,51756,0,0,174714,0,0,0,0,3000,3000,3868,1808,5676,3994,1731,5725,4108,41,267,3,0,3,156,1572,2042
2,05/12/2022,0229-Ekkattuthangal,140469,140962,1250,3432,25382,0,0,170533,0,0,0,0,1250,1250,4034,1004,5038,4450,1301,5751,4642,31,300,2,0,3,149,784,1269
2,05/12/2022,0231-Arignar Anna Alandur,224575,219236,400,5144,68510,0,0,298629,0,0,0,0,5750,5750,5953,2363,8316,5486,2017,7503,5850,57,520,1,0,5,192,2009,2784
2,05/12/2022,0233-St. Thomas Mount,129748,116550,401,4096,37772,0,0,172017,0,0,0,4000,5900,9900,3091,1299,4390,3064,1127,4191,3081,45,134,0,0,3,125,1128,1435
1,06/12/2022,01ED-Wimco Nagar Depot Metro,93287,76840,0,1112,20092,0,0,114491,0,0,0,0,4750,4750,2151,531,2682,1773,381,2154,1794,14,39,2,0,4,35,503,597
1,06/12/2022,01EF-Wimco Nagar Metro,128646,121497,0,3088,28978,0,0,160712,0,0,0,0,0,0,3197,789,3986,2834,762,3596,2906,43,65,0,0,4,87,689,888
1,06/12/2022,01F1-Thiruvotriyur Metro,116318,97662,1200,1680,20844,0,0,140042,0,0,0,0,0,0,2704,598,3302,2546,495,3041,2531,28,0,0,0,5,50,558,641
1,06/12/2022,01F3-Thiruvotriyur Theradi Metro,99387,112798,500,1384,29792,0,0,131063,0,0,0,0,0,0,2662,837,3499,2890,813,3703,2861,19,31,1,0,3,47,789,890
1,06/12/2022,01F5-Kaladipet Metro,120706,91948,400,992,19872,0,0,141970,0,0,0,0,0,0,2800,641,3441,2696,546,3242,2661,28,1,0,0,3,31,600,663
1,06/12/2022,01F7-Tollgate Metro,71737,53972,0,696,14300,0,0,86733,0,0,0,0,0,0,1516,440,1956,1477,349,1826,1459,21,0,0,0,5,19,414,459
1,06/12/2022,01F9-New Washermenpet Metro,91470,90475,0,1208,21716,0,0,114394,0,0,0,0,500,500,2693,730,3423,2657,721,3378,2676,13,44,1,0,3,43,682,786
1,06/12/2022,01FB-Tondiarpet Metro,96561,96457,1050,1472,25776,0,0,124859,0,0,0,0,250,250,2743,855,3598,2810,764,3574,2790,16,1,0,0,5,46,798,866
1,06/12/2022,01FD-Thiagaraya College Metro,110253,102198,450,1416,23286,0,0,135405,0,0,0,0,1750,1750,3183,825,4008,3223,771,3994,3243,63,38,1,0,1,54,762,919
1,06/12/2022,0101-Washermanpet,117052,116772,0,1560,36366,0,0,154978,0,0,0,0,11500,11500,3459,1220,4679,3192,1026,4218,3245,18,100,2,0,7,57,1153,1337
1,06/12/2022,0103-Mannadi,88366,104666,500,1344,27892,0,0,118102,0,0,0,0,0,0,2990,968,3958,3187,972,4159,3222,27,97,3,0,3,49,909,1088
1,06/12/2022,0105-High Court,153885,240356,700,2400,68498,0,0,225483,0,0,0,0,0,0,6855,2413,9268,6916,2068,8984,7060,21,228,2,0,4,92,2302,2649
1,06/12/2022,0109-Government Estate,112702,142761,200,2272,36172,0,0,151346,0,0,0,0,1750,1750,4104,1350,5454,4283,1588,5871,4639,25,452,4,0,2,100,1192,1775
1,06/12/2022,0111-LIC,93246,148574,800,2040,26192,0,0,122278,0,0,0,0,2000,2000,4311,974,5285,4976,860,5836,4975,23,0,0,0,1,91,839,954
1,06/12/2022,0113-Thousand Lights,163865,244707,2410,5288,43484,0,0,215047,0,0,0,0,250,250,7360,1649,9009,8110,1525,9635,8111,34,0,0,0,5,208,1358,1605
1,06/12/2022,0115-AG-DMS,130950,137154,1000,1944,21986,0,0,155880,0,0,0,0,250,250,4581,808,5389,4399,798,5197,4557,15,180,0,0,0,68,689,952
1,06/12/2022,0117-Teynampet,117088,130966,1600,2224,23056,0,0,143968,0,0,0,0,0,0,3975,920,4895,4511,920,5431,4545,24,71,2,0,2,95,778,972
1,06/12/2022,0119-Nandanam,126292,126927,4750,2080,24996,0,0,158118,0,0,0,0,0,0,3984,961,4945,4395,886,5281,4400,26,17,1,0,3,88,840,975
1,06/12/2022,0121-Saidapet,55540,72990,200,1144,20094,0,0,76978,0,0,0,0,4750,4750,1782,714,2496,2163,706,2869,2149,17,33,4,0,0,52,665,771
1,06/12/2022,0123-Little Mount,99331,96166,350,2144,21174,0,0,122999,0,0,0,0,0,0,3403,840,4243,2863,697,3560,3044,18,183,4,0,0,95,704,1004
1,06/12/2022,0125-Guindy,157000,250091,2500,7496,69392,0,0,236388,0,0,0,0,0,0,7396,2560,9956,6935,2242,9177,7225,38,330,3,0,0,243,2200,2814
1,06/12/2022,0129-Nanganallur Road,61378,45042,400,712,10906,0,0,73396,0,0,0,0,0,0,1257,363,1620,1356,347,1703,1332,8,0,0,0,1,25,325,359
1,06/12/2022,0131-Meenambakkam,136505,115641,3093,2848,28640,0,0,171086,0,0,0,0,0,0,3447,847,4294,2827,759,3586,2996,17,191,12,0,2,90,775,1087
1,06/12/2022,0133-Chennai International Airport,200615,321234,760,10248,136820,0,0,348443,0,0,0,0,8250,8250,5477,3808,9285,5707,3646,9353,6026,63,697,6,0,5,242,3422,4435
2,06/12/2022,0201-Puratchi Thalaivar Dr. M.G. Ramachandran Central,254393,415832,750,13016,183492,0,0,451651,0,0,0,0,5200,5200,10986,6704,17690,9295,6733,16028,9988,92,1069,8,0,17,515,6000,7701
2,06/12/2022,0203-Egmore,89925,125313,1100,2568,59366,0,0,152959,0,0,0,0,10000,10000,2509,2136,4645,2432,2419,4851,2673,27,489,8,0,4,109,1972,2609
2,06/12/2022,0205-Nehru Park,55666,42336,400,968,12926,0,0,69960,0,0,0,0,2750,2750,1275,502,1777,1203,524,1727,1252,22,85,1,0,0,39,442,589
2,06/12/2022,0207-Kilpauk,43840,52162,0,888,12070,0,0,56798,0,0,0,0,0,0,1478,463,1941,1536,509,2045,1607,21,97,0,0,3,35,403,559
2,06/12/2022,0209-Pachaiyappas College,46705,42918,0,584,9832,0,0,57121,0,0,0,0,4000,4000,1459,376,1835,1369,380,1749,1391,9,69,1,0,2,21,348,450
2,06/12/2022,0211-Shenoy Nagar,53548,48779,0,792,12554,0,0,66894,0,0,0,0,3000,3000,1380,464,1844,1444,423,1867,1470,11,84,1,0,0,34,423,553
2,06/12/2022,0213-Anna Nagar East,91733,106178,300,3160,23332,0,0,118525,0,0,0,0,0,0,3107,865,3972,3174,867,4041,3295,15,195,1,0,1,98,747,1057
2,06/12/2022,0215-Anna Nagar Tower,95172,98010,850,2368,21514,0,0,119904,0,0,0,0,1000,1000,2787,814,3601,2866,793,3659,2945,28,161,1,0,2,92,691,975
2,06/12/2022,0217-Thirumangalam,304906,304097,3010,8360,72394,0,0,388670,0,0,0,0,1500,1500,8262,2568,10830,8394,2483,10877,8711,63,462,4,0,4,264,2228,3025
2,06/12/2022,0219-Koyambedu,215632,225142,256,4272,73622,0,0,293782,0,0,0,0,14000,14000,5811,2606,8417,5165,2057,7222,5590,44,579,8,0,8,178,2342,3159
2,06/12/2022,0221-Puratchi Thalaivi Dr. J. Jayalalithaa CMBT,93267,173459,250,3368,70178,0,0,167063,0,0,0,0,0,0,2945,2368,5313,3533,3826,7359,3906,31,766,2,0,2,132,2168,3101
2,06/12/2022,0223-Arumbakkam,64145,62033,550,1472,23710,0,0,89877,0,0,0,0,750,750,1687,875,2562,1664,713,2377,1597,48,0,3,0,1,50,802,904
2,06/12/2022,0225-Vadapalani,138519,207824,200,6192,73998,0,0,218909,0,0,0,0,6000,6000,4948,2621,7569,4996,2595,7591,5275,42,565,8,0,8,223,2276,3122
2,06/12/2022,0227-Ashok Nagar,115036,134635,500,5072,41904,0,0,162512,0,0,0,0,3000,3000,3554,1535,5089,3564,1376,4940,3685,33,217,6,0,4,136,1317,1713
2,06/12/2022,0229-Ekkattuthangal,118092,140056,500,3296,26138,0,0,148026,0,0,0,0,0,0,4216,1026,5242,4306,1106,5412,4595,21,349,1,0,4,140,826,1341
2,06/12/2022,0231-Arignar Anna Alandur,173916,190842,400,4656,54330,0,0,233302,0,0,0,0,3500,3500,5384,1923,7307,5038,1689,6727,5355,49,443,1,0,1,176,1655,2325
2,06/12/2022,0233-St. Thomas Mount,101455,104672,500,2888,31918,0,0,136761,0,0,0,6000,2075,8075,2896,1122,4018,2850,856,3706,2864,31,91,1,0,0,112,971,1206
1,07/12/2022,01ED-Wimco Nagar Depot Metro,98184,86457,0,1296,26700,0,0,126180,0,0,0,0,1750,1750,2248,690,2938,1963,422,2385,1890,17,1,1,0,13,39,658,729
1,07/12/2022,01EF-Wimco Nagar Metro,127809,125313,0,3056,29466,0,0,160331,0,0,0,0,750,750,3231,815,4046,3018,785,3803,3005,37,69,2,0,6,91,707,912
1,07/12/2022,01F1-Thiruvotriyur Metro,115467,99779,0,1760,20092,0,0,137319,0,0,0,0,0,0,2864,588,3452,2713,520,3233,2664,25,1,0,0,2,46,538,612
1,07/12/2022,01F3-Thiruvotriyur Theradi Metro,112049,163118,1200,2416,54668,0,0,170333,0,0,0,0,0,0,3457,1513,4970,3622,1461,5083,3693,16,200,3,0,16,76,1409,1720
1,07/12/2022,01F5-Kaladipet Metro,112044,107713,0,1416,26910,0,0,140370,0,0,0,0,0,0,3085,817,3902,3050,659,3709,2966,28,0,1,0,3,49,756,837
1,07/12/2022,01F7-Tollgate Metro,64099,64338,400,832,19504,0,0,84835,0,0,0,0,0,0,1707,595,2302,1709,477,2186,1653,33,3,0,0,10,28,557,631
1,07/12/2022,01F9-New Washermenpet Metro,105961,96724,400,1240,15196,0,0,122797,0,0,0,0,250,250,3131,495,3626,2905,680,3585,3144,16,311,1,0,2,41,452,823
1,07/12/2022,01FB-Tondiarpet Metro,91542,104374,970,1488,28368,0,0,122368,0,0,0,0,250,250,2999,928,3927,3111,845,3956,3007,15,0,0,0,3,43,871,932
1,07/12/2022,01FD-Thiagaraya College Metro,118329,119508,300,1952,28272,0,0,148853,0,0,0,0,1500,1500,3580,1003,4583,3703,873,4576,3733,48,77,2,0,1,75,914,1117
1,07/12/2022,0101-Washermanpet,121066,124851,1429,2192,38820,0,0,163507,0,0,0,0,14250,14250,3809,1362,5171,3445,1179,4624,3476,22,133,1,0,6,84,1263,1509
1,07/12/2022,0103-Mannadi,88394,109319,100,992,28288,0,0,117774,0,0,0,0,1500,1500,3091,971,4062,3473,978,4451,3403,14,104,0,0,5,34,927,1084
1,07/12/2022,0105-High Court,168052,246389,1210,3632,51764,0,0,224658,0,0,0,0,0,0,7567,1878,9445,7164,1908,9072,7852,31,836,1,0,4,139,1711,2722
1,07/12/2022,0109-Government Estate,117850,157533,3500,2760,37672,0,0,161782,0,0,0,0,1750,1750,4574,1398,5972,4786,1556,6342,5151,21,582,1,0,3,115,1244,1966
1,07/12/2022,0111-LIC,89869,161050,2250,1608,30712,0,0,124439,0,0,0,0,0,0,4572,1086,5658,5398,890,6288,5298,20,0,2,0,2,71,989,1084
1,07/12/2022,0113-Thousand Lights,179521,258202,2700,4624,35852,0,0,222697,0,0,0,0,0,0,8095,1399,9494,8827,1419,10246,8928,22,246,1,0,5,188,1134,1596
1,07/12/2022,0115-AG-DMS,142793,154104,1430,2144,28538,0,0,174905,0,0,0,0,3000,3000,5007,1020,6027,4912,880,5792,5000,22,141,2,0,1,92,898,1156
1,07/12/2022,0117-Teynampet,105516,141728,1100,2600,29986,0,0,139202,0,0,0,0,2000,2000,4084,1126,5210,4792,984,5776,4725,15,0,0,0,4,91,998,1108
1,07/12/2022,0119-Nandanam,119854,142167,50,2496,23226,0,0,145626,0,0,0,0,250,250,4527,879,5406,4811,967,5778,5044,26,340,1,0,2,108,762,1239
1,07/12/2022,0121-Saidapet,58338,88464,0,1144,25396,0,0,84878,0,0,0,0,4000,4000,2147,885,3032,2625,723,3348,2522,11,1,1,0,1,44,823,881
1,07/12/2022,0123-Little Mount,103526,105692,1100,2424,23442,0,0,130492,0,0,0,0,2000,2000,3744,948,4692,3139,771,3910,3330,24,220,0,0,0,101,778,1123
1,07/12/2022,0125-Guindy,150819,276747,1450,8984,71902,0,0,233155,0,0,0,0,500,500,8339,2645,10984,7725,2429,10154,8128,31,534,2,0,3,284,2257,3111
1,07/12/2022,0129-Nanganallur Road,28838,50688,50,600,13508,0,0,42996,0,0,0,0,0,0,1340,425,1765,1486,368,1854,1434,8,0,0,0,1,20,390,419
1,07/12/2022,0131-Meenambakkam,144365,126440,1770,1880,35682,0,0,183697,0,0,0,0,0,0,3760,987,4747,2987,836,3823,3107,26,214,7,0,3,61,940,1251
1,07/12/2022,0133-Chennai International Airport,255699,350449,800,8880,97156,0,0,362535,0,0,0,0,3750,3750,6493,2781,9274,6294,3835,10129,7879,59,2035,21,0,12,269,2454,4850
2,07/12/2022,0201-Puratchi Thalaivar Dr. M.G. Ramachandran Central,230350,446291,550,12304,196740,0,0,439944,0,0,0,0,5250,5250,11849,7141,18990,10500,7081,17581,10821,80,1119,10,1,29,479,6542,8260
2,07/12/2022,0203-Egmore,89452,134172,200,3248,64286,0,0,157186,0,0,0,0,21500,21500,2622,2360,4982,2861,2687,5548,2885,28,434,23,0,3,139,2211,2838
2,07/12/2022,0205-Nehru Park,46903,48477,0,728,13862,0,0,61493,0,0,0,0,4750,4750,1463,528,1991,1372,485,1857,1449,25,143,0,0,1,31,484,684
2,07/12/2022,0207-Kilpauk,40431,57836,0,912,15892,0,0,57235,0,0,0,0,250,250,1547,584,2131,1673,582,2255,1706,12,87,0,0,1,37,536,673
2,07/12/2022,0209-Pachaiyappas College,53017,48566,0,544,13036,0,0,66597,0,0,0,0,7500,7500,1662,499,2161,1475,443,1918,1507,9,67,1,0,4,26,464,571
2,07/12/2022,0211-Shenoy Nagar,51691,50377,2000,808,11910,0,0,66409,0,0,0,0,2000,2000,1461,425,1886,1556,458,2014,1580,16,94,0,0,1,34,387,532
2,07/12/2022,0213-Anna Nagar East,109891,118299,2450,2744,28720,0,0,143805,0,0,0,0,3000,3000,3343,1079,4422,3444,949,4393,3533,28,188,2,0,3,106,941,1268
2,07/12/2022,0215-Anna Nagar Tower,109075,107169,1100,1888,24142,0,0,136205,0,0,0,0,750,750,3097,896,3993,3183,846,4029,3215,18,215,0,0,2,76,805,1116
2,07/12/2022,0217-Thirumangalam,299205,321277,3250,7776,80394,0,0,390625,0,0,0,0,0,0,8801,2784,11585,8996,2545,11541,9080,52,464,4,0,2,241,2476,3239
2,07/12/2022,0219-Koyambedu,220918,243165,1100,4480,92598,0,0,319096,0,0,0,0,14000,14000,5980,3144,9124,5391,2258,7649,5588,59,510,9,0,7,177,2914,3676
2,07/12/2022,0221-Puratchi Thalaivi Dr. J. Jayalalithaa CMBT,92222,193204,0,2840,81494,0,0,176556,0,0,0,0,0,0,3110,2663,5773,3957,3772,7729,4163,20,873,0,0,3,123,2524,3543
2,07/12/2022,0223-Arumbakkam,72714,70102,1000,1416,25126,0,0,100256,0,0,0,0,11500,11500,1791,879,2670,1960,742,2702,1836,56,1,6,0,7,55,813,938
2,07/12/2022,0225-Vadapalani,123254,194404,1300,4536,65796,0,0,194886,0,0,0,0,9500,9500,4648,2260,6908,4841,2203,7044,5016,39,485,0,0,4,173,2015,2716
2,07/12/2022,0227-Ashok Nagar,101693,145070,530,3272,47036,0,0,152531,0,0,0,0,1500,1500,3770,1642,5412,3799,1408,5207,3894,27,244,4,0,3,131,1463,1872
2,07/12/2022,0229-Ekkattuthangal,108641,141029,2050,3240,23632,0,0,137563,0,0,0,0,0,0,4326,931,5257,4423,1001,5424,4694,22,349,0,0,2,131,736,1240
2,07/12/2022,0231-Arignar Anna Alandur,177686,210406,72,4768,60372,0,0,242898,0,0,0,0,6000,6000,6031,2065,8096,5465,1769,7234,5822,68,494,5,0,6,186,1789,2548
2,07/12/2022,0233-St. Thomas Mount,106371,111013,900,2656,30718,0,0,140645,0,0,0,3000,8450,11450,3244,1060,4304,2999,959,3958,3132,20,215,1,0,1,94,927,1258
1,08/12/2022,01ED-Wimco Nagar Depot Metro,97829,86406,0,1656,25718,0,0,125203,0,0,0,0,7250,7250,2306,679,2985,1975,387,2362,1923,19,0,2,0,5,49,632,707
1,08/12/2022,01EF-Wimco Nagar Metro,124877,128888,600,2968,27654,0,0,156099,0,0,0,0,0,0,3390,766,4156,3176,720,3896,3182,35,72,1,0,5,82,666,861
1,08/12/2022,01F1-Thiruvotriyur Metro,128417,103550,100,1800,20254,0,0,150571,0,0,0,0,0,0,2947,599,3546,2856,469,3325,2796,26,1,3,1,3,56,544,634
1,08/12/2022,01F3-Thiruvotriyur Theradi Metro,129213,247683,100,2728,113366,0,0,245407,0,0,0,0,0,0,4275,3071,7346,4423,2736,7159,4536,31,391,2,0,14,91,2956,3485
1,08/12/2022,01F5-Kaladipet Metro,113057,106314,640,1032,23166,0,0,137895,0,0,0,0,0,0,3140,726,3866,3123,635,3758,3076,29,1,0,0,3,38,686,757
1,08/12/2022,01F7-Tollgate Metro,61381,55636,0,880,14620,0,0,76881,0,0,0,0,250,250,1694,455,2149,1556,389,1945,1538,13,0,0,0,6,27,425,471
1,08/12/2022,01F9-New Washermenpet Metro,125739,102210,560,1320,3372,0,0,130991,0,0,0,0,1250,1250,3636,150,3786,3167,689,3856,3753,17,675,0,0,3,53,93,841
1,08/12/2022,01FB-Tondiarpet Metro,109166,109272,2200,1424,28502,0,0,141292,0,0,0,0,1000,1000,3077,956,4033,3280,857,4137,3179,13,1,1,0,4,47,887,953
1,08/12/2022,01FD-Thiagaraya College Metro,109987,125729,2850,1848,29506,0,0,144191,0,0,0,0,500,500,3763,1088,4851,4033,990,5023,3953,42,27,0,0,2,67,1009,1147
1,08/12/2022,0101-Washermanpet,115374,134857,759,2400,42406,0,0,160939,0,0,0,0,16750,16750,4046,1513,5559,3780,1325,5105,3777,33,150,2,0,6,101,1397,1689
1,08/12/2022,0103-Mannadi,88036,114376,0,1104,31868,0,0,121008,0,0,0,0,0,0,3151,1094,4245,3576,1120,4696,3508,21,84,0,0,1,41,1044,1191
1,08/12/2022,0105-High Court,174084,251952,300,3256,39446,0,0,217086,0,0,0,0,0,0,8443,1478,9921,7416,2005,9421,8598,29,1317,4,0,6,139,1311,2806
1,08/12/2022,0109-Government Estate,124489,163527,400,2616,33422,0,0,160927,0,0,0,0,3500,3500,5054,1199,6253,4844,1649,6493,5538,33,878,0,0,2,114,1067,2094
1,08/12/2022,0111-LIC,87896,188093,710,2608,37170,0,0,128384,0,0,0,0,0,0,5512,1318,6830,6174,1060,7234,6097,20,0,0,0,0,98,1181,1299
1,08/12/2022,0113-Thousand Lights,171026,270209,4654,6552,34306,0,0,216538,0,0,0,0,0,0,8841,1383,10224,8938,1528,10466,9428,30,506,0,0,7,253,1063,1859
1,08/12/2022,0115-AG-DMS,109633,165572,1700,2320,30064,0,0,143717,0,0,0,0,2500,2500,5587,1060,6647,5141,840,5981,5357,21,283,1,0,0,86,932,1323
1,08/12/2022,0117-Teynampet,109234,155027,3020,1920,35074,0,0,149248,0,0,0,0,1000,1000,4456,1306,5762,5162,1069,6231,5071,21,1,0,0,9,85,1179,1295
1,08/12/2022,0119-Nandanam,113575,144444,2650,3056,30028,0,0,149309,0,0,0,0,1000,1000,4552,1136,5688,4826,992,5818,4894,31,163,1,0,1,121,976,1293
1,08/12/2022,0121-Saidapet,55625,93694,0,1920,28848,0,0,86393,0,0,0,0,4500,4500,2149,980,3129,2694,873,3567,2633,21,0,0,0,1,78,910,1010
1,08/12/2022,0123-Little Mount,112133,110889,100,2024,26652,0,0,140909,0,0,0,0,1750,1750,4027,986,5013,3254,738,3992,3409,23,267,1,0,6,87,850,1234
1,08/12/2022,0125-Guindy,162901,288788,650,7488,81346,0,0,252385,0,0,0,0,0,0,8380,2849,11229,8086,2322,10408,8306,46,473,2,0,3,265,2495,3284
1,08/12/2022,0129-Nanganallur Road,57780,50400,1100,648,11870,0,0,71398,0,0,0,0,0,0,1357,376,1733,1552,341,1893,1474,7,0,4,0,1,21,345,378
1,08/12/2022,0131-Meenambakkam,140781,130583,300,2568,34030,0,0,177679,0,0,0,0,0,0,3911,990,4901,3126,843,3969,3298,14,272,8,0,2,76,914,1286
1,08/12/2022,0133-Chennai International Airport,205446,358970,1880,7496,146764,0,0,361586,0,0,0,0,6000,6000,6479,4013,10492,6444,3726,10170,6836,55,987,22,0,12,246,3699,5021
2,08/12/2022,0201-Puratchi Thalaivar Dr. M.G. Ramachandran Central,262405,466079,1510,10880,192740,0,0,467535,0,0,0,0,9000,9000,12766,6974,19740,11528,7408,18936,11871,119,1306,8,0,29,460,6359,8281
2,08/12/2022,0203-Egmore,73988,138562,800,2480,61750,0,0,139018,0,0,0,0,13350,13350,2615,2290,4905,3222,2858,6080,3213,21,458,8,0,6,109,2157,2759
2,08/12/2022,0205-Nehru Park,45189,49733,0,1248,15314,0,0,61751,0,0,0,0,0,0,1472,579,2051,1346,504,1850,1426,30,136,0,0,1,48,524,739
2,08/12/2022,0207-Kilpauk,46229,62930,0,968,19062,0,0,66259,0,0,0,0,500,500,1675,690,2365,1785,638,2423,1795,26,89,0,0,0,40,638,793
2,08/12/2022,0209-Pachaiyappas College,55480,53270,0,608,14398,0,0,70486,0,0,0,0,500,500,1786,536,2322,1614,455,2069,1624,20,95,1,0,4,28,498,646
2,08/12/2022,0211-Shenoy Nagar,45000,53045,0,832,12750,0,0,58582,0,0,0,0,250,250,1501,452,1953,1612,456,2068,1642,13,109,0,0,0,34,412,568
2,08/12/2022,0213-Anna Nagar East,96792,119018,2300,2344,26722,0,0,128158,0,0,0,0,0,0,3495,1008,4503,3546,944,4490,3648,18,229,4,0,2,102,886,1241
2,08/12/2022,0215-Anna Nagar Tower,97414,107249,324,1392,25286,0,0,124416,0,0,0,0,1250,1250,3087,882,3969,3100,797,3897,3160,20,222,0,1,5,55,804,1107
2,08/12/2022,0217-Thirumangalam,292222,329358,320,8872,77608,0,0,379022,0,0,0,0,1500,1500,9185,2683,11868,9049,2664,11713,9383,49,688,5,0,1,261,2353,3357
2,08/12/2022,0219-Koyambedu,187404,229974,300,4824,84158,0,0,276686,0,0,0,0,10750,10750,5698,2864,8562,5274,2167,7441,5412,53,493,2,0,9,163,2630,3350
2,08/12/2022,0221-Puratchi Thalaivi Dr. J. Jayalalithaa CMBT,77820,188297,700,2464,84288,0,0,165272,0,0,0,0,0,0,2790,2707,5497,4302,3779,8081,4021,27,526,3,0,3,105,2591,3255
2,08/12/2022,0223-Arumbakkam,76238,71498,57,1176,25944,0,0,103415,0,0,0,0,4500,4500,1870,893,2763,1997,738,2735,1838,65,1,4,0,6,43,860,979
2,08/12/2022,0225-Vadapalani,132981,196093,300,4200,68648,0,0,206129,0,0,0,0,4500,4500,4692,2365,7057,4809,2156,6965,4948,42,422,0,0,4,164,2138,2770
2,08/12/2022,0227-Ashok Nagar,117115,156061,1850,3184,44558,0,0,166707,0,0,0,0,9000,9000,4182,1512,5694,3999,1502,5501,4309,19,498,7,0,4,117,1350,1995
2,08/12/2022,0229-Ekkattuthangal,113061,146267,1650,3720,30590,0,0,149021,0,0,0,0,250,250,4324,1156,5480,4351,1002,5353,4631,31,348,3,0,1,150,959,1492
2,08/12/2022,0231-Arignar Anna Alandur,153746,206979,600,4040,58018,0,0,216404,0,0,0,0,3750,3750,5967,2000,7967,5440,1675,7115,5773,41,569,1,0,0,158,1773,2542
2,08/12/2022,0233-St. Thomas Mount,108308,112116,901,2288,30098,0,0,141595,0,0,0,3000,7800,10800,3153,1027,4180,3099,909,4008,3210,18,206,0,0,0,91,908,1223
1,09/12/2022,01ED-Wimco Nagar Depot Metro,52728,58580,0,1000,18832,0,0,72560,0,0,0,0,2250,2250,1568,492,2060,1292,301,1593,1260,10,0,1,0,4,29,467,511
1,09/12/2022,01EF-Wimco Nagar Metro,74307,91613,100,2904,19150,0,0,96461,0,0,0,0,250,250,2226,559,2785,2251,547,2798,2286,23,67,4,0,6,75,477,652
1,09/12/2022,01F1-Thiruvotriyur Metro,76415,68019,0,672,17662,0,0,94749,0,0,0,0,0,0,1860,494,2354,1742,415,2157,1687,18,0,0,0,2,24,471,515
1,09/12/2022,01F3-Thiruvotriyur Theradi Metro,78373,139249,0,2432,56400,0,0,137205,0,0,0,0,0,0,2634,1640,4274,2918,1497,4415,2854,20,71,1,0,14,82,1538,1726
1,09/12/2022,01F5-Kaladipet Metro,75963,71600,50,728,18610,0,0,95351,0,0,0,0,0,0,1953,561,2514,1988,518,2506,1931,19,0,2,0,3,27,531,582
1,09/12/2022,01F7-Tollgate Metro,38493,46093,150,744,15618,0,0,55005,0,0,0,0,0,0,1099,514,1613,1162,451,1613,1128,18,0,0,0,12,19,492,541
1,09/12/2022,01F9-New Washermenpet Metro,72860,70070,1000,1096,7916,0,0,82872,0,0,0,0,0,0,2251,291,2542,2041,551,2592,2344,12,328,1,0,2,38,252,633
1,09/12/2022,01FB-Tondiarpet Metro,54849,74810,0,1344,22642,0,0,78835,0,0,0,0,750,750,1969,753,2722,2153,722,2875,2062,10,2,1,0,7,50,696,766
1,09/12/2022,01FD-Thiagaraya College Metro,78460,83572,100,1448,23356,0,0,103364,0,0,0,0,0,0,2372,841,3213,2430,726,3156,2436,16,39,0,0,5,50,794,904
1,09/12/2022,0101-Washermanpet,88085,93573,800,1296,31320,0,0,121501,0,0,0,0,13250,13250,2698,1092,3790,2452,1101,3553,2492,20,194,1,0,6,46,1025,1292
1,09/12/2022,0103-Mannadi,49102,75598,230,600,26024,0,0,75956,0,0,0,0,0,0,2103,932,3035,2095,829,2924,2091,21,97,0,0,4,25,914,1061
1,09/12/2022,0105-High Court,98358,172855,1800,1656,46388,0,0,148202,0,0,0,0,0,0,5205,1700,6905,4993,1315,6308,5196,17,262,0,0,5,67,1620,1971
1,09/12/2022,0109-Government Estate,74804,117259,1300,1656,33886,0,0,111646,0,0,0,0,750,750,3450,1242,4692,3327,1174,4501,3606,23,377,1,0,1,73,1168,1643
1,09/12/2022,0111-LIC,58391,130008,200,1800,28774,0,0,89165,0,0,0,0,0,0,3789,1035,4824,4122,699,4821,4088,20,1,0,0,3,73,945,1042
1,09/12/2022,0113-Thousand Lights,116774,204504,1100,4496,36108,0,0,158478,0,0,0,0,0,0,6382,1333,7715,6081,1163,7244,6559,33,518,0,0,7,176,1138,1872
1,09/12/2022,0115-AG-DMS,90499,105069,0,1632,26064,0,0,118195,0,0,0,0,0,0,3201,897,4098,2965,582,3547,3112,24,216,0,0,1,61,813,1115
1,09/12/2022,0117-Teynampet,66980,95116,350,1448,22262,0,0,91040,0,0,0,0,250,250,2879,818,3697,2847,733,3580,3007,16,207,0,0,3,63,738,1027
1,09/12/2022,0119-Nandanam,86936,100613,550,2472,16500,0,0,106458,0,0,0,0,2250,2250,3424,662,4086,3024,728,3752,3443,18,456,0,0,1,97,564,1136
1,09/12/2022,0121-Saidapet,40311,60458,150,848,22186,0,0,63495,0,0,0,0,0,0,1511,758,2269,1673,584,2257,1589,4,4,0,0,0,38,721,767
1,09/12/2022,0123-Little Mount,67735,75543,830,1424,21440,0,0,91429,0,0,0,0,250,250,2563,796,3359,1972,499,2471,2156,4,243,0,0,2,56,716,1021
1,09/12/2022,0125-Guindy,105463,192924,1220,4168,61886,0,0,172737,0,0,0,0,1500,1500,5391,2206,7597,5007,1690,6697,5281,26,444,5,0,2,174,1979,2630
1,09/12/2022,0129-Nanganallur Road,32067,32822,0,1032,8734,0,0,41833,0,0,0,0,0,0,901,291,1192,960,231,1191,907,8,1,0,0,2,25,264,300
1,09/12/2022,0131-Meenambakkam,95200,89238,400,1712,27568,0,0,124880,0,0,0,0,0,0,2582,842,3424,2015,597,2612,2075,15,144,2,0,4,56,774,995
1,09/12/2022,0133-Chennai International Airport,145472,270558,100,5704,126664,0,0,277940,0,0,0,0,7500,7500,3371,3450,6821,4374,3191,7565,4629,50,857,2,0,8,180,3244,4341
2,09/12/2022,0201-Puratchi Thalaivar Dr. M.G. Ramachandran Central,176810,388285,1860,7600,164624,0,0,350894,0,0,0,0,950,950,8817,5814,14631,10141,7896,18037,9679,88,1186,16,0,29,324,5423,7066
2,09/12/2022,0203-Egmore,74341,158297,600,4648,64900,0,0,144489,0,0,0,0,2500,2500,3029,2615,5644,3283,3236,6519,4042,25,1280,4,0,6,204,2386,3905
2,09/12/2022,0205-Nehru Park,35138,40386,0,760,14210,0,0,50108,0,0,0,0,500,500,1179,527,1706,966,400,1366,1079,25,173,0,0,2,31,485,716
2,09/12/2022,0207-Kilpauk,27564,42876,200,656,14152,0,0,42572,0,0,0,0,0,0,1107,505,1612,1081,434,1515,1137,7,94,0,0,1,29,470,601
2,09/12/2022,0209-Pachaiyappas College,32334,33498,0,176,11160,0,0,43670,0,0,0,0,6000,6000,1031,391,1422,933,329,1262,923,21,56,1,0,0,8,379,465
2,09/12/2022,0211-Shenoy Nagar,30008,34018,200,440,10404,0,0,41052,0,0,0,0,250,250,947,360,1307,891,321,1212,930,3,79,1,0,1,20,334,438
2,09/12/2022,0213-Anna Nagar East,57668,69461,200,1592,18758,0,0,78218,0,0,0,0,3000,3000,1981,677,2658,1872,565,2437,1933,3,170,0,0,1,55,615,844
2,09/12/2022,0215-Anna Nagar Tower,51975,63831,300,1496,17688,0,0,71459,0,0,0,0,250,250,1751,625,2376,1654,504,2158,1745,10,190,0,0,3,49,568,820
2,09/12/2022,0217-Thirumangalam,170597,222985,620,5888,62594,0,0,239699,0,0,0,0,0,0,5964,2149,8113,5367,1840,7207,5887,33,828,4,0,4,219,1917,3005
2,09/12/2022,0219-Koyambedu,108722,162109,250,3536,58416,0,0,170924,0,0,0,0,7250,7250,3723,2006,5729,3505,1711,5216,3760,15,510,2,0,10,145,1826,2508
2,09/12/2022,0221-Puratchi Thalaivi Dr. J. Jayalalithaa CMBT,44476,144862,100,2760,64658,0,0,111994,0,0,0,0,0,0,1842,2093,3935,3714,3920,7634,3111,12,349,1,0,1,60,2022,2445
2,09/12/2022,0223-Arumbakkam,46771,58184,0,1208,27282,0,0,75261,0,0,0,0,3250,3250,1339,904,2243,1361,624,1985,1216,33,1,0,0,2,39,866,941
2,09/12/2022,0225-Vadapalani,86508,135335,200,3832,53970,0,0,144510,0,0,0,0,9000,9000,3014,1859,4873,2847,1615,4462,3076,28,476,3,0,6,149,1665,2327
2,09/12/2022,0227-Ashok Nagar,68693,117105,100,3272,45436,0,0,117501,0,0,0,0,500,500,2648,1504,4152,2576,1200,3776,2709,13,316,1,0,5,119,1352,1806
2,09/12/2022,0229-Ekkattuthangal,72944,100532,500,2824,29714,0,0,105982,0,0,0,0,0,0,2753,1040,3793,2412,693,3105,2755,16,431,1,0,1,107,896,1452
2,09/12/2022,0231-Arignar Anna Alandur,111876,140057,2380,3200,46748,0,0,164204,0,0,0,0,1250,1250,3848,1566,5414,3220,1209,4429,3576,27,550,1,0,7,120,1412,2117
2,09/12/2022,0233-St. Thomas Mount,53705,77957,50,1768,24590,0,0,80113,0,0,0,3000,1200,4200,1978,845,2823,1971,706,2677,2063,11,213,0,0,1,72,758,1055
1,10/12/2022,01ED-Wimco Nagar Depot Metro,53562,55153,0,1656,23294,0,0,78512,0,0,0,0,2250,2250,1317,607,1924,1025,322,1347,1005,18,0,0,0,10,44,569,641
1,10/12/2022,01EF-Wimco Nagar Metro,65239,75336,0,1712,23354,0,0,90305,0,0,0,0,250,250,1780,625,2405,1563,564,2127,1627,35,81,0,0,3,52,565,736
1,10/12/2022,01F1-Thiruvotriyur Metro,74980,67920,0,1384,21770,0,0,98134,0,0,0,0,0,0,1708,584,2292,1559,508,2067,1534,20,3,0,0,9,47,549,628
1,10/12/2022,01F3-Thiruvotriyur Theradi Metro,70752,86429,0,1984,28686,0,0,101422,0,0,0,0,0,0,1983,827,2810,1924,771,2695,1980,19,78,0,0,5,64,766,932
1,10/12/2022,01F5-Kaladipet Metro,69677,64790,0,1344,21690,0,0,92711,0,0,0,0,0,0,1751,663,2414,1593,585,2178,1580,13,0,1,0,1,48,612,675
1,10/12/2022,01F7-Tollgate Metro,39258,41665,0,736,15252,0,0,55246,0,0,0,0,0,0,1093,482,1575,1029,443,1472,995,14,0,1,0,15,24,451,505
1,10/12/2022,01F9-New Washermenpet Metro,61754,65809,100,616,21216,0,0,83686,0,0,0,0,0,0,1895,671,2566,1671,618,2289,1733,10,105,0,0,5,27,641,788
1,10/12/2022,01FB-Tondiarpet Metro,60246,73882,1200,1384,31250,0,0,94080,0,0,0,0,500,500,1759,973,2732,1687,771,2458,1658,15,1,2,0,6,50,922,996
1,10/12/2022,01FD-Thiagaraya College Metro,79385,88934,100,1896,33932,0,0,115313,0,0,0,0,2000,2000,2355,1160,3515,2219,952,3171,2235,79,48,5,0,6,67,1076,1281
1,10/12/2022,0101-Washermanpet,67887,80471,20,2056,30338,0,0,100301,0,0,0,0,12000,12000,2110,1066,3176,1924,1058,2982,2043,10,141,0,0,12,74,972,1209
1,10/12/2022,0103-Mannadi,60668,75545,0,1376,25912,0,0,87956,0,0,0,0,0,0,1909,894,2803,2016,870,2886,2067,14,141,0,0,7,43,846,1051
1,10/12/2022,0105-High Court,58478,109303,210,2112,38724,0,0,99524,0,0,0,0,0,0,2592,1359,3951,2841,1265,4106,2916,14,175,0,0,11,84,1245,1529
1,10/12/2022,0109-Government Estate,68020,108939,100,2640,32232,0,0,102992,0,0,0,0,1000,1000,2850,1211,4061,2787,1371,4158,3204,22,494,5,0,1,110,1071,1703
1,10/12/2022,0111-LIC,38305,69528,480,1552,24194,0,0,64531,0,0,0,0,1000,1000,1487,838,2325,1838,666,2504,1783,13,1,0,0,4,55,763,836
1,10/12/2022,0113-Thousand Lights,58289,118770,700,2632,36696,0,0,98317,0,0,0,0,0,0,2941,1323,4264,3380,1119,4499,3280,18,0,2,0,1,109,1196,1326
1,10/12/2022,0115-AG-DMS,40273,56816,50,656,16884,0,0,57863,0,0,0,0,0,0,1385,554,1939,1376,529,1905,1489,15,178,0,0,1,26,514,734
1,10/12/2022,0117-Teynampet,39293,61413,200,1208,21494,0,0,62195,0,0,0,0,0,0,1435,786,2221,1711,664,2375,1632,13,1,0,0,2,46,725,787
1,10/12/2022,0119-Nandanam,40156,61088,279,1584,22318,0,0,64337,0,0,0,0,0,0,1473,819,2292,1642,658,2300,1592,18,0,0,0,1,63,740,822
1,10/12/2022,0121-Saidapet,34812,46624,0,1088,22688,0,0,58588,0,0,0,0,8000,8000,826,772,1598,980,634,1614,906,16,2,0,0,2,42,723,785
1,10/12/2022,0123-Little Mount,44165,52061,1100,1760,18206,0,0,65231,0,0,0,0,1250,1250,1416,668,2084,1169,534,1703,1326,10,207,0,0,4,73,585,879
1,10/12/2022,0125-Guindy,73351,146271,1570,4344,64412,0,0,143677,0,0,0,0,3000,3000,3022,2199,5221,2979,1921,4900,3141,29,352,5,0,4,156,2011,2557
1,10/12/2022,0129-Nanganallur Road,19140,25518,0,480,10894,0,0,30514,0,0,0,0,0,0,464,339,803,573,313,886,529,3,0,2,0,0,16,322,343
1,10/12/2022,0131-Meenambakkam,55768,77337,350,2632,32172,0,0,90922,0,0,0,0,0,0,1651,959,2610,1375,794,2169,1515,14,182,1,0,2,80,879,1158
1,10/12/2022,0133-Chennai International Airport,141280,287848,814,8520,144288,0,0,294902,0,0,0,0,4500,4500,3541,4011,7552,3907,3833,7740,4453,60,1163,16,0,21,263,3696,5219
2,10/12/2022,0201-Puratchi Thalaivar Dr. M.G. Ramachandran Central,153913,358877,410,9664,195224,0,0,359211,0,0,0,0,2600,2600,6394,6642,13036,6091,6710,12801,6508,84,1421,14,0,27,397,6242,8185
2,10/12/2022,0203-Egmore,79639,128912,200,3936,62946,0,0,146721,0,0,0,0,25500,25500,1988,2224,4212,2372,3043,5415,2697,22,666,11,0,12,153,2055,2919
2,10/12/2022,0205-Nehru Park,27772,33825,100,928,13372,0,0,42172,0,0,0,0,0,0,857,480,1337,741,404,1145,828,23,127,0,0,2,36,424,612
2,10/12/2022,0207-Kilpauk,20522,32931,250,712,11190,0,0,32674,0,0,0,0,1000,1000,723,416,1139,803,409,1212,842,15,76,0,0,0,36,377,504
2,10/12/2022,0209-Pachaiyappas College,33878,30953,0,328,10950,0,0,45156,0,0,0,0,14000,14000,794,372,1166,766,364,1130,796,8,97,0,0,1,14,351,471
2,10/12/2022,0211-Shenoy Nagar,26421,28934,100,824,9248,0,0,36593,0,0,0,0,2000,2000,790,338,1128,713,327,1040,771,5,97,1,0,1,35,301,440
2,10/12/2022,0213-Anna Nagar East,49515,67512,2500,1616,19676,0,0,73307,0,0,0,0,1500,1500,1780,715,2495,1747,715,2462,1847,12,230,0,0,2,63,642,949
2,10/12/2022,0215-Anna Nagar Tower,51647,62117,100,1376,20230,0,0,73353,0,0,0,0,0,0,1585,716,2301,1414,772,2186,1576,12,253,0,0,3,56,656,980
2,10/12/2022,0217-Thirumangalam,137880,187790,750,5272,71386,0,0,215288,0,0,0,0,0,0,4300,2402,6702,3922,2389,6311,4274,41,667,3,0,6,200,2186,3103
2,10/12/2022,0219-Koyambedu,95333,155714,0,4768,74744,0,0,174845,0,0,0,0,8750,8750,2926,2583,5509,2555,1976,4531,2954,34,620,4,0,2,187,2365,3212
2,10/12/2022,0221-Puratchi Thalaivi Dr. J. Jayalalithaa CMBT,53246,143686,0,2440,68876,0,0,124562,0,0,0,0,0,0,1696,2264,3960,3034,3942,6976,2766,22,492,6,0,7,97,2151,2775
2,10/12/2022,0223-Arumbakkam,40707,52879,100,1240,28376,0,0,70423,0,0,0,0,4500,4500,1090,1004,2094,1105,689,1794,1011,43,4,0,0,5,59,931,1042
2,10/12/2022,0225-Vadapalani,94057,156704,1250,6616,64582,0,0,166505,0,0,0,0,4500,4500,3268,2331,5599,3165,2401,5566,3520,34,660,5,0,15,246,2029,2989
2,10/12/2022,0227-Ashok Nagar,67499,98953,300,3224,44256,0,0,115279,0,0,0,0,3000,3000,2039,1514,3553,1913,1386,3299,2109,22,296,0,0,1,131,1350,1800
2,10/12/2022,0229-Ekkattuthangal,52752,68046,100,2192,24726,0,0,79770,0,0,0,0,250,250,1678,877,2555,1434,757,2191,1714,10,373,1,0,0,86,758,1228
2,10/12/2022,0231-Arignar Anna Alandur,99338,127670,550,3984,51452,0,0,155324,0,0,0,0,1500,1500,2734,1747,4481,2554,1504,4058,2845,30,548,2,0,9,148,1565,2302
2,10/12/2022,0233-St. Thomas Mount,52600,73251,383,2888,31344,0,0,87215,0,0,0,0,3200,3200,1494,1081,2575,1478,931,2409,1558,30,271,6,0,2,108,950,1367
1,11/12/2022,01ED-Wimco Nagar Depot Metro,54769,63420,0,1720,30950,0,0,87439,0,0,0,0,2250,2250,1023,761,1784,1011,516,1527,978,15,0,0,0,15,47,717,794
1,11/12/2022,01EF-Wimco Nagar Metro,54878,74169,0,1992,34020,0,0,90890,0,0,0,0,2000,2000,1240,883,2123,1195,846,2041,1212,38,75,1,0,15,54,816,999
1,11/12/2022,01F1-Thiruvotriyur Metro,61386,77805,0,2760,32640,0,0,96786,0,0,0,0,0,0,1396,885,2281,1452,807,2259,1455,26,0,2,0,15,95,821,959
1,11/12/2022,01F3-Thiruvotriyur Theradi Metro,61720,100960,250,2072,47906,0,0,111948,0,0,0,0,0,0,1547,1309,2856,1724,1265,2989,1725,27,81,1,0,16,61,1236,1422
1,11/12/2022,01F5-Kaladipet Metro,63932,70364,0,1680,32060,0,0,97672,0,0,0,0,0,0,1375,934,2309,1372,986,2358,1337,18,0,1,0,17,50,879,965
1,11/12/2022,01F7-Tollgate Metro,30883,46229,100,504,23440,0,0,54927,0,0,0,0,0,0,804,680,1484,854,634,1488,825,20,0,0,0,14,17,651,702
1,11/12/2022,01F9-New Washermenpet Metro,44531,61843,0,704,26150,0,0,71385,0,0,0,0,250,250,1267,789,2056,1227,731,1958,1286,6,108,0,0,8,24,763,909
1,11/12/2022,01FB-Tondiarpet Metro,44624,69145,800,1608,35066,0,0,82098,0,0,0,0,250,250,1226,1040,2266,1329,1003,2332,1253,11,0,2,0,18,47,987,1065
1,11/12/2022,01FD-Thiagaraya College Metro,68776,89513,30,3048,43250,0,0,115104,0,0,0,0,2000,2000,1675,1369,3044,1774,1254,3028,1771,41,52,0,0,4,73,1283,1453
1,11/12/2022,0101-Washermanpet,57987,78049,200,1384,41208,0,0,100779,0,0,0,0,18000,18000,1385,1304,2689,1363,1306,2669,1400,15,142,1,0,13,55,1239,1465
1,11/12/2022,0103-Mannadi,37925,65992,0,1672,33072,0,0,72669,0,0,0,0,1500,1500,1174,1131,2305,1225,1094,2319,1273,15,146,2,0,10,56,1060,1289
1,11/12/2022,0105-High Court,33863,67485,380,1512,33844,0,0,69599,0,0,0,0,0,0,1354,1216,2570,1229,1086,2315,1390,14,238,3,0,9,64,1142,1470
1,11/12/2022,0109-Government Estate,47120,74802,100,1768,31356,0,0,80344,0,0,0,0,0,0,1555,1147,2702,1446,1239,2685,1725,13,378,2,0,4,71,1048,1516
1,11/12/2022,0111-LIC,12962,46455,0,1704,22730,0,0,37396,0,0,0,0,0,0,723,810,1533,997,747,1744,930,10,2,0,0,6,71,718,807
1,11/12/2022,0113-Thousand Lights,28548,65253,200,1888,30794,0,0,61430,0,0,0,0,0,0,1138,1067,2205,1553,1148,2701,1371,19,0,1,0,9,68,967,1064
1,11/12/2022,0115-AG-DMS,28844,42230,500,1032,15954,0,0,46330,0,0,0,0,2000,2000,884,524,1408,790,608,1398,940,6,226,0,0,2,39,486,759
1,11/12/2022,0117-Teynampet,19376,43380,0,1272,21416,0,0,42064,0,0,0,0,0,0,714,755,1469,945,782,1727,874,13,1,0,0,4,54,704,776
1,11/12/2022,0119-Nandanam,30891,46791,500,1664,21922,0,0,54977,0,0,0,0,0,0,926,792,1718,1008,672,1680,992,14,50,2,0,5,68,713,852
1,11/12/2022,0121-Saidapet,15828,42926,0,1672,24036,0,0,41536,0,0,0,0,0,0,546,804,1350,751,810,1561,697,7,1,0,0,3,51,757,819
1,11/12/2022,0123-Little Mount,30952,50906,800,1528,23316,0,0,56596,0,0,0,0,0,0,1105,842,1947,931,681,1612,1068,13,237,0,0,4,57,757,1068
1,11/12/2022,0125-Guindy,58593,150789,528,5584,79768,0,0,144473,0,0,0,0,0,0,2291,2647,4938,2304,2561,4865,2515,20,541,2,0,8,192,2400,3163
1,11/12/2022,0129-Nanganallur Road,12960,24664,100,736,14570,0,0,28366,0,0,0,0,0,0,289,435,724,420,395,815,368,3,1,1,0,0,26,412,443
1,11/12/2022,0131-Meenambakkam,49890,87446,700,2552,45850,0,0,98992,0,0,0,0,0,0,1393,1242,2635,1129,986,2115,1315,14,336,1,0,10,86,1163,1610
1,11/12/2022,0133-Chennai International Airport,118727,291025,2500,9856,168016,0,0,299099,0,0,0,0,3000,3000,3420,4606,8026,3370,4036,7406,3788,55,970,6,1,31,309,4233,5605
2,11/12/2022,0201-Puratchi Thalaivar Dr. M.G. Ramachandran Central,131592,354493,350,13544,218166,0,0,363652,0,0,0,0,1650,1650,5258,7711,12969,4332,6829,11161,5176,98,1383,12,0,31,515,7160,9199
2,11/12/2022,0203-Egmore,58413,120267,400,4448,68342,0,0,131603,0,0,0,0,8750,8750,1756,2418,4174,1700,2922,4622,1970,27,538,9,0,12,171,2256,3013
2,11/12/2022,0205-Nehru Park,15920,27998,0,720,13528,0,0,30168,0,0,0,0,0,0,540,497,1037,528,494,1022,562,10,150,0,0,0,33,453,646
2,11/12/2022,0207-Kilpauk,16482,27910,0,656,11700,0,0,28838,0,0,0,0,0,0,537,405,942,560,440,1000,613,12,89,0,0,8,28,371,508
2,11/12/2022,0209-Pachaiyappas College,28086,25230,0,728,10430,0,0,39244,0,0,0,0,12500,12500,545,387,932,503,382,885,572,13,107,1,0,1,30,355,507
2,11/12/2022,0211-Shenoy Nagar,19025,23071,100,280,9356,0,0,28761,0,0,0,0,2000,2000,516,319,835,490,354,844,543,4,98,0,0,5,15,304,426
2,11/12/2022,0213-Anna Nagar East,50813,61606,200,1784,26954,0,0,79751,0,0,0,0,6000,6000,1336,957,2293,1293,906,2199,1379,12,198,0,0,4,82,862,1158
2,11/12/2022,0215-Anna Nagar Tower,32395,56837,300,2296,21872,0,0,56863,0,0,0,0,0,0,1218,819,2037,1219,852,2071,1331,12,258,0,0,3,94,717,1084
2,11/12/2022,0217-Thirumangalam,123220,201227,1030,7352,86590,0,0,218192,0,0,0,0,0,0,3832,2875,6707,3547,3116,6663,4118,41,1007,6,0,10,269,2574,3907
2,11/12/2022,0219-Koyambedu,72445,148836,1030,4536,82708,0,0,160719,0,0,0,0,1500,1500,2480,2760,5240,2091,2333,4424,2438,19,632,4,0,11,200,2571,3437
2,11/12/2022,0221-Puratchi Thalaivi Dr. J. Jayalalithaa CMBT,49091,157166,300,4032,91042,0,0,144465,0,0,0,0,0,0,1975,2983,4958,2329,3855,6184,2445,15,701,16,0,12,174,2798,3716
2,11/12/2022,0223-Arumbakkam,29666,46769,500,960,27318,0,0,58444,0,0,0,0,6000,6000,785,951,1736,903,702,1605,794,30,4,0,0,13,49,892,988
2,11/12/2022,0225-Vadapalani,83922,185534,700,6928,84954,0,0,176504,0,0,0,0,1500,1500,3408,3034,6442,3235,2951,6186,3747,40,987,2,0,18,279,2654,3980
2,11/12/2022,0227-Ashok Nagar,49225,92467,300,2608,48324,0,0,100457,0,0,0,0,6000,6000,1569,1566,3135,1614,1537,3151,1676,14,324,3,0,4,95,1447,1887
2,11/12/2022,0229-Ekkattuthangal,34940,52034,550,2384,21180,0,0,59054,0,0,0,0,0,0,1081,795,1876,1047,921,1968,1248,10,297,4,0,4,103,671,1089
2,11/12/2022,0231-Arignar Anna Alandur,85195,142469,330,4032,68070,0,0,157627,0,0,0,0,500,500,2578,2214,4792,2314,2044,4358,2651,30,717,9,0,16,159,2010,2941
2,11/12/2022,0233-St. Thomas Mount,36962,77473,50,3288,43016,0,0,83316,0,0,0,3400,1000,4400,1167,1412,2579,1278,1189,2467,1259,20,188,6,0,6,113,1282,1615
1,12/12/2022,01ED-Wimco Nagar Depot Metro,103973,86367,200,1744,26134,0,0,132051,0,0,0,0,3750,3750,2271,660,2931,1910,246,2156,1900,12,1,3,0,5,43,644,708
1,12/12/2022,01EF-Wimco Nagar Metro,146988,134363,2315,2312,31844,0,0,183459,0,0,0,0,2250,2250,3383,845,4228,3119,922,4041,3170,43,94,4,0,9,67,772,989
1,12/12/2022,01F1-Thiruvotriyur Metro,143188,106993,100,1080,22242,0,0,166610,0,0,0,0,0,0,2877,624,3501,2900,594,3494,2831,32,0,1,0,9,32,589,663
1,12/12/2022,01F3-Thiruvotriyur Theradi Metro,123557,130332,600,1536,33726,0,0,159419,0,0,0,0,0,0,3028,952,3980,3247,1025,4272,3301,24,82,3,0,6,53,893,1061
1,12/12/2022,01F5-Kaladipet Metro,129068,109268,100,1168,28150,0,0,158486,0,0,0,0,0,0,3073,892,3965,3044,808,3852,3015,26,0,1,0,1,43,842,913
1,12/12/2022,01F7-Tollgate Metro,68807,60434,0,1008,16676,0,0,86491,0,0,0,0,0,0,1655,542,2197,1628,488,2116,1603,19,0,0,0,4,34,498,555
1,12/12/2022,01F9-New Washermenpet Metro,120816,100726,300,1144,13268,0,0,135528,0,0,0,0,500,500,3317,399,3716,3054,637,3691,3362,15,364,0,0,3,42,420,844
1,12/12/2022,01FB-Tondiarpet Metro,110509,108719,768,1320,28414,0,0,141011,0,0,0,0,1250,1250,2998,965,3963,3204,907,4111,3155,22,0,0,0,9,44,905,980
1,12/12/2022,01FD-Thiagaraya College Metro,146478,128255,800,1520,32234,0,0,181032,0,0,0,0,1250,1250,3682,1125,4807,3941,1119,5060,3929,49,49,2,0,3,59,1056,1218
1,12/12/2022,0101-Washermanpet,123463,127419,2200,2224,37168,0,0,165055,0,0,0,0,13750,13750,3764,1322,5086,3604,1347,4951,3659,20,123,0,0,3,88,1232,1466
1,12/12/2022,0103-Mannadi,94002,109648,0,984,30516,0,0,125502,0,0,0,0,3000,3000,2973,1051,4024,3382,1183,4565,3358,14,87,0,0,4,39,997,1141
1,12/12/2022,0105-High Court,174566,232897,500,2728,58098,0,0,235892,0,0,0,0,0,0,6902,2127,9029,6999,1870,8869,7194,37,307,0,0,2,115,1979,2440
1,12/12/2022,0109-Government Estate,110256,152050,750,2040,39656,0,0,152702,0,0,0,0,3500,3500,4279,1511,5790,4793,1682,6475,4988,30,300,2,0,1,96,1371,1800
1,12/12/2022,0111-LIC,102569,168780,350,2144,30526,0,0,135589,0,0,0,0,0,0,4826,1113,5939,5641,1048,6689,5555,26,1,1,0,0,86,1000,1114
1,12/12/2022,0113-Thousand Lights,182738,273142,2050,6216,49800,0,0,240804,0,0,0,0,250,250,7861,1888,9749,9037,1789,10826,8982,50,0,0,0,5,231,1588,1874
1,12/12/2022,0115-AG-DMS,122740,156052,2320,1992,27512,0,0,154564,0,0,0,0,500,500,5025,928,5953,4917,940,5857,5067,31,203,0,0,0,77,861,1172
1,12/12/2022,0117-Teynampet,135254,144504,1400,2320,31468,0,0,170442,0,0,0,0,0,0,4123,1199,5322,4845,1201,6046,4754,25,2,0,0,9,88,1086,1210
1,12/12/2022,0119-Nandanam,115552,139872,735,1944,32696,0,0,150927,0,0,0,0,2750,2750,3983,1234,5217,4715,1177,5892,4612,29,2,0,0,4,83,1107,1225
1,12/12/2022,0121-Saidapet,62589,90023,0,1864,25826,0,0,90279,0,0,0,0,10000,10000,2038,941,2979,2633,890,3523,2585,17,0,1,0,2,63,864,947
1,12/12/2022,0123-Little Mount,116602,102222,400,1848,22878,0,0,141728,0,0,0,0,4000,4000,3698,892,4590,3117,825,3942,3232,26,207,0,0,3,82,765,1083
1,12/12/2022,0125-Guindy,169523,277342,1380,9168,82524,0,0,262595,0,0,0,0,2000,2000,8172,3019,11191,7474,2635,10109,7801,48,396,2,0,6,300,2650,3402
1,12/12/2022,0129-Nanganallur Road,52035,49351,200,904,14016,0,0,67155,0,0,0,0,0,0,1288,441,1729,1386,371,1757,1349,13,0,0,0,0,22,403,438
1,12/12/2022,0131-Meenambakkam,129538,141878,1400,4760,41498,0,0,177196,0,0,0,0,0,0,4011,1209,5220,3100,925,4025,3371,21,322,0,0,5,94,1129,1571
1,12/12/2022,0133-Chennai International Airport,207896,351195,700,8624,141862,0,0,359082,0,0,0,0,23250,23250,5489,3976,9465,5959,3822,9781,6728,52,1100,8,0,14,267,3631,5072
2,12/12/2022,0201-Puratchi Thalaivar Dr. M.G. Ramachandran Central,277449,493786,1200,16576,215178,0,0,510403,0,0,0,0,13050,13050,13082,7792,20874,11604,7781,19385,12073,117,1163,5,0,32,655,7001,8973
2,12/12/2022,0203-Egmore,86123,147587,0,4792,75652,0,0,166567,0,0,0,0,12000,12000,2964,2758,5722,2871,2994,5865,2981,22,461,4,0,4,187,2533,3211
2,12/12/2022,0205-Nehru Park,55671,46128,0,544,13816,0,0,70031,0,0,0,0,250,250,1497,534,2031,1345,533,1878,1378,23,123,0,0,1,28,496,671
2,12/12/2022,0207-Kilpauk,50865,61082,100,1048,16238,0,0,68251,0,0,0,0,0,0,1668,611,2279,1800,566,2366,1817,20,85,0,0,4,42,559,710
2,12/12/2022,0209-Pachaiyappas College,54292,53504,0,656,14982,0,0,69930,0,0,0,0,4000,4000,1654,576,2230,1609,536,2145,1629,10,81,1,0,0,28,538,658
2,12/12/2022,0211-Shenoy Nagar,50561,51215,0,960,11640,0,0,63161,0,0,0,0,2250,2250,1430,428,1858,1543,533,2076,1615,10,127,0,0,3,35,387,562
2,12/12/2022,0213-Anna Nagar East,109098,119974,400,2696,29740,0,0,141934,0,0,0,0,3000,3000,3345,1071,4416,3389,1082,4471,3534,29,242,1,0,0,89,984,1345
2,12/12/2022,0215-Anna Nagar Tower,93357,101810,1700,1592,24972,0,0,121621,0,0,0,0,2500,2500,2846,882,3728,2924,911,3835,2994,20,180,8,0,1,60,801,1070
2,12/12/2022,0217-Thirumangalam,331429,330690,2530,8168,75564,0,0,417691,0,0,0,0,0,0,9098,2658,11756,8913,2976,11889,9522,73,843,7,0,4,278,2316,3521
2,12/12/2022,0219-Koyambedu,254511,265675,1128,5024,101144,0,0,361807,0,0,0,5000,17500,22500,6631,3404,10035,5643,2380,8023,6052,51,634,2,0,12,195,3197,4091
2,12/12/2022,0221-Puratchi Thalaivi Dr. J. Jayalalithaa CMBT,98532,213990,130,6168,103920,0,0,208750,0,0,0,0,0,0,3551,3464,7015,3631,3798,7429,4222,31,974,3,0,1,224,3221,4454
2,12/12/2022,0223-Arumbakkam,65215,73162,0,1408,27876,0,0,94499,0,0,0,0,4250,4250,1786,1020,2806,1957,827,2784,1847,55,0,4,0,4,55,946,1064
2,12/12/2022,0225-Vadapalani,148570,217206,550,5392,74304,0,0,228816,0,0,0,0,8500,8500,5067,2556,7623,5138,2610,7748,5484,42,639,4,0,8,203,2279,3175
2,12/12/2022,0227-Ashok Nagar,106651,173096,800,5608,59614,0,0,172673,0,0,0,0,0,0,4103,2064,6167,4196,1905,6101,4417,24,383,1,0,4,202,1804,2418
2,12/12/2022,0229-Ekkattuthangal,120875,139978,750,3216,27766,0,0,152607,0,0,0,0,0,0,3922,1018,4940,4317,1224,5541,4511,31,338,0,0,1,121,869,1360
2,12/12/2022,0231-Arignar Anna Alandur,187607,210925,1900,5504,66000,0,0,261011,0,0,0,0,5500,5500,5892,2279,8171,5220,1865,7085,5655,56,590,5,0,1,199,2025,2876
2,12/12/2022,0233-St. Thomas Mount,107632,114711,100,3808,35708,0,0,147248,0,0,0,0,5500,5500,3121,1266,4387,3049,1067,4116,3112,21,150,2,0,1,122,1113,1409
1,13/12/2022,01ED-Wimco Nagar Depot Metro,88426,81839,100,1464,25246,0,0,115236,0,0,0,0,4250,4250,2253,600,2853,1796,435,2231,1798,11,0,0,0,5,35,633,684
1,13/12/2022,01EF-Wimco Nagar Metro,136123,129262,250,3000,27676,0,0,167049,0,0,0,0,0,0,3482,669,4151,3021,850,3871,3163,33,155,4,0,4,92,685,973
1,13/12/2022,01F1-Thiruvotriyur Metro,110930,96454,0,1016,18074,0,0,130020,0,0,0,0,0,0,2872,430,3302,2667,469,3136,2653,31,0,3,1,4,34,484,557
1,13/12/2022,01F3-Thiruvotriyur Theradi Metro,118892,122731,0,2056,29600,0,0,150548,0,0,0,0,0,0,2988,705,3693,3158,899,4057,3164,22,48,3,0,3,51,776,903
1,13/12/2022,01F5-Kaladipet Metro,107323,101658,200,1520,22826,0,0,131869,0,0,0,0,0,0,3050,616,3666,2954,641,3595,2923,16,0,2,0,3,48,664,733
1,13/12/2022,01F7-Tollgate Metro,61931,61216,400,888,15182,0,0,78401,0,0,0,0,250,250,1780,386,2166,1711,463,2174,1703,25,2,0,0,13,30,459,529
1,13/12/2022,01F9-New Washermenpet Metro,94041,92126,300,704,18968,0,0,114013,0,0,0,0,500,500,2912,555,3467,2866,624,3490,2891,23,56,0,0,0,23,606,708
1,13/12/2022,01FB-Tondiarpet Metro,95441,97650,12,1096,22724,0,0,119273,0,0,0,0,1000,1000,2918,670,3588,2979,779,3758,2964,22,0,0,0,3,34,736,795
1,13/12/2022,01FD-Thiagaraya College Metro,111842,120780,700,1720,29076,0,0,143338,0,0,0,0,1000,1000,3621,770,4391,3729,910,4639,3748,38,32,0,0,3,61,929,1063
1,13/12/2022,0101-Washermanpet,122805,124473,1440,2200,36352,0,0,162797,0,0,0,0,22750,22750,3710,1076,4786,3524,1225,4749,3578,22,117,0,0,8,71,1148,1366
1,13/12/2022,0103-Mannadi,86830,113810,200,1000,31348,0,0,119378,0,0,0,0,3000,3000,3124,899,4023,3496,1088,4584,3484,20,92,0,0,1,42,1026,1181
1,13/12/2022,0105-High Court,160669,266009,550,2736,76900,0,0,240855,0,0,0,0,0,0,7527,2205,9732,7687,2281,9968,7774,37,221,0,0,4,116,2558,2936
1,13/12/2022,0109-Government Estate,101867,164263,800,2184,48962,0,0,153813,0,0,0,0,3750,3750,4467,1468,5935,4921,1867,6788,5054,34,267,2,0,4,97,1673,2077
1,13/12/2022,0111-LIC,93572,177578,1400,3760,31770,0,0,130502,0,0,0,0,5750,5750,4997,985,5982,5883,1058,6941,5881,18,0,9,0,2,116,1030,1175
1,13/12/2022,0113-Thousand Lights,163958,269791,3180,5928,45160,0,0,218226,0,0,0,0,250,250,8137,1424,9561,9061,1550,10611,9060,34,0,0,0,4,223,1425,1686
1,13/12/2022,0115-AG-DMS,126367,153686,350,2408,25180,0,0,154305,0,0,0,0,1250,1250,5049,763,5812,4983,779,5762,5116,32,164,0,0,0,105,782,1083
1,13/12/2022,0117-Teynampet,118720,142782,1124,1632,31786,0,0,153262,0,0,0,0,1000,1000,4086,1010,5096,4777,1094,5871,4722,18,0,0,0,2,71,1096,1187
1,13/12/2022,0119-Nandanam,113194,137919,3418,2448,26326,0,0,145386,0,0,0,0,3750,3750,4247,850,5097,4742,932,5674,4816,24,119,0,0,0,109,877,1129
1,13/12/2022,0121-Saidapet,59079,89535,0,2176,23410,0,0,84665,0,0,0,0,750,750,2211,743,2954,2695,803,3498,2662,18,0,0,0,5,72,781,876
1,13/12/2022,0123-Little Mount,101123,108335,860,2096,24814,0,0,128893,0,0,0,0,2750,2750,3831,806,4637,3198,776,3974,3377,18,221,1,0,7,94,851,1192
1,13/12/2022,0125-Guindy,138854,272261,3000,6624,76462,0,0,224940,0,0,0,0,2000,2000,8231,2426,10657,7525,2501,10026,7874,50,379,4,0,1,272,2449,3155
1,13/12/2022,0129-Nanganallur Road,56155,48728,1230,1664,12344,0,0,71393,0,0,0,0,0,0,1295,325,1620,1429,353,1782,1395,5,0,1,0,0,30,360,396
1,13/12/2022,0131-Meenambakkam,127054,136474,1800,2584,36742,0,0,168180,0,0,0,0,0,0,4019,987,5006,3207,942,4149,3382,18,213,3,0,4,81,989,1308
1,13/12/2022,0133-Chennai International Airport,213081,350586,1450,9192,129806,0,0,353529,0,0,0,0,15000,15000,5881,3224,9105,6198,3857,10055,7075,63,1266,7,0,14,280,3333,4963
2,13/12/2022,0201-Puratchi Thalaivar Dr. M.G. Ramachandran Central,236300,462341,1950,13912,189296,0,0,441458,0,0,0,0,10950,10950,12345,5839,18184,11443,6857,18300,11950,132,1121,5,0,16,504,6243,8021
2,13/12/2022,0203-Egmore,88729,135104,500,3424,58626,0,0,151279,0,0,0,0,5350,5350,2777,1847,4624,2809,2612,5421,3097,21,612,6,0,4,151,1975,2769
2,13/12/2022,0205-Nehru Park,47425,43214,0,872,11058,0,0,59355,0,0,0,0,2000,2000,1435,391,1826,1273,414,1687,1362,23,144,1,0,0,32,391,591
2,13/12/2022,0207-Kilpauk,42747,57063,0,2304,15496,0,0,60547,0,0,0,0,250,250,1536,473,2009,1685,587,2272,1701,14,91,2,0,2,37,515,661
2,13/12/2022,0209-Pachaiyappas College,49598,49012,0,824,12764,0,0,63186,0,0,0,0,5000,5000,1651,424,2075,1476,421,1897,1518,26,81,1,0,0,36,456,600
2,13/12/2022,0211-Shenoy Nagar,51409,48593,600,656,9864,0,0,62529,0,0,0,0,2000,2000,1431,324,1755,1502,426,1928,1557,17,120,0,0,4,28,330,499
2,13/12/2022,0213-Anna Nagar East,92059,119072,1095,2496,29142,0,0,124792,0,0,0,0,1500,1500,3401,892,4293,3450,1028,4478,3560,22,219,1,0,7,106,949,1304
2,13/12/2022,0215-Anna Nagar Tower,116662,101711,1000,1584,24704,0,0,143950,0,0,0,0,2250,2250,3093,729,3822,2883,881,3764,2982,21,213,0,0,1,64,808,1107
2,13/12/2022,0217-Thirumangalam,315740,330711,1000,8544,69558,0,0,394842,0,0,0,0,0,0,9384,2056,11440,9103,2820,11923,9759,62,909,6,0,5,298,2132,3412
2,13/12/2022,0219-Koyambedu,197025,246348,1890,4472,78232,0,0,281619,0,0,0,5000,8000,13000,6388,2301,8689,5795,2127,7922,6202,45,616,3,0,5,190,2431,3290
2,13/12/2022,0221-Puratchi Thalaivi Dr. J. Jayalalithaa CMBT,77006,169634,1224,2888,78932,0,0,160050,0,0,0,0,0,0,2728,2137,4865,3639,3367,7006,3584,33,427,0,0,3,122,2484,3069
2,13/12/2022,0223-Arumbakkam,66897,68989,60,1720,24234,0,0,92911,0,0,0,0,4500,4500,1827,750,2577,1928,727,2655,1825,38,1,1,0,2,67,836,945
2,13/12/2022,0225-Vadapalani,125527,207921,1640,5640,73048,0,0,205855,0,0,0,0,5500,5500,4845,2134,6979,5006,2503,7509,5285,21,525,2,0,6,207,2310,3071
2,13/12/2022,0227-Ashok Nagar,95622,152493,700,3264,51218,0,0,150804,0,0,0,0,6000,6000,3878,1467,5345,3838,1535,5373,4012,24,297,5,0,0,126,1597,2049
2,13/12/2022,0229-Ekkattuthangal,100841,139831,100,2888,27378,0,0,131207,0,0,0,0,250,250,4228,819,5047,4351,1044,5395,4544,26,315,1,1,1,117,843,1304
2,13/12/2022,0231-Arignar Anna Alandur,177792,203390,1275,4232,57552,0,0,240851,0,0,0,0,4500,4500,5926,1663,7589,5470,1750,7220,5734,51,429,2,0,5,163,1764,2414
2,13/12/2022,0233-St. Thomas Mount,109962,116890,748,4696,35148,0,0,150554,0,0,0,3000,3450,6450,3238,1124,4362,3106,1072,4178,3220,33,165,1,1,0,129,1085,1414
1,14/12/2022,01ED-Wimco Nagar Depot Metro,85159,83165,0,944,23930,0,0,110033,0,0,0,0,4250,4250,2316,591,2907,1900,455,2355,1880,16,4,1,0,5,29,576,631
1,14/12/2022,01EF-Wimco Nagar Metro,117969,133230,300,4536,30734,0,0,153539,0,0,0,0,2250,2250,3439,771,4210,3089,950,4039,3184,35,115,1,0,11,79,760,1001
1,14/12/2022,01F1-Thiruvotriyur Metro,118706,105345,0,1528,22850,0,0,143084,0,0,0,0,0,0,2936,644,3580,2775,533,3308,2751,24,0,2,0,8,50,595,679
1,14/12/2022,01F3-Thiruvotriyur Theradi Metro,106543,125725,2300,1512,32256,0,0,142611,0,0,0,0,0,0,2998,924,3922,3247,928,4175,3234,17,15,2,0,4,50,865,953
1,14/12/2022,01F5-Kaladipet Metro,109533,106440,50,1792,25878,0,0,137253,0,0,0,0,0,0,3089,838,3927,2956,677,3633,2966,20,2,0,1,0,61,772,856
1,14/12/2022,01F7-Tollgate Metro,63690,60654,0,920,15988,0,0,80598,0,0,0,0,0,0,1759,511,2270,1641,449,2090,1638,23,0,0,0,15,24,469,531
1,14/12/2022,01F9-New Washermenpet Metro,93350,96490,100,936,20890,0,0,115276,0,0,0,0,1250,1250,2903,720,3623,2924,725,3649,2969,11,60,1,0,0,38,684,794
1,14/12/2022,01FB-Tondiarpet Metro,91127,104948,1100,2152,27606,0,0,121985,0,0,0,0,250,250,2963,902,3865,3084,845,3929,3061,22,5,1,0,3,41,856,928
1,14/12/2022,01FD-Thiagaraya College Metro,115139,134991,888,1672,40032,0,0,157731,0,0,0,0,3000,3000,3756,1342,5098,3893,1112,5005,3867,31,14,0,0,4,55,1278,1382
1,14/12/2022,0101-Washermanpet,112697,124878,300,2104,37526,0,0,152627,0,0,0,0,14250,14250,3718,1268,4986,3495,1236,4731,3564,18,104,4,0,2,78,1191,1397
1,14/12/2022,0103-Mannadi,82244,109456,300,824,28590,0,0,111958,0,0,0,0,0,0,2989,1004,3993,3436,1049,4485,3387,13,98,2,0,3,38,958,1112
1,14/12/2022,0105-High Court,147801,250290,2090,2528,69536,0,0,221955,0,0,0,0,0,0,7204,2426,9630,7353,1991,9344,7461,32,241,2,0,3,108,2294,2680
1,14/12/2022,0109-Government Estate,99529,161893,450,2480,48884,0,0,151343,0,0,0,0,1000,1000,4417,1770,6187,4771,1798,6569,4984,27,321,2,0,1,105,1648,2104
1,14/12/2022,0111-LIC,77707,159638,1677,2360,28422,0,0,110166,0,0,0,0,0,0,4565,1059,5624,5268,988,6256,5283,14,0,1,0,4,105,918,1042
1,14/12/2022,0113-Thousand Lights,143135,264355,2880,5616,48102,0,0,199733,0,0,0,0,0,0,7825,1828,9653,8712,1644,10356,8718,40,1,1,0,4,230,1522,1798
1,14/12/2022,0115-AG-DMS,124600,161197,1350,2336,27364,0,0,155650,0,0,0,0,1000,1000,5364,973,6337,5188,875,6063,5327,29,190,2,0,2,88,858,1169
1,14/12/2022,0117-Teynampet,102408,148848,800,2640,30454,0,0,136302,0,0,0,0,0,0,4355,1203,5558,5028,1146,6174,5015,23,0,0,0,4,109,1065,1201
1,14/12/2022,0119-Nandanam,116665,139862,360,2328,24926,0,0,144279,0,0,0,0,500,500,4417,968,5385,4836,973,5809,4939,38,176,1,0,3,93,828,1139
1,14/12/2022,0121-Saidapet,49182,90619,0,1752,25508,0,0,76442,0,0,0,0,2000,2000,2130,930,3060,2644,859,3503,2623,5,0,4,0,1,71,843,924
1,14/12/2022,0123-Little Mount,97671,107256,2000,2032,26986,0,0,128689,0,0,0,0,1000,1000,3795,1020,4815,3104,836,3940,3271,27,197,1,0,4,88,901,1218
1,14/12/2022,0125-Guindy,152496,283540,950,8040,82698,0,0,244184,0,0,0,0,3500,3500,8465,2970,11435,7671,2672,10343,8053,44,396,6,0,0,293,2608,3347
1,14/12/2022,0129-Nanganallur Road,53665,51014,200,904,11696,0,0,66465,0,0,0,0,0,0,1418,388,1806,1503,389,1892,1489,9,0,0,0,0,27,352,388
1,14/12/2022,0131-Meenambakkam,145761,142756,400,2880,39292,0,0,188333,0,0,0,0,0,0,4173,1170,5343,3310,1027,4337,3520,16,233,1,1,2,90,1083,1426
1,14/12/2022,0133-Chennai International Airport,205996,364965,1150,9392,145554,0,0,362092,0,0,0,0,7500,7500,5461,4088,9549,6210,4088,10298,7041,68,1122,13,0,13,290,3719,5225
2,14/12/2022,0201-Puratchi Thalaivar Dr. M.G. Ramachandran Central,222112,479615,1450,12712,200700,0,0,436974,0,0,0,0,5650,5650,12136,7227,19363,11584,7463,19047,12146,103,1068,11,0,24,510,6651,8367
2,14/12/2022,0203-Egmore,79522,137261,50,2592,68418,0,0,150582,0,0,0,0,17050,17050,2498,2414,4912,2735,2823,5558,2851,20,366,5,0,2,109,2307,2809
2,14/12/2022,0205-Nehru Park,47652,47060,600,624,12182,0,0,61058,0,0,0,0,3000,3000,1553,451,2004,1368,482,1850,1449,42,133,0,0,2,26,416,619
2,14/12/2022,0207-Kilpauk,37710,59823,140,888,17304,0,0,56042,0,0,0,0,1000,1000,1614,647,2261,1656,650,2306,1724,27,111,0,0,1,35,602,776
2,14/12/2022,0209-Pachaiyappas College,50185,55194,0,1168,15110,0,0,66463,0,0,0,0,6000,6000,1757,611,2368,1657,497,2154,1687,25,68,1,0,2,50,548,694
2,14/12/2022,0211-Shenoy Nagar,46574,50340,2000,1080,12916,0,0,62570,0,0,0,0,4250,4250,1422,471,1893,1478,478,1956,1537,5,110,0,0,1,45,425,586
2,14/12/2022,0213-Anna Nagar East,90984,123824,150,2512,31618,0,0,125264,0,0,0,0,0,0,3526,1163,4689,3513,1156,4669,3636,26,202,1,0,6,93,1036,1364
2,14/12/2022,0215-Anna Nagar Tower,98384,112254,730,1696,27490,0,0,128300,0,0,0,0,750,750,3078,987,4065,3133,988,4121,3293,17,247,0,0,2,79,899,1244
2,14/12/2022,0217-Thirumangalam,270940,338735,600,7984,86214,0,0,365738,0,0,0,0,0,0,9225,2965,12190,9095,2891,11986,9463,49,543,5,0,6,287,2629,3519
2,14/12/2022,0219-Koyambedu,193455,259390,1700,5200,93624,0,0,293979,0,0,0,5000,10250,15250,6469,3200,9669,5838,2449,8287,6107,61,481,1,0,10,179,2972,3704
2,14/12/2022,0221-Puratchi Thalaivi Dr. J. Jayalalithaa CMBT,68549,176123,700,3128,77844,0,0,150221,0,0,0,0,0,0,2849,2624,5473,3622,3916,7538,3823,27,554,5,0,4,125,2473,3188
2,14/12/2022,0223-Arumbakkam,72324,73361,0,1736,24944,0,0,99004,0,0,0,0,3500,3500,2016,918,2934,2068,805,2873,1983,59,0,4,1,11,62,844,981
2,14/12/2022,0225-Vadapalani,130081,213762,800,5808,76228,0,0,212917,0,0,0,0,8000,8000,4969,2720,7689,5175,2624,7799,5405,30,441,0,0,5,233,2448,3157
2,14/12/2022,0227-Ashok Nagar,106691,157139,700,3792,52102,0,0,163285,0,0,0,0,0,0,4030,1827,5857,4049,1678,5727,4205,33,282,3,0,5,136,1652,2111
2,14/12/2022,0229-Ekkattuthangal,98734,149183,2790,3408,29008,0,0,133940,0,0,0,0,250,250,4471,1108,5579,4567,1066,5633,4841,27,367,0,0,1,141,918,1454
2,14/12/2022,0231-Arignar Anna Alandur,158679,211081,2940,5680,60802,0,0,228101,0,0,0,0,7500,7500,6020,2150,8170,5487,1997,7484,5893,38,488,13,0,3,212,1869,2623
2,14/12/2022,0233-St. Thomas Mount,95924,115516,1100,3448,37086,0,0,137558,0,0,0,500,4125,4625,3136,1298,4434,2988,1119,4107,3079,22,123,3,0,1,120,1137,1406
1,15/12/2022,01ED-Wimco Nagar Depot Metro,78511,84503,0,1192,27652,0,0,107355,0,0,0,0,1750,1750,2237,721,2958,1830,489,2319,1813,12,0,0,0,5,35,688,740
1,15/12/2022,01EF-Wimco Nagar Metro,119878,128075,352,2408,27502,0,0,150140,0,0,0,0,500,500,3364,760,4124,3124,827,3951,3159,47,58,2,0,6,70,679,862
1,15/12/2022,01F1-Thiruvotriyur Metro,101440,98260,0,1480,19980,0,0,122900,0,0,0,0,0,0,2881,561,3442,2638,507,3145,2625,32,1,3,0,1,45,525,607
1,15/12/2022,01F3-Thiruvotriyur Theradi Metro,99833,125736,900,2616,31588,0,0,134937,0,0,0,0,0,0,3025,927,3952,3201,891,4092,3250,9,29,2,0,1,83,846,970
1,15/12/2022,01F5-Kaladipet Metro,98247,101221,100,1976,22138,0,0,122461,0,0,0,0,0,0,2989,709,3698,2937,682,3619,2929,16,0,1,0,1,42,661,721
1,15/12/2022,01F7-Tollgate Metro,57166,58741,0,720,15786,0,0,73672,0,0,0,0,0,0,1642,495,2137,1595,423,2018,1584,16,0,1,0,9,21,462,509
1,15/12/2022,01F9-New Washermenpet Metro,84129,92304,1500,1008,19690,0,0,106327,0,0,0,0,0,0,2852,671,3523,2814,687,3501,2851,17,52,1,0,0,34,626,730
1,15/12/2022,01FB-Tondiarpet Metro,92907,100085,3350,1976,23152,0,0,121385,0,0,0,0,750,750,2971,800,3771,3004,850,3854,3033,23,13,1,0,1,64,725,827
1,15/12/2022,01FD-Thiagaraya College Metro,108431,117454,600,1712,29010,0,0,139753,0,0,0,0,1000,1000,3465,1006,4471,3598,861,4459,3619,27,19,0,0,1,61,937,1045
1,15/12/2022,0101-Washermanpet,97666,125588,220,2016,39814,0,0,139716,0,0,0,0,5000,5000,3704,1361,5065,3425,1185,4610,3496,15,126,0,0,2,71,1283,1497
1,15/12/2022,0103-Mannadi,79064,110073,0,1296,30746,0,0,111106,0,0,0,0,0,0,3030,1106,4136,3326,1060,4386,3343,20,102,2,0,2,55,1041,1222
1,15/12/2022,0105-High Court,145294,283547,1790,4792,95652,0,0,247528,0,0,0,0,0,0,7492,3408,10900,7591,2714,10305,7698,30,279,3,0,7,136,3248,3703
1,15/12/2022,0109-Government Estate,100112,158856,300,3336,42852,0,0,146600,0,0,0,0,1500,1500,4485,1583,6068,4708,1748,6456,5104,25,457,2,0,4,125,1412,2025
1,15/12/2022,0111-LIC,86322,162432,1200,2600,29904,0,0,120026,0,0,0,0,250,250,4533,1094,5627,5356,995,6351,5349,26,2,0,0,2,101,967,1098
1,15/12/2022,0113-Thousand Lights,134807,265597,3730,5528,48796,0,0,192861,0,0,0,0,0,0,7945,1846,9791,8747,1651,10398,8736,25,0,3,0,2,223,1560,1813
1,15/12/2022,0115-AG-DMS,118980,158800,700,2736,25444,0,0,147860,0,0,0,0,250,250,5292,949,6241,5101,846,5947,5309,16,209,2,0,0,109,812,1148
1,15/12/2022,0117-Teynampet,101386,139709,300,2144,28104,0,0,131934,0,0,0,0,2000,2000,4036,1113,5149,4771,1017,5788,4723,26,0,0,0,3,92,983,1104
1,15/12/2022,0119-Nandanam,118077,141455,320,2496,27952,0,0,148845,0,0,0,0,250,250,4470,1060,5530,4699,1015,5714,4874,49,193,0,0,2,107,923,1274
1,15/12/2022,0121-Saidapet,57064,86388,400,1864,22006,0,0,81334,0,0,0,0,6000,6000,2103,806,2909,2634,812,3446,2627,13,0,3,0,1,69,727,813
1,15/12/2022,0123-Little Mount,94465,104536,200,2544,23438,0,0,120647,0,0,0,0,2750,2750,3833,932,4765,3104,757,3861,3296,23,230,3,0,1,106,795,1158
1,15/12/2022,0125-Guindy,141976,284303,870,7208,86316,0,0,236370,0,0,0,0,3500,3500,8443,3054,11497,7628,2674,10302,7920,52,375,5,0,11,273,2707,3423
1,15/12/2022,0129-Nanganallur Road,47708,52561,100,832,12902,0,0,61542,0,0,0,0,0,0,1401,419,1820,1530,373,1903,1498,12,0,0,0,2,25,377,416
1,15/12/2022,0131-Meenambakkam,139519,135626,1600,2600,34958,0,0,178677,0,0,0,0,0,0,4013,1048,5061,3228,883,4111,3436,20,238,4,0,1,86,959,1308
1,15/12/2022,0133-Chennai International Airport,186986,354511,1580,11744,139726,0,0,340036,0,0,0,0,4500,4500,6448,3983,10431,6227,3947,10174,6936,65,946,8,1,8,349,3582,4959
2,15/12/2022,0201-Puratchi Thalaivar Dr. M.G. Ramachandran Central,214762,458496,2396,11744,192388,0,0,421290,0,0,0,0,6150,6150,12108,7032,19140,11300,7062,18362,11673,89,1092,15,0,17,470,6477,8160
2,15/12/2022,0203-Egmore,75798,135914,1000,2856,63478,0,0,143132,0,0,0,0,22000,22000,2480,2283,4763,2903,2779,5682,2974,26,396,5,0,3,116,2154,2700
2,15/12/2022,0205-Nehru Park,43861,47286,500,760,13338,0,0,58459,0,0,0,0,500,500,1532,504,2036,1376,537,1913,1451,30,143,0,0,0,33,463,669
2,15/12/2022,0207-Kilpauk,41434,60893,200,976,16446,0,0,59056,0,0,0,0,0,0,1653,609,2262,1740,569,2309,1801,25,109,2,0,1,44,558,739
2,15/12/2022,0209-Pachaiyappas College,44605,49263,0,808,11744,0,0,57157,0,0,0,0,8000,8000,1683,455,2138,1543,434,1977,1607,22,80,1,0,1,30,422,556
2,15/12/2022,0211-Shenoy Nagar,43013,50172,0,920,12464,0,0,56397,0,0,0,0,2250,2250,1468,450,1918,1498,472,1970,1555,10,83,9,0,2,37,407,548
2,15/12/2022,0213-Anna Nagar East,91562,123098,700,2896,29778,0,0,124936,0,0,0,0,0,0,3531,1110,4641,3609,1041,4650,3717,20,252,1,0,4,102,983,1362
2,15/12/2022,0215-Anna Nagar Tower,96013,110511,500,2632,26370,0,0,125515,0,0,0,0,1250,1250,3185,969,4154,3124,980,4104,3259,21,200,3,0,4,89,872,1189
2,15/12/2022,0217-Thirumangalam,270555,330906,700,8192,77500,0,0,356947,0,0,0,0,1500,1500,9192,2727,11919,9127,2711,11838,9513,58,588,8,0,3,288,2390,3335
2,15/12/2022,0219-Koyambedu,197506,253131,1050,5568,89322,0,0,293446,0,0,0,0,5000,5000,6317,3053,9370,5724,2369,8093,6042,44,478,6,0,11,206,2816,3561
2,15/12/2022,0221-Puratchi Thalaivi Dr. J. Jayalalithaa CMBT,70092,174818,1110,2632,75238,0,0,149072,0,0,0,0,0,0,2826,2468,5294,3801,3763,7564,3917,25,592,5,0,6,114,2352,3094
2,15/12/2022,0223-Arumbakkam,59828,68090,200,2376,23280,0,0,85684,0,0,0,0,2500,2500,1868,882,2750,1892,729,2621,1820,50,1,2,0,2,84,792,931
2,15/12/2022,0225-Vadapalani,117343,201679,748,5512,69524,0,0,193127,0,0,0,0,8000,8000,4813,2465,7278,4894,2476,7370,5190,52,515,2,0,6,213,2193,2981
2,15/12/2022,0227-Ashok Nagar,89185,156948,645,5936,47618,0,0,143384,0,0,0,0,0,0,4166,1755,5921,3985,1522,5507,4322,35,380,4,0,2,210,1493,2124
2,15/12/2022,0229-Ekkattuthangal,95541,146138,2896,2800,29324,0,0,130561,0,0,0,0,250,250,4429,1083,5512,4438,1013,5451,4708,28,389,2,0,3,119,906,1447
2,15/12/2022,0231-Arignar Anna Alandur,162472,210486,1650,4752,60834,0,0,229708,0,0,0,0,4000,4000,5964,2111,8075,5447,1870,7317,5862,44,540,0,0,2,201,1878,2665
2,15/12/2022,0233-St. Thomas Mount,98346,110095,700,5408,31336,0,0,135790,0,0,0,0,7075,7075,3091,1111,4202,2957,986,3943,3084,27,163,0,0,1,132,958,1281
1,16/12/2022,01ED-Wimco Nagar Depot Metro,76199,83214,48,1384,26846,0,0,104477,0,0,0,0,1500,1500,2221,706,2927,1806,393,2199,1785,12,0,0,0,3,41,668,724
1,16/12/2022,01EF-Wimco Nagar Metro,101833,128475,0,2472,29720,0,0,134025,0,0,0,0,2500,2500,3311,818,4129,3016,862,3878,3092,24,98,4,0,5,75,718,924
1,16/12/2022,01F1-Thiruvotriyur Metro,90557,101615,0,1248,23976,0,0,115781,0,0,0,0,0,0,2853,668,3521,2614,580,3194,2603,21,0,4,0,4,37,621,687
1,16/12/2022,01F3-Thiruvotriyur Theradi Metro,95105,126595,1450,2032,32418,0,0,131005,0,0,0,0,0,0,3090,949,4039,3244,934,4178,3244,19,34,3,0,6,71,864,997
1,16/12/2022,01F5-Kaladipet Metro,96456,93101,0,1080,19034,0,0,116570,0,0,0,0,0,0,2921,619,3540,2749,610,3359,2749,15,0,0,1,1,36,578,631
1,16/12/2022,01F7-Tollgate Metro,55777,56055,200,1376,12680,0,0,70033,0,0,0,0,0,0,1657,442,2099,1605,430,2035,1603,21,0,0,0,8,35,375,439
1,16/12/2022,01F9-New Washermenpet Metro,81264,89597,1964,728,20682,0,0,104638,0,0,0,0,250,250,2757,692,3449,2680,657,3337,2701,15,40,1,0,2,29,659,746
1,16/12/2022,01FB-Tondiarpet Metro,84802,101866,200,1928,25786,0,0,112716,0,0,0,0,500,500,2976,877,3853,2977,860,3837,2981,16,0,2,0,5,67,802,892
1,16/12/2022,01FD-Thiagaraya College Metro,98735,121834,100,1880,32368,0,0,133083,0,0,0,0,3250,3250,3504,1147,4651,3612,965,4577,3641,33,23,1,0,2,68,1068,1195
1,16/12/2022,0101-Washermanpet,104661,122886,200,1920,36414,0,0,143195,0,0,0,0,7000,7000,3832,1263,5095,3442,1223,4665,3512,24,131,2,0,5,75,1184,1421
1,16/12/2022,0103-Mannadi,75498,109552,0,1832,32184,0,0,109514,0,0,0,0,0,0,2994,1140,4134,3221,1167,4388,3276,13,102,1,0,0,58,1070,1244
1,16/12/2022,0105-High Court,129986,258966,900,3432,79212,0,0,213530,0,0,0,0,0,0,7039,2795,9834,7236,2138,9374,7409,36,258,0,0,2,145,2621,3062
1,16/12/2022,0109-Government Estate,102260,165315,350,2656,53644,0,0,158910,0,0,0,0,6750,6750,4435,1957,6392,4724,1835,6559,4934,18,317,0,0,3,123,1794,2255
1,16/12/2022,0111-LIC,73953,168838,250,3824,36472,0,0,114499,0,0,0,0,250,250,4622,1371,5993,5351,1055,6406,5416,25,0,0,0,2,121,1154,1302
1,16/12/2022,0113-Thousand Lights,134638,271504,4060,6904,53528,0,0,199130,0,0,0,0,250,250,7910,2058,9968,8886,1698,10584,8866,32,0,1,0,5,274,1704,2016
1,16/12/2022,0115-AG-DMS,117602,165682,850,2664,31586,0,0,152702,0,0,0,0,1000,1000,5405,1130,6535,5148,901,6049,5343,27,221,0,0,0,107,995,1350
1,16/12/2022,0117-Teynampet,97429,148960,600,2344,33004,0,0,133377,0,0,0,0,2000,2000,4400,1253,5653,4966,1115,6081,4921,14,3,1,0,3,96,1129,1246
1,16/12/2022,0119-Nandanam,98142,137289,700,2888,25622,0,0,127352,0,0,0,0,250,250,4338,1031,5369,4586,969,5555,4791,22,221,5,0,4,118,859,1229
1,16/12/2022,0121-Saidapet,45234,87239,200,1520,25992,0,0,72946,0,0,0,0,250,250,2110,939,3049,2534,839,3373,2492,19,0,0,0,1,63,863,946
1,16/12/2022,0123-Little Mount,87040,111094,300,2976,30064,0,0,120380,0,0,0,0,0,0,3829,1186,5015,3088,874,3962,3283,21,225,1,0,0,129,1017,1393
1,16/12/2022,0125-Guindy,127100,301670,1860,9024,102496,0,0,240480,0,0,0,0,2000,2000,8367,3621,11988,7540,2762,10302,7982,42,515,1,0,5,301,3249,4113
1,16/12/2022,0129-Nanganallur Road,40785,52282,1500,608,14866,0,0,57759,0,0,0,0,0,0,1412,472,1884,1496,366,1862,1443,5,0,1,1,0,23,447,477
1,16/12/2022,0131-Meenambakkam,131435,133518,2000,2072,36066,0,0,171573,0,0,0,0,0,0,3944,1067,5011,3210,900,4110,3341,25,177,6,0,5,66,1004,1283
1,16/12/2022,0133-Chennai International Airport,200308,375292,200,12672,147742,0,0,360922,0,0,0,0,5250,5250,6821,4228,11049,6255,4461,10716,7276,51,1304,15,0,10,391,3761,5532
2,16/12/2022,0201-Puratchi Thalaivar Dr. M.G. Ramachandran Central,220562,498463,2100,13528,209346,0,0,445536,0,0,0,0,7050,7050,11806,7375,19181,11987,8478,20465,12530,100,1285,8,0,18,531,6869,8811
2,16/12/2022,0203-Egmore,74259,151108,0,3520,67790,0,0,145569,0,0,0,0,12500,12500,2714,2405,5119,3272,3179,6451,3394,22,475,11,0,2,149,2261,2920
2,16/12/2022,0205-Nehru Park,39506,55295,0,1704,15454,0,0,56664,0,0,0,0,0,0,1618,609,2227,1555,548,2103,1656,15,154,0,0,2,70,536,777
2,16/12/2022,0207-Kilpauk,38268,60704,250,1896,18106,0,0,58520,0,0,0,0,0,0,1586,665,2251,1689,653,2342,1732,26,101,0,0,0,49,600,776
2,16/12/2022,0209-Pachaiyappas College,50759,51430,0,1152,13634,0,0,65545,0,0,0,0,8000,8000,1703,552,2255,1537,517,2054,1607,19,104,1,0,0,49,489,662
2,16/12/2022,0211-Shenoy Nagar,40223,48457,450,1040,11960,0,0,53673,0,0,0,0,1000,1000,1411,445,1856,1450,509,1959,1514,10,113,1,0,2,41,394,561
2,16/12/2022,0213-Anna Nagar East,83054,123526,100,2744,31972,0,0,117870,0,0,0,0,0,0,3502,1207,4709,3452,1120,4572,3632,22,259,3,0,2,111,1072,1469
2,16/12/2022,0215-Anna Nagar Tower,94676,111451,850,3056,28932,0,0,127514,0,0,0,0,250,250,3078,1088,4166,3061,952,4013,3213,9,221,1,0,6,116,937,1290
2,16/12/2022,0217-Thirumangalam,276622,341562,580,9680,87148,0,0,374030,0,0,0,0,0,0,9321,3091,12412,9089,2952,12041,9568,46,715,6,0,6,343,2686,3802
2,16/12/2022,0219-Koyambedu,177011,254440,80,5728,92168,0,0,274987,0,0,0,0,7000,7000,6346,3245,9591,5702,2467,8169,6018,63,517,4,0,8,232,2955,3779
2,16/12/2022,0221-Puratchi Thalaivi Dr. J. Jayalalithaa CMBT,76705,188229,540,3680,75434,0,0,156359,0,0,0,0,0,0,2851,2570,5421,4623,5091,9714,4462,28,610,8,0,3,149,2424,3222
2,16/12/2022,0223-Arumbakkam,62946,70893,0,2112,26782,0,0,91840,0,0,0,0,9750,9750,1891,983,2874,1899,793,2692,1811,47,0,1,0,1,70,892,1011
2,16/12/2022,0225-Vadapalani,132528,247135,794,7560,85432,0,0,226314,0,0,0,0,8500,8500,5813,3081,8894,5663,3203,8866,6268,30,917,8,0,9,294,2713,3971
2,16/12/2022,0227-Ashok Nagar,96027,165198,500,4472,54484,0,0,155483,0,0,0,0,0,0,4324,1975,6299,4073,1666,5739,4374,37,455,7,0,4,174,1740,2417
2,16/12/2022,0229-Ekkattuthangal,94503,136410,734,4616,33746,0,0,133599,0,0,0,0,1250,1250,3830,1314,5144,3616,1027,4643,4115,22,509,0,0,1,182,1061,1775
2,16/12/2022,0231-Arignar Anna Alandur,150582,219889,2010,6728,67936,0,0,227256,0,0,0,0,4000,4000,6080,2352,8432,5344,1959,7303,5883,55,694,2,0,2,247,2058,3058
2,16/12/2022,0233-St. Thomas Mount,83336,120724,0,4256,40924,0,0,128516,0,0,0,0,1900,1900,3170,1444,4614,3081,1093,4174,3130,27,106,3,0,4,156,1258,1554
1,17/12/2022,01ED-Wimco Nagar Depot Metro,77453,82401,0,1888,27204,0,0,106545,0,0,0,0,3500,3500,2105,701,2806,1669,346,2015,1721,10,71,1,0,6,47,667,802
1,17/12/2022,01EF-Wimco Nagar Metro,103094,121144,1100,2840,34646,0,0,141680,0,0,0,0,500,500,2933,931,3864,2674,924,3598,2716,43,100,3,0,6,88,834,1074
1,17/12/2022,01F1-Thiruvotriyur Metro,113209,101669,0,1856,25764,0,0,140829,0,0,0,0,0,0,2780,720,3500,2554,721,3275,2525,42,12,3,0,11,58,667,793
1,17/12/2022,01F3-Thiruvotriyur Theradi Metro,86373,119517,0,2680,34146,0,0,123199,0,0,0,0,0,0,2820,1026,3846,2943,1108,4051,2956,21,48,4,0,5,89,913,1080
1,17/12/2022,01F5-Kaladipet Metro,92207,97633,200,1952,25696,0,0,120055,0,0,0,0,0,0,2794,819,3613,2679,821,3500,2690,10,47,0,0,1,59,760,877
1,17/12/2022,01F7-Tollgate Metro,61379,57723,0,1408,15158,0,0,77945,0,0,0,0,0,0,1645,499,2144,1545,480,2025,1553,19,48,0,0,10,41,448,566
1,17/12/2022,01F9-New Washermenpet Metro,76062,89415,0,1256,22718,0,0,100036,0,0,0,0,250,250,2643,768,3411,2658,822,3480,2673,20,82,0,0,0,47,712,861
1,17/12/2022,01FB-Tondiarpet Metro,87191,96599,150,1736,28744,0,0,117821,0,0,0,0,750,750,2693,943,3636,2744,904,3648,2680,22,10,1,0,3,58,875,969
1,17/12/2022,01FD-Thiagaraya College Metro,101039,123334,465,3040,36546,0,0,141090,0,0,0,0,1000,1000,3430,1298,4728,3557,1176,4733,3596,33,74,2,0,3,115,1170,1397
1,17/12/2022,0101-Washermanpet,88232,127462,1550,2336,47182,0,0,139300,0,0,0,0,17750,17750,3314,1578,4892,3176,1538,4714,3228,20,201,2,0,11,103,1472,1809
1,17/12/2022,0103-Mannadi,79657,109662,2800,2184,35420,0,0,120061,0,0,0,0,1500,1500,2792,1284,4076,3198,1284,4482,3145,28,124,0,0,4,94,1182,1432
1,17/12/2022,0105-High Court,103523,217961,24,4872,81736,0,0,190155,0,0,0,0,0,0,5251,2841,8092,5305,2368,7673,5488,29,487,1,0,3,186,2611,3317
1,17/12/2022,0109-Government Estate,99377,162289,1037,4400,48114,0,0,152928,0,0,0,0,250,250,4358,1826,6184,4189,2062,6251,4840,28,864,4,0,9,182,1608,2695
1,17/12/2022,0111-LIC,74192,172217,250,3944,49152,0,0,127538,0,0,0,0,0,0,4177,1736,5913,4952,1274,6226,4896,16,0,1,0,6,155,1539,1717
1,17/12/2022,0113-Thousand Lights,104671,218913,1400,6728,60770,0,0,173569,0,0,0,0,0,0,5608,2242,7850,6431,1935,8366,6377,32,86,2,0,13,256,1919,2308
1,17/12/2022,0115-AG-DMS,76715,126382,2050,3200,31054,0,0,113019,0,0,0,0,250,250,3574,1103,4677,3361,819,4180,3668,23,338,1,0,0,117,953,1432
1,17/12/2022,0117-Teynampet,65117,110322,50,2224,36074,0,0,103465,0,0,0,0,1000,1000,2664,1323,3987,3201,997,4198,3093,16,2,0,0,3,93,1210,1324
1,17/12/2022,0119-Nandanam,68160,103345,200,2400,28984,0,0,99744,0,0,0,0,1000,1000,2852,1087,3939,2864,971,3835,3049,30,307,4,0,6,102,954,1403
1,17/12/2022,0121-Saidapet,39600,68640,330,1944,24332,0,0,66206,0,0,0,0,4000,4000,1367,877,2244,1742,875,2617,1717,8,71,0,0,0,78,778,935
1,17/12/2022,0123-Little Mount,60561,84280,354,3344,28626,0,0,92885,0,0,0,0,250,250,2461,1088,3549,1952,855,2807,2228,19,326,2,0,2,136,946,1431
1,17/12/2022,0125-Guindy,132176,275207,1001,10144,109654,0,0,252975,0,0,0,0,3000,3000,6372,3892,10264,5637,3365,9002,6338,38,969,7,0,5,379,3419,4817
1,17/12/2022,0129-Nanganallur Road,41818,43601,100,1336,12986,0,0,56240,0,0,0,0,0,0,1045,430,1475,1137,445,1582,1113,8,54,0,0,2,41,383,488
1,17/12/2022,0131-Meenambakkam,120284,145468,500,3880,40216,0,0,164880,0,0,0,0,0,0,3724,1233,4957,2921,1314,4235,3434,22,671,1,0,2,129,1100,1925
1,17/12/2022,0133-Chennai International Airport,185033,368757,400,14224,167334,0,0,366991,0,0,0,0,6750,6750,5895,4796,10691,5494,4752,10246,6342,85,1535,24,0,14,434,4293,6385
2,17/12/2022,0201-Puratchi Thalaivar Dr. M.G. Ramachandran Central,216272,509197,640,18272,242988,0,0,478172,0,0,0,0,5150,5150,10369,8795,19164,10622,8740,19362,11028,122,1856,8,0,25,710,7999,10720
2,17/12/2022,0203-Egmore,78512,150127,100,4264,74916,0,0,157792,0,0,0,0,19000,19000,2530,2645,5175,2952,3258,6210,3088,21,623,7,0,10,166,2464,3291
2,17/12/2022,0205-Nehru Park,40630,57943,600,1376,22020,0,0,64626,0,0,0,0,4500,4500,1460,829,2289,1438,719,2157,1494,29,182,0,0,5,62,744,1022
2,17/12/2022,0207-Kilpauk,34893,56582,0,952,16842,0,0,52687,0,0,0,0,0,0,1470,627,2097,1418,645,2063,1565,16,240,0,0,2,44,562,864
2,17/12/2022,0209-Pachaiyappas College,45292,52400,0,1016,14658,0,0,60966,0,0,0,0,6000,6000,1664,570,2234,1490,603,2093,1582,26,172,1,0,3,43,515,760
2,17/12/2022,0211-Shenoy Nagar,42261,53631,0,1432,13478,0,0,57171,0,0,0,0,0,0,1446,516,1962,1469,598,2067,1603,16,239,0,0,3,55,451,764
2,17/12/2022,0213-Anna Nagar East,77314,124951,1000,3608,39170,0,0,121092,80,0,80,0,0,0,3319,1482,4801,3251,1325,4576,3411,19,374,0,0,5,151,1301,1850
2,17/12/2022,0215-Anna Nagar Tower,79763,115491,200,3960,33236,0,0,117159,0,0,0,0,0,0,3020,1275,4295,2890,1236,4126,3169,23,440,2,0,3,160,1091,1719
2,17/12/2022,0217-Thirumangalam,229689,327729,350,11032,116366,0,0,357437,0,0,0,0,0,0,7658,4071,11729,7501,3739,11240,7884,61,948,7,0,9,431,3587,5043
2,17/12/2022,0219-Koyambedu,152891,243121,456,6344,115436,0,0,275127,0,0,0,0,2750,2750,4937,3965,8902,4610,2972,7582,4816,51,710,16,0,7,275,3670,4729
2,17/12/2022,0221-Puratchi Thalaivi Dr. J. Jayalalithaa CMBT,81847,194004,400,3384,81938,0,0,167569,0,0,0,0,0,0,2913,2769,5682,4298,5004,9302,4283,31,1037,6,0,2,157,2610,3843
2,17/12/2022,0223-Arumbakkam,50467,71211,300,2512,30402,0,0,83681,0,0,0,0,6000,6000,1625,1121,2746,1724,900,2624,1665,34,87,0,0,14,90,1018,1243
2,17/12/2022,0225-Vadapalani,117981,265604,1420,9512,113132,0,0,242045,0,0,0,0,2000,2000,5222,4058,9280,5508,4058,9566,5871,52,1131,6,0,4,379,3561,5133
2,17/12/2022,0227-Ashok Nagar,87114,156013,750,6320,54888,0,0,149072,0,0,0,0,4500,4500,3653,2086,5739,3546,1896,5442,3908,45,617,6,0,3,252,1757,2680
2,17/12/2022,0229-Ekkattuthangal,101545,100132,530,3776,31676,0,0,137527,0,0,0,0,0,0,2602,1190,3792,2476,1068,3544,2763,33,463,3,0,1,158,999,1657
2,17/12/2022,0231-Arignar Anna Alandur,143139,219732,280,9200,82508,0,0,235127,0,0,0,0,1500,1500,5066,2928,7994,4507,2779,7286,5147,60,924,6,0,7,316,2549,3862
2,17/12/2022,0233-St. Thomas Mount,94095,132729,100,5112,47234,0,0,146541,0,0,0,3000,5800,8800,3063,1637,4700,2658,1544,4202,3104,15,660,2,0,4,179,1432,2292
1,18/12/2022,01ED-Wimco Nagar Depot Metro,47012,63477,0,1656,32364,0,0,81032,0,0,0,0,2500,2500,1071,804,1875,977,447,1424,961,15,0,0,0,7,46,771,839
1,18/12/2022,01EF-Wimco Nagar Metro,61788,77554,0,2800,31444,0,0,96032,0,0,0,0,1000,1000,1359,841,2200,1364,904,2268,1383,54,77,4,0,21,82,749,987
1,18/12/2022,01F1-Thiruvotriyur Metro,60556,76233,50,1584,30904,0,0,93094,0,0,0,0,0,0,1431,829,2260,1525,755,2280,1464,40,0,1,0,8,55,781,885
1,18/12/2022,01F3-Thiruvotriyur Theradi Metro,69821,110360,400,3272,51838,0,0,125331,0,0,0,0,0,0,1676,1412,3088,1985,1293,3278,1938,30,30,5,0,12,99,1296,1472
1,18/12/2022,01F5-Kaladipet Metro,51301,67060,0,1464,29952,0,0,82717,0,0,0,0,0,0,1297,893,2190,1357,776,2133,1316,21,1,0,0,6,49,842,919
1,18/12/2022,01F7-Tollgate Metro,28885,42829,0,1080,19284,0,0,49249,0,0,0,0,0,0,875,591,1466,884,515,1399,861,26,1,0,0,19,40,546,632
1,18/12/2022,01F9-New Washermenpet Metro,50438,60884,0,1344,24674,0,0,76456,0,0,0,0,1000,1000,1335,776,2111,1286,779,2065,1356,8,111,0,0,10,46,735,910
1,18/12/2022,01FB-Tondiarpet Metro,40444,68476,50,1408,33328,0,0,75230,0,0,0,0,0,0,1283,1011,2294,1340,905,2245,1291,16,4,2,0,13,46,955,1036
1,18/12/2022,01FD-Thiagaraya College Metro,56143,91378,40,3384,40152,0,0,99719,0,0,0,0,0,0,1841,1322,3163,1827,1236,3063,1953,34,148,1,0,5,102,1210,1500
1,18/12/2022,0101-Washermanpet,61435,92086,0,2176,47316,0,0,110927,0,0,0,0,12500,12500,1663,1531,3194,1586,1503,3089,1683,22,239,4,0,14,80,1440,1799
1,18/12/2022,0103-Mannadi,43138,69835,0,1976,32624,0,0,77738,0,0,0,0,0,0,1282,1131,2413,1330,1255,2585,1423,16,175,0,0,15,74,1044,1324
1,18/12/2022,0105-High Court,43215,85690,0,2192,40152,0,0,85559,0,0,0,0,0,0,1585,1404,2989,1561,1282,2843,1770,12,319,5,0,11,87,1316,1750
1,18/12/2022,0109-Government Estate,44137,97991,0,2408,48266,0,0,94811,0,0,0,0,250,250,1818,1715,3533,1794,1646,3440,1998,12,388,9,0,13,104,1589,2115
1,18/12/2022,0111-LIC,21730,68885,100,1936,34720,0,0,58486,0,0,0,0,0,0,1123,1199,2322,1471,1084,2555,1355,14,0,0,0,16,75,1095,1200
1,18/12/2022,0113-Thousand Lights,35399,91247,0,3672,44400,0,0,83471,0,0,0,0,0,0,1483,1553,3036,2076,1542,3618,1834,17,10,0,0,12,142,1382,1563
1,18/12/2022,0115-AG-DMS,21380,44650,0,1576,18940,0,0,41896,0,0,0,0,0,0,863,643,1506,867,557,1424,946,12,158,2,0,1,55,582,810
1,18/12/2022,0117-Teynampet,25062,51389,0,1464,26018,0,0,52544,0,0,0,0,0,0,866,950,1816,1100,977,2077,1050,4,4,0,0,4,72,867,951
1,18/12/2022,0119-Nandanam,41811,50664,100,1920,22300,0,0,66131,0,0,0,0,0,0,1026,850,1876,944,761,1705,1097,19,242,2,0,4,74,755,1096
1,18/12/2022,0121-Saidapet,20495,51701,0,1688,30090,0,0,52273,0,0,0,0,0,0,647,1024,1671,915,888,1803,812,11,0,4,0,1,56,970,1042
1,18/12/2022,0123-Little Mount,38041,61144,300,2128,29418,0,0,69887,0,0,0,0,0,0,1279,1071,2350,1087,881,1968,1234,17,233,13,0,7,86,943,1299
1,18/12/2022,0125-Guindy,77198,187876,200,9248,96672,0,0,183318,0,0,0,0,0,0,3045,3379,6424,2624,3115,5739,3280,31,918,15,0,12,334,2956,4266
1,18/12/2022,0129-Nanganallur Road,15416,28752,0,1336,14824,0,0,31576,0,0,0,0,0,0,377,487,864,524,467,991,486,4,0,1,0,4,43,447,499
1,18/12/2022,0131-Meenambakkam,56361,94442,0,3472,47000,0,0,106833,0,0,0,0,0,0,1543,1357,2900,1317,1220,2537,1517,18,320,10,0,8,97,1266,1719
1,18/12/2022,0133-Chennai International Airport,162461,325151,0,14008,166516,0,0,342985,0,0,0,0,750,750,4525,4710,9235,3821,4922,8743,4869,65,1688,16,0,27,379,4221,6396
2,18/12/2022,0201-Puratchi Thalaivar Dr. M.G. Ramachandran Central,149497,428757,550,18480,257114,0,0,425641,0,0,0,0,1400,1400,6106,9105,15211,5649,8394,14043,6446,102,1670,37,0,42,691,8258,10800
2,18/12/2022,0203-Egmore,53956,118876,400,4120,67048,0,0,125524,0,0,0,0,7000,7000,1814,2393,4207,1670,2990,4660,2048,17,695,8,0,9,172,2231,3132
2,18/12/2022,0205-Nehru Park,26764,42326,0,1768,20000,0,0,48532,0,0,0,0,2000,2000,857,747,1604,745,694,1439,887,19,179,2,0,8,76,668,952
2,18/12/2022,0207-Kilpauk,18027,34156,0,872,15126,0,0,34025,0,0,0,0,0,0,662,534,1196,724,628,1352,750,9,107,2,0,7,36,495,656
2,18/12/2022,0209-Pachaiyappas College,29365,36603,0,744,16580,0,0,46689,0,0,0,0,8000,8000,777,592,1369,695,541,1236,761,15,99,0,0,6,31,548,699
2,18/12/2022,0211-Shenoy Nagar,18571,31486,0,1328,13760,0,0,33659,0,0,0,0,0,0,614,493,1107,651,507,1158,693,4,90,0,0,4,49,441,588
2,18/12/2022,0213-Anna Nagar East,38084,74491,200,2672,29358,0,0,70314,0,0,0,0,0,0,1574,1117,2691,1608,1048,2656,1785,12,313,0,0,5,119,979,1428
2,18/12/2022,0215-Anna Nagar Tower,46608,77831,100,4024,30830,0,0,81562,0,0,0,0,0,0,1588,1148,2736,1537,1215,2752,1766,15,374,0,0,4,126,981,1500
2,18/12/2022,0217-Thirumangalam,124844,231228,0,10624,107068,0,0,242536,0,0,0,0,0,0,4147,3686,7833,3996,3447,7443,4539,45,918,13,0,12,391,3232,4611
2,18/12/2022,0219-Koyambedu,92810,177732,450,6328,98416,0,0,198004,0,0,0,0,1000,1000,2972,3417,6389,2527,2721,5248,2955,47,740,7,0,24,274,3115,4207
2,18/12/2022,0221-Puratchi Thalaivi Dr. J. Jayalalithaa CMBT,51057,168130,100,5016,101654,0,0,157827,0,0,0,0,0,0,1999,3377,5376,2535,4557,7092,2538,20,675,6,0,5,202,3179,4087
2,18/12/2022,0223-Arumbakkam,29713,46814,0,1136,27354,0,0,58203,0,0,0,0,250,250,811,979,1790,938,753,1691,831,37,1,3,0,13,58,909,1021
2,18/12/2022,0225-Vadapalani,102239,231318,0,12136,108030,0,0,222405,0,0,0,0,3000,3000,3950,4058,8008,3805,4297,8102,4611,35,1306,5,0,20,481,3403,5250
2,18/12/2022,0227-Ashok Nagar,61325,103401,0,3888,50830,0,0,116043,0,0,0,0,3000,3000,1820,1816,3636,1817,1699,3516,2034,25,430,10,0,7,157,1639,2268
2,18/12/2022,0229-Ekkattuthangal,30328,61915,0,2552,33766,0,0,66646,0,0,0,0,0,0,1009,1270,2279,1356,964,2320,1181,22,49,1,0,4,113,1131,1320
2,18/12/2022,0231-Arignar Anna Alandur,90061,159813,1000,5992,78630,0,0,175683,0,0,0,0,500,500,2783,2598,5381,2512,2381,4893,2947,50,797,14,0,15,219,2370,3465
2,18/12/2022,0233-St. Thomas Mount,48802,102023,0,5792,58298,0,0,112892,0,0,0,3000,6800,9800,1420,1997,3417,1520,1632,3152,1597,25,238,1,0,14,185,1782,2245
1,19/12/2022,01ED-Wimco Nagar Depot Metro,93976,87307,0,1536,24532,0,0,120044,0,0,0,0,1750,1750,2300,652,2952,1968,502,2470,1965,14,0,2,0,6,43,609,674
1,19/12/2022,01EF-Wimco Nagar Metro,135013,128287,240,3136,30210,0,0,168599,0,0,0,0,250,250,3366,843,4209,3001,882,3883,3085,44,78,3,0,4,92,738,959
1,19/12/2022,01F1-Thiruvotriyur Metro,134661,106124,0,1736,21566,0,0,157963,0,0,0,0,0,0,2995,621,3616,2826,515,3341,2827,25,0,2,1,5,57,562,652
1,19/12/2022,01F3-Thiruvotriyur Theradi Metro,114293,121770,0,3088,28002,0,0,145383,0,0,0,0,0,0,3005,860,3865,3183,852,4035,3226,30,34,2,0,2,84,754,906
1,19/12/2022,01F5-Kaladipet Metro,127095,104295,0,1656,24938,0,0,153689,0,0,0,0,0,0,3088,780,3868,2992,658,3650,2958,32,0,0,0,1,44,729,806
1,19/12/2022,01F7-Tollgate Metro,75374,57995,200,752,13622,0,0,89948,0,0,0,0,0,0,1639,441,2080,1641,371,2012,1632,23,0,3,0,7,26,417,476
1,19/12/2022,01F9-New Washermenpet Metro,115802,96554,292,832,20768,0,0,137694,0,0,0,0,500,500,2946,700,3646,2932,757,3689,2968,15,62,1,0,1,32,666,777
1,19/12/2022,01FB-Tondiarpet Metro,100743,105609,1500,1496,27006,0,0,130745,0,0,0,0,1750,1750,3021,902,3923,3090,854,3944,3086,22,1,0,0,1,48,851,923
1,19/12/2022,01FD-Thiagaraya College Metro,120674,119367,200,2240,27446,0,0,150560,0,0,0,0,2000,2000,3554,1013,4567,3743,1028,4771,3790,21,29,0,0,0,80,925,1055
1,19/12/2022,0101-Washermanpet,115624,128250,3600,2248,38468,0,0,159940,0,0,0,0,15750,15750,3825,1369,5194,3541,1306,4847,3645,22,126,2,0,5,80,1276,1511
1,19/12/2022,0103-Mannadi,89093,117683,1000,1464,32922,0,0,124479,0,0,0,0,0,0,3186,1172,4358,3561,1247,4808,3590,23,90,0,0,1,61,1101,1276
1,19/12/2022,0105-High Court,156719,256998,1110,3472,72538,0,0,233839,0,0,0,0,0,0,7308,2588,9896,7367,2322,9689,7569,32,261,1,0,4,142,2420,2860
1,19/12/2022,0109-Government Estate,105189,163641,700,2344,50884,0,0,159117,0,0,0,0,2250,2250,4374,1860,6234,4763,1898,6661,4989,30,332,3,0,2,103,1699,2169
1,19/12/2022,0111-LIC,102817,178080,1400,2184,35948,0,0,142349,0,0,0,0,0,0,4927,1270,6197,5768,1162,6930,5716,25,0,2,0,2,92,1141,1262
1,19/12/2022,0113-Thousand Lights,161417,283320,2700,6032,52574,0,0,222723,0,0,0,0,1000,1000,8391,2037,10428,9414,1926,11340,9315,42,2,0,0,5,238,1709,1996
1,19/12/2022,0115-AG-DMS,131179,167324,1000,2320,28734,0,0,163233,0,0,0,0,500,500,5426,1021,6447,5297,989,6286,5456,22,206,3,0,0,92,885,1208
1,19/12/2022,0117-Teynampet,105333,136180,200,1960,30668,0,0,138161,0,0,0,0,0,0,3853,1186,5039,4596,1163,5759,4512,24,5,0,0,0,80,1070,1179
1,19/12/2022,0119-Nandanam,116768,138708,850,2856,24582,0,0,145056,0,0,0,0,4000,4000,4241,1000,5241,4733,1145,5878,4885,41,203,3,0,4,123,834,1208
1,19/12/2022,0121-Saidapet,58336,89637,0,2128,24718,0,0,85182,0,0,0,0,0,0,2044,897,2941,2658,900,3558,2636,22,0,0,0,0,75,800,897
1,19/12/2022,0123-Little Mount,103662,105499,170,5128,25466,0,0,134426,0,0,0,0,1000,1000,3649,1035,4684,3162,840,4002,3282,20,146,1,0,1,127,858,1153
1,19/12/2022,0125-Guindy,169930,288268,3150,8432,83196,0,0,264708,0,0,0,0,7500,7500,8491,3073,11564,7583,2915,10498,8142,64,675,0,0,1,332,2622,3694
1,19/12/2022,0129-Nanganallur Road,56301,48896,600,608,11258,0,0,68767,0,0,0,0,0,0,1367,376,1743,1474,356,1830,1445,9,0,0,0,2,23,341,375
1,19/12/2022,0131-Meenambakkam,151810,147241,500,3272,38888,0,0,194470,0,0,0,0,0,0,4165,1179,5344,3461,993,4454,3680,26,272,1,0,0,109,1067,1475
1,19/12/2022,0133-Chennai International Airport,196777,366771,1050,9808,157378,0,0,365013,0,0,0,0,11250,11250,6410,4430,10840,6259,4348,10607,6834,58,890,12,0,13,311,4032,5316
2,19/12/2022,0201-Puratchi Thalaivar Dr. M.G. Ramachandran Central,274664,546822,1275,21648,228662,0,0,526249,0,0,0,0,7350,7350,14203,8642,22845,12528,8371,20899,13712,138,1687,26,0,18,847,7468,10184
2,19/12/2022,0203-Egmore,89294,148233,440,4312,74176,0,0,168222,0,0,0,0,19000,19000,2840,2660,5500,2920,3033,5953,3082,22,409,7,0,9,163,2439,3049
2,19/12/2022,0205-Nehru Park,45944,48756,1500,1240,13914,0,0,62598,0,0,0,0,1000,1000,1534,565,2099,1380,546,1926,1464,29,118,1,0,0,51,494,693
2,19/12/2022,0207-Kilpauk,42769,62846,0,944,17916,0,0,61629,0,0,0,0,0,0,1662,636,2298,1743,672,2415,1801,13,111,0,0,0,40,585,749
2,19/12/2022,0209-Pachaiyappas College,50804,53856,0,784,14414,0,0,66002,0,0,0,0,6000,6000,1774,569,2343,1654,553,2207,1696,27,85,1,0,1,33,529,676
2,19/12/2022,0211-Shenoy Nagar,50691,54657,0,896,13088,0,0,64675,0,0,0,0,0,0,1499,484,1983,1627,591,2218,1706,15,126,0,0,1,35,446,623
2,19/12/2022,0213-Anna Nagar East,94310,123130,650,2328,30182,0,0,127470,0,0,0,0,0,0,3542,1134,4676,3572,1128,4700,3702,22,224,0,0,1,92,1012,1351
2,19/12/2022,0215-Anna Nagar Tower,102659,109519,1440,2712,23168,0,0,129979,0,0,0,0,0,0,3125,892,4017,3185,931,4116,3362,16,226,0,0,4,109,766,1121
2,19/12/2022,0217-Thirumangalam,301446,339210,2500,9224,84762,0,0,397932,0,0,0,0,0,0,9099,2998,12097,9207,2990,12197,9589,60,554,6,0,4,327,2621,3572
2,19/12/2022,0219-Koyambedu,216309,264144,500,6328,100262,0,0,323399,0,0,0,0,4750,4750,6498,3467,9965,5699,2637,8336,6063,56,511,2,0,6,238,3201,4014
2,19/12/2022,0221-Puratchi Thalaivi Dr. J. Jayalalithaa CMBT,87991,189988,975,4352,84780,0,0,178098,0,0,0,0,0,0,3359,2866,6225,3563,3888,7451,4078,29,846,9,0,1,186,2641,3712
2,19/12/2022,0223-Arumbakkam,64351,69388,100,1616,24486,0,0,90553,0,0,0,0,4750,4750,1863,905,2768,1910,739,2649,1844,38,1,2,0,6,63,831,941
2,19/12/2022,0225-Vadapalani,142155,227835,1800,6976,78280,0,0,229211,0,0,0,0,6000,6000,5238,2802,8040,5306,3025,8331,5832,41,753,3,0,5,274,2438,3514
2,19/12/2022,0227-Ashok Nagar,121203,166546,450,2984,54332,0,0,178969,0,0,0,0,6000,6000,4137,1854,5991,4237,1723,5960,4403,33,324,6,0,6,133,1666,2168
2,19/12/2022,0229-Ekkattuthangal,98096,146531,1700,2792,39324,0,0,141912,0,0,0,0,500,500,3923,1433,5356,4525,1246,5771,4375,24,1,3,0,5,122,1265,1420
2,19/12/2022,0231-Arignar Anna Alandur,198849,223036,3400,6008,67104,0,0,275361,0,0,0,0,4250,4250,6134,2329,8463,5650,2020,7670,6052,47,533,4,0,3,238,2005,2830
2,19/12/2022,0233-St. Thomas Mount,96682,118209,200,4824,37474,0,0,139180,0,0,0,0,4050,4050,3137,1333,4470,3128,1094,4222,3182,29,143,1,0,1,144,1152,1470
1,20/12/2022,01ED-Wimco Nagar Depot Metro,90482,79978,0,1336,23128,0,0,114946,0,0,0,0,3000,3000,2269,616,2885,1809,437,2246,1811,15,1,4,0,2,37,578,637
1,20/12/2022,01EF-Wimco Nagar Metro,112444,120652,2725,2936,25380,0,0,143485,0,0,0,0,4750,4750,3210,720,3930,2910,768,3678,2980,27,52,2,0,3,86,614,784
1,20/12/2022,01F1-Thiruvotriyur Metro,105880,98850,0,1560,19058,0,0,126498,0,0,0,0,0,0,2896,556,3452,2690,469,3159,2701,27,0,2,0,0,45,505,579
1,20/12/2022,01F3-Thiruvotriyur Theradi Metro,96126,119029,1200,1936,29930,0,0,129192,0,0,0,0,0,0,2881,860,3741,3058,895,3953,3072,14,19,5,0,2,58,787,885
1,20/12/2022,01F5-Kaladipet Metro,108651,100185,0,1288,20114,0,0,130053,0,0,0,0,0,0,3041,653,3694,2979,607,3586,2969,16,1,0,0,3,48,598,666
1,20/12/2022,01F7-Tollgate Metro,58334,55250,0,624,12218,0,0,71176,0,0,0,0,250,250,1687,401,2088,1568,410,1978,1562,23,2,0,0,1,17,377,420
1,20/12/2022,01F9-New Washermenpet Metro,91300,92315,0,800,19144,0,0,111244,0,0,0,0,250,250,2875,657,3532,2859,661,3520,2892,19,50,0,0,3,35,616,723
1,20/12/2022,01FB-Tondiarpet Metro,98692,101146,0,1784,25642,0,0,126118,0,0,0,0,2000,2000,2962,860,3822,2953,779,3732,2960,24,0,0,0,2,48,799,873
1,20/12/2022,01FD-Thiagaraya College Metro,97454,122018,650,1728,30028,0,0,129860,0,0,0,0,2750,2750,3590,1089,4679,3756,1016,4772,3771,27,34,0,0,2,62,1023,1148
1,20/12/2022,0101-Washermanpet,102012,124361,761,1896,38262,0,0,142931,0,0,0,0,17250,17250,3800,1331,5131,3432,1208,4640,3525,17,120,2,0,7,70,1250,1466
1,20/12/2022,0103-Mannadi,78650,112462,708,1072,28532,0,0,108962,0,0,0,0,0,0,3125,1020,4145,3491,1153,4644,3547,16,112,1,0,1,48,951,1129
1,20/12/2022,0105-High Court,148203,267158,2300,3144,77604,0,0,231251,0,0,0,0,0,0,7376,2755,10131,7591,2342,9933,7756,41,258,0,0,2,128,2571,3000
1,20/12/2022,0109-Government Estate,95215,155134,200,2240,49422,0,0,147077,0,0,0,0,1500,1500,4186,1830,6016,4549,1807,6356,4718,21,222,0,0,2,106,1668,2019
1,20/12/2022,0111-LIC,95010,164392,810,2048,31358,0,0,129226,0,0,0,0,0,0,4704,1113,5817,5378,986,6364,5341,25,1,0,0,0,81,996,1103
1,20/12/2022,0113-Thousand Lights,154996,274624,3180,5712,49634,0,0,213522,0,0,0,0,0,0,8226,1885,10111,9119,1804,10923,9144,28,0,1,0,2,233,1578,1842
1,20/12/2022,0115-AG-DMS,127116,158770,2350,3224,20344,0,0,153034,0,0,0,0,250,250,5366,786,6152,5077,920,5997,5438,28,337,0,0,0,120,629,1114
1,20/12/2022,0117-Teynampet,88895,132676,700,2072,29780,0,0,121447,0,0,0,0,0,0,3818,1145,4963,4462,1034,5496,4416,10,0,3,0,2,92,1018,1125
1,20/12/2022,0119-Nandanam,103462,138950,551,2136,24796,0,0,130945,0,0,0,0,2000,2000,4379,980,5359,4752,1023,5775,4910,42,185,2,0,2,101,825,1157
1,20/12/2022,0121-Saidapet,48411,84461,200,1632,23098,0,0,73341,0,0,0,0,4500,4500,2020,825,2845,2534,792,3326,2509,11,0,2,0,1,53,759,826
1,20/12/2022,0123-Little Mount,84414,103130,600,2216,23862,0,0,111092,0,0,0,0,250,250,3744,966,4710,3140,689,3829,3277,32,148,1,0,1,99,823,1104
1,20/12/2022,0125-Guindy,132867,272209,1300,8920,75528,0,0,218615,0,0,0,0,500,500,8204,2809,11013,7457,2519,9976,7906,38,424,3,0,2,297,2394,3158
1,20/12/2022,0129-Nanganallur Road,53371,49158,0,800,11974,0,0,66145,0,0,0,0,0,0,1378,394,1772,1457,364,1821,1427,6,0,0,0,1,31,347,385
1,20/12/2022,0131-Meenambakkam,133094,137724,2376,3600,36716,0,0,175786,0,0,0,0,0,0,3933,1117,5050,3282,930,4212,3457,18,171,5,0,0,105,989,1288
1,20/12/2022,0133-Chennai International Airport,204580,343037,1228,11080,143624,0,0,360512,0,0,0,0,9000,9000,6249,4053,10302,6070,4015,10085,6471,70,804,9,0,17,292,3592,4784
2,20/12/2022,0201-Puratchi Thalaivar Dr. M.G. Ramachandran Central,231298,478668,1250,13456,201488,0,0,447492,0,0,0,0,5650,5650,12268,7479,19747,11384,7456,18840,12075,126,1088,3,0,20,561,6652,8450
2,20/12/2022,0203-Egmore,63519,132247,0,3144,63138,0,0,129801,0,0,0,0,6500,6500,2553,2261,4814,2645,2817,5462,2861,24,395,4,0,6,130,2108,2667
2,20/12/2022,0205-Nehru Park,35067,44190,0,1040,11850,0,0,47957,0,0,0,0,0,0,1454,470,1924,1325,456,1781,1392,22,92,0,0,0,40,426,580
2,20/12/2022,0207-Kilpauk,36268,59202,1129,728,17126,0,0,55251,0,0,0,0,0,0,1577,612,2189,1660,639,2299,1697,25,91,0,0,0,33,561,710
2,20/12/2022,0209-Pachaiyappas College,55302,49876,0,936,11230,0,0,67468,0,0,0,0,10000,10000,1784,474,2258,1565,544,2109,1623,20,75,2,0,0,42,424,563
2,20/12/2022,0211-Shenoy Nagar,47506,51174,200,688,12956,0,0,61350,0,0,0,0,2000,2000,1452,470,1922,1526,488,2014,1572,15,85,0,0,0,30,437,567
2,20/12/2022,0213-Anna Nagar East,98495,118762,550,2848,28908,0,0,130801,0,0,0,0,0,0,3485,1073,4558,3454,1067,4521,3611,23,196,0,0,0,85,955,1259
2,20/12/2022,0215-Anna Nagar Tower,106471,111151,20,2208,25224,0,0,133923,0,0,0,0,2000,2000,3131,940,4071,3166,984,4150,3317,24,201,2,0,2,85,828,1142
2,20/12/2022,0217-Thirumangalam,269847,328398,915,9024,79436,0,0,359222,0,0,0,0,0,0,8999,2849,11848,8919,2836,11755,9344,48,579,2,0,1,307,2450,3387
2,20/12/2022,0219-Koyambedu,186886,243444,1945,4280,83362,0,0,276473,0,0,0,0,3500,3500,6227,2840,9067,5660,2348,8008,5923,55,438,4,0,5,168,2607,3277
2,20/12/2022,0221-Puratchi Thalaivi Dr. J. Jayalalithaa CMBT,63154,168703,280,3024,79424,0,0,145882,0,0,0,0,0,0,2657,2688,5345,3530,3618,7148,3554,17,366,6,0,5,130,2512,3036
2,20/12/2022,0223-Arumbakkam,64396,65568,200,1592,22284,0,0,88472,0,0,0,0,11000,11000,1821,842,2663,1807,683,2490,1763,34,8,0,0,2,54,769,867
2,20/12/2022,0225-Vadapalani,118523,218927,700,7376,75810,0,0,202409,0,0,0,0,5000,5000,5062,2728,7790,5091,2940,8031,5597,30,652,0,0,7,270,2358,3317
2,20/12/2022,0227-Ashok Nagar,101837,156637,900,3864,49512,0,0,156113,328550,0,328550,0,0,0,4079,1747,5826,4011,1520,5531,4211,33,314,4,0,1,151,1499,2002
2,20/12/2022,0229-Ekkattuthangal,88937,142460,2550,3048,37124,0,0,131659,0,0,0,0,1250,1250,4007,1392,5399,4367,1090,5457,4317,29,0,0,0,1,133,1201,1364
2,20/12/2022,0231-Arignar Anna Alandur,174811,201341,1540,5328,58842,0,0,240521,0,0,0,0,5000,5000,5854,2043,7897,5158,1811,6969,5539,42,437,3,0,1,203,1729,2415
2,20/12/2022,0233-St. Thomas Mount,98553,111193,820,3176,32346,0,0,134895,0,0,0,6000,7900,13900,3111,1139,4250,2978,1024,4002,3093,35,183,1,0,0,120,976,1315
1,21/12/2022,01ED-Wimco Nagar Depot Metro,81796,82012,1250,912,24826,0,0,108784,0,0,0,0,2750,2750,2271,635,2906,1830,456,2286,1813,16,4,1,0,4,28,609,662
1,21/12/2022,01EF-Wimco Nagar Metro,113459,124380,526,1464,28388,0,0,143837,0,0,0,0,250,250,3201,746,3947,3010,741,3751,3038,38,41,3,1,7,44,692,826
1,21/12/2022,01F1-Thiruvotriyur Metro,107263,100096,0,1336,18476,0,0,127075,0,0,0,0,0,0,2961,537,3498,2724,438,3162,2716,28,0,0,0,3,46,493,570
1,21/12/2022,01F3-Thiruvotriyur Theradi Metro,99014,124114,900,2136,29034,0,0,131084,0,0,0,0,0,0,2996,859,3855,3227,873,4100,3284,19,42,5,0,6,66,784,922
1,21/12/2022,01F5-Kaladipet Metro,104060,104202,0,1064,22668,0,0,127792,0,0,0,0,0,0,3166,710,3876,3041,675,3716,3016,13,0,1,0,4,34,672,724
1,21/12/2022,01F7-Tollgate Metro,67262,59328,236,632,14306,0,0,82436,0,0,0,0,0,0,1728,466,2194,1658,442,2100,1647,21,0,0,0,6,21,433,481
1,21/12/2022,01F9-New Washermenpet Metro,103539,94992,100,736,20636,0,0,125011,0,0,0,0,1500,1500,2926,671,3597,2928,656,3584,2944,12,49,0,0,0,26,646,733
1,21/12/2022,01FB-Tondiarpet Metro,96590,103965,1750,1296,25824,0,0,125460,0,0,0,0,1000,1000,3099,830,3929,3118,864,3982,3099,20,1,0,0,0,33,785,839
1,21/12/2022,01FD-Thiagaraya College Metro,110095,118020,200,1256,26214,0,0,137765,0,0,0,0,4250,4250,3648,919,4567,3737,864,4601,3751,29,37,0,0,1,45,867,979
1,21/12/2022,0101-Washermanpet,118810,133642,100,2160,41510,0,0,162580,0,0,0,0,9500,9500,4164,1471,5635,3642,1326,4968,3804,27,183,0,0,2,88,1365,1665
1,21/12/2022,0103-Mannadi,83363,115738,600,1016,31712,0,0,116691,0,0,0,0,1500,1500,3276,1102,4378,3508,1158,4666,3561,18,120,1,0,0,42,1056,1237
1,21/12/2022,0105-High Court,127415,251468,890,2752,70032,0,0,201089,0,0,0,0,0,0,7301,2495,9796,7305,2219,9524,7449,20,253,2,0,1,106,2364,2746
1,21/12/2022,0109-Government Estate,94413,157187,350,1752,47926,0,0,144441,0,0,0,0,1500,1500,4352,1778,6130,4734,1791,6525,4897,26,282,0,0,3,76,1662,2049
1,21/12/2022,0111-LIC,82024,167655,480,1592,32872,0,0,116968,0,0,0,0,250,250,4802,1152,5954,5482,1017,6499,5444,43,0,3,0,3,64,1069,1182
1,21/12/2022,0113-Thousand Lights,135386,278035,3360,4408,51444,0,0,194598,0,0,0,0,0,0,8288,1908,10196,9222,1773,10995,9159,30,0,1,0,2,179,1657,1869
1,21/12/2022,0115-AG-DMS,114382,167033,850,1880,31242,0,0,148354,0,0,0,0,500,500,5484,1129,6613,5230,880,6110,5394,23,214,0,0,0,81,1000,1318
1,21/12/2022,0117-Teynampet,106411,164567,1400,2384,32416,0,0,142611,0,0,0,0,0,0,5078,1215,6293,5529,1118,6647,5548,21,93,0,0,0,93,1093,1300
1,21/12/2022,0119-Nandanam,102587,139432,300,1800,26724,0,0,131411,0,0,0,0,3000,3000,4258,1032,5290,4724,972,5696,4844,34,189,0,0,2,80,913,1218
1,21/12/2022,0121-Saidapet,48386,90456,500,1144,25296,0,0,75326,0,0,0,0,3000,3000,2207,866,3073,2699,933,3632,2661,13,0,2,0,2,50,808,875
1,21/12/2022,0123-Little Mount,81185,107562,550,1712,25206,0,0,108653,0,0,0,0,500,500,3821,966,4787,3193,776,3969,3352,14,207,1,0,2,78,863,1165
1,21/12/2022,0125-Guindy,145532,290509,3300,7928,82878,0,0,239638,0,0,0,0,1500,1500,8671,2951,11622,7589,2576,10165,8240,43,656,4,0,3,261,2605,3572
1,21/12/2022,0129-Nanganallur Road,48694,46852,1100,408,10800,0,0,61002,0,0,0,0,0,0,1325,361,1686,1425,345,1770,1373,7,0,1,0,0,17,335,360
1,21/12/2022,0131-Meenambakkam,132030,137300,0,1728,36786,0,0,170544,0,0,0,0,0,0,4017,1075,5092,3229,937,4166,3432,21,251,3,0,2,64,1005,1346
1,21/12/2022,0133-Chennai International Airport,172155,343755,2000,5720,146520,0,0,326395,0,0,0,0,7500,7500,6023,4002,10025,6246,3997,10243,6456,58,805,17,0,8,185,3767,4840
2,21/12/2022,0201-Puratchi Thalaivar Dr. M.G. Ramachandran Central,224781,499183,600,10384,216498,0,0,452263,0,0,0,0,5850,5850,12302,7727,20029,11909,7678,19587,12278,127,1181,7,0,15,419,7101,8850
2,21/12/2022,0203-Egmore,81540,144871,700,2376,72288,0,0,156904,0,0,0,0,10500,10500,2627,2557,5184,2861,2991,5852,2990,29,429,6,0,4,103,2427,2998
2,21/12/2022,0205-Nehru Park,38420,46271,500,768,13934,0,0,53622,0,0,0,0,6000,6000,1431,520,1951,1305,500,1805,1381,28,99,4,0,0,32,484,647
2,21/12/2022,0207-Kilpauk,38986,61122,0,504,17972,0,0,57462,0,0,0,0,0,0,1649,655,2304,1684,665,2349,1739,22,121,0,0,1,23,624,791
2,21/12/2022,0209-Pachaiyappas College,49110,52686,0,520,13178,0,0,62808,0,0,0,0,8250,8250,1842,521,2363,1638,506,2144,1658,23,73,1,0,1,23,489,610
2,21/12/2022,0211-Shenoy Nagar,49876,53214,0,432,13080,0,0,63388,0,0,0,0,3000,3000,1459,472,1931,1621,508,2129,1651,13,96,0,0,0,19,447,575
2,21/12/2022,0213-Anna Nagar East,87582,127594,800,1792,32250,0,0,122424,0,0,0,0,0,0,3695,1183,4878,3667,1021,4688,3820,29,293,1,0,3,76,1087,1489
2,21/12/2022,0215-Anna Nagar Tower,79142,107847,150,1440,26968,0,0,107700,0,0,0,0,2000,2000,3103,964,4067,3016,932,3948,3136,21,226,0,0,2,56,894,1199
2,21/12/2022,0217-Thirumangalam,268833,339979,1030,7016,86582,0,0,363461,0,0,0,0,0,0,9286,2937,12223,9300,2756,12056,9529,58,610,4,0,7,208,2679,3566
2,21/12/2022,0219-Koyambedu,182855,247987,539,3776,86224,0,0,273394,0,0,0,0,2750,2750,6274,2890,9164,5655,2349,8004,5975,39,539,3,0,7,144,2708,3440
2,21/12/2022,0221-Puratchi Thalaivi Dr. J. Jayalalithaa CMBT,64629,177924,430,2448,83274,0,0,150781,0,0,0,0,0,0,2720,2773,5493,3956,4529,8485,3794,38,382,3,0,11,102,2668,3204
2,21/12/2022,0223-Arumbakkam,53337,65707,0,1320,21772,0,0,76429,0,0,0,0,3750,3750,1866,821,2687,1865,641,2506,1821,40,6,1,0,2,52,758,859
2,21/12/2022,0225-Vadapalani,114614,218914,910,4272,74580,0,0,194376,0,0,0,0,4000,4000,5187,2594,7781,5286,2680,7966,5636,22,687,1,0,7,178,2371,3266
2,21/12/2022,0227-Ashok Nagar,99100,154213,750,3512,51554,0,0,154916,0,0,0,0,2000,2000,3947,1784,5731,3890,1569,5459,4067,16,295,4,0,2,127,1613,2057
2,21/12/2022,0229-Ekkattuthangal,91888,151408,1599,2840,36438,0,0,132765,0,0,0,0,0,0,4339,1330,5669,4581,1162,5743,4671,31,227,8,0,7,120,1169,1562
2,21/12/2022,0231-Arignar Anna Alandur,166542,210428,2869,5208,59528,0,0,234147,0,0,0,0,5250,5250,6055,2044,8099,5468,1888,7356,5884,42,548,5,0,1,170,1796,2562
2,21/12/2022,0233-St. Thomas Mount,95456,113702,200,2904,33062,0,0,131622,0,0,0,3000,2000,5000,3247,1152,4399,3012,960,3972,3155,18,219,4,0,2,106,1014,1363
1,22/12/2022,01ED-Wimco Nagar Depot Metro,84399,81772,0,1272,23496,0,0,109167,0,0,0,0,500,500,2291,614,2905,1857,422,2279,1822,13,0,4,0,4,34,578,633
1,22/12/2022,01EF-Wimco Nagar Metro,112217,126488,114,3080,28262,0,0,143673,0,0,0,0,1250,1250,3289,795,4084,3032,718,3750,3083,48,85,1,0,4,81,695,914
1,22/12/2022,01F1-Thiruvotriyur Metro,110992,98779,200,1200,20244,0,0,132636,0,0,0,0,0,0,2897,566,3463,2653,480,3133,2628,15,0,1,0,4,37,534,591
1,22/12/2022,01F3-Thiruvotriyur Theradi Metro,92813,118830,100,1704,27342,0,0,121959,0,0,0,0,0,0,3000,815,3815,3132,777,3909,3148,15,58,4,0,3,55,749,884
1,22/12/2022,01F5-Kaladipet Metro,97842,100431,200,1448,21480,0,0,120970,0,0,0,0,0,0,3002,686,3688,2945,607,3552,2935,15,0,4,0,3,48,635,705
1,22/12/2022,01F7-Tollgate Metro,59180,60239,40,600,15322,0,0,75142,0,0,0,0,0,0,1777,478,2255,1657,365,2022,1646,28,0,0,0,10,21,452,511
1,22/12/2022,01F9-New Washermenpet Metro,93771,92075,200,784,19568,0,0,114323,0,0,0,0,250,250,2870,672,3542,2870,606,3476,2866,18,39,0,0,5,32,638,732
1,22/12/2022,01FB-Tondiarpet Metro,80226,100612,155,1584,26480,0,0,108445,0,0,0,0,1750,1750,2902,872,3774,2941,745,3686,2909,24,7,0,0,2,52,806,891
1,22/12/2022,01FD-Thiagaraya College Metro,103937,118039,300,1904,28558,0,0,134699,0,0,0,0,1250,1250,3558,1006,4564,3686,879,4565,3697,38,14,1,0,4,73,923,1053
1,22/12/2022,0101-Washermanpet,91538,127773,340,1696,40604,0,0,134178,0,0,0,0,11250,11250,3868,1388,5256,3505,1301,4806,3566,17,150,4,0,5,72,1304,1552
1,22/12/2022,0103-Mannadi,76400,110408,700,2056,30642,0,0,109798,0,0,0,0,0,0,3064,1109,4173,3355,996,4351,3373,13,88,1,0,2,57,1041,1202
1,22/12/2022,0105-High Court,128276,247962,1700,2816,67444,0,0,200236,0,0,0,0,0,0,7090,2369,9459,7352,2195,9547,7451,27,249,3,0,3,120,2205,2607
1,22/12/2022,0109-Government Estate,99435,156911,1600,2464,48830,0,0,152329,0,0,0,0,6500,6500,4343,1784,6127,4627,1682,6309,4796,21,266,2,0,5,110,1622,2026
1,22/12/2022,0111-LIC,86629,179537,2000,2008,34092,0,0,124729,0,0,0,0,2000,2000,5149,1216,6365,5921,1033,6954,5854,24,1,0,0,7,86,1087,1205
1,22/12/2022,0113-Thousand Lights,152764,271962,1550,4296,48942,0,0,207552,0,0,0,0,0,0,8291,1841,10132,9069,1780,10849,9065,33,85,0,0,6,189,1554,1867
1,22/12/2022,0115-AG-DMS,109975,162475,430,2720,31406,0,0,144531,0,0,0,0,1250,1250,5037,1162,6199,4884,779,5663,5154,23,268,0,0,1,108,1001,1401
1,22/12/2022,0117-Teynampet,92492,155082,2390,2600,28930,0,0,126412,0,0,0,0,0,0,4942,1136,6078,5316,1020,6336,5320,25,77,2,0,3,104,998,1209
1,22/12/2022,0119-Nandanam,99591,137943,2600,3056,24768,0,0,130015,0,0,0,0,2000,2000,4362,975,5337,4656,926,5582,4839,33,228,2,0,1,103,803,1170
1,22/12/2022,0121-Saidapet,49468,87939,200,1888,25808,0,0,77364,0,0,0,0,4500,4500,2078,915,2993,2590,788,3378,2530,12,0,5,0,1,69,839,926
1,22/12/2022,0123-Little Mount,78705,108504,100,2616,28998,0,0,110419,0,0,0,0,1000,1000,3726,1112,4838,3110,732,3842,3238,22,204,0,0,3,105,957,1291
1,22/12/2022,0125-Guindy,133953,278715,1350,9744,68726,0,0,213773,0,0,0,0,0,0,8650,2607,11257,7390,2367,9757,8324,22,916,2,0,3,365,2172,3480
1,22/12/2022,0129-Nanganallur Road,46455,51560,500,712,13438,0,0,61105,0,0,0,0,0,0,1376,428,1804,1512,366,1878,1450,8,0,0,0,0,24,392,424
1,22/12/2022,0131-Meenambakkam,118457,133747,100,2728,34226,0,0,155511,0,0,0,0,0,0,3944,1053,4997,3298,799,4097,3423,22,234,6,0,2,82,947,1293
1,22/12/2022,0133-Chennai International Airport,198504,350382,700,9584,134660,0,0,343448,0,0,0,0,4500,4500,6583,3809,10392,6643,3916,10559,6892,61,1206,6,0,22,295,3453,5043
2,22/12/2022,0201-Puratchi Thalaivar Dr. M.G. Ramachandran Central,252567,496709,1521,13368,177988,0,0,445444,0,0,0,0,7450,7450,13076,6565,19641,12387,7348,19735,13437,97,2223,20,0,15,549,5827,8731
2,22/12/2022,0203-Egmore,67158,135820,100,2360,64954,0,0,134572,0,0,0,0,8000,8000,2456,2298,4754,3118,2902,6020,3004,17,465,14,0,4,108,2159,2767
2,22/12/2022,0205-Nehru Park,40247,49132,1500,1272,14874,0,0,57893,0,0,0,0,250,250,1512,574,2086,1345,510,1855,1468,14,157,0,0,1,57,506,735
2,22/12/2022,0207-Kilpauk,34133,60014,1700,1016,17386,0,0,54235,0,0,0,0,0,0,1647,652,2299,1692,626,2318,1730,12,106,0,0,0,46,589,753
2,22/12/2022,0209-Pachaiyappas College,46230,50344,0,1064,13034,0,0,60328,0,0,0,0,6000,6000,1694,537,2231,1547,466,2013,1573,13,68,2,0,0,43,484,610
2,22/12/2022,0211-Shenoy Nagar,42480,49862,0,872,12158,0,0,55510,0,0,0,0,0,0,1390,453,1843,1482,442,1924,1514,14,71,1,0,0,33,411,530
2,22/12/2022,0213-Anna Nagar East,84401,121625,200,2192,29888,0,0,116681,0,0,0,0,3000,3000,3605,1112,4717,3519,919,4438,3645,24,248,2,0,3,93,998,1368
2,22/12/2022,0215-Anna Nagar Tower,94522,107828,1300,2136,26084,0,0,124042,0,0,0,0,0,0,3010,963,3973,3059,914,3973,3159,12,268,5,0,3,84,856,1228
2,22/12/2022,0217-Thirumangalam,269102,331507,1100,8744,83308,0,0,362254,0,0,0,0,500,500,9032,2944,11976,9061,2641,11702,9353,52,649,3,0,4,324,2554,3586
2,22/12/2022,0219-Koyambedu,188156,252844,1200,5104,78380,0,0,272840,0,0,0,0,4750,4750,6673,2737,9410,5682,2193,7875,6415,47,1061,5,1,10,202,2392,3718
2,22/12/2022,0221-Puratchi Thalaivi Dr. J. Jayalalithaa CMBT,68973,177905,600,2936,68926,0,0,141435,0,0,0,0,0,0,2902,2391,5293,4627,4491,9118,4244,35,658,1,0,7,127,2205,3033
2,22/12/2022,0223-Arumbakkam,54507,63829,0,1352,22254,0,0,78113,0,0,0,0,4250,4250,1706,836,2542,1771,618,2389,1692,28,5,6,0,1,63,762,865
2,22/12/2022,0225-Vadapalani,113498,213480,400,6200,68722,0,0,188820,0,0,0,0,3500,3500,5029,2513,7542,4968,2758,7726,5592,44,927,4,0,7,253,2129,3364
2,22/12/2022,0227-Ashok Nagar,92865,153232,100,4416,44128,0,0,141509,0,0,0,0,0,0,4054,1608,5662,3889,1499,5388,4268,31,517,5,0,4,173,1373,2103
2,22/12/2022,0229-Ekkattuthangal,88551,149350,1340,4328,33796,0,0,128015,0,0,0,0,250,250,4449,1287,5736,4365,989,5354,4668,19,323,0,0,3,170,1056,1571
2,22/12/2022,0231-Arignar Anna Alandur,151325,208662,0,5248,61836,0,0,218409,0,0,0,0,5000,5000,5978,2170,8148,5432,1730,7162,5732,54,483,5,0,8,207,1854,2611
2,22/12/2022,0233-St. Thomas Mount,96807,116959,250,4032,33046,0,0,134135,0,0,0,3000,5200,8200,3230,1170,4400,3043,949,3992,3232,31,312,2,0,1,138,1013,1497
1,23/12/2022,01ED-Wimco Nagar Depot Metro,71183,85811,500,1320,30026,0,0,103029,0,0,0,0,0,0,2243,768,3011,1805,555,2360,1789,13,0,2,0,3,37,722,777
1,23/12/2022,01EF-Wimco Nagar Metro,103049,130636,1253,3448,32016,0,0,139766,0,0,0,0,3250,3250,3318,892,4210,3022,920,3942,3094,48,82,3,0,5,100,773,1011
1,23/12/2022,01F1-Thiruvotriyur Metro,102090,106395,100,2112,20970,0,0,125272,0,0,0,0,0,0,3163,636,3799,2777,572,3349,2843,25,59,0,0,6,67,574,731
1,23/12/2022,01F3-Thiruvotriyur Theradi Metro,94732,133908,700,2600,35870,0,0,133902,0,0,0,0,0,0,3223,1032,4255,3253,1080,4333,3381,17,147,2,0,5,90,935,1196
1,23/12/2022,01F5-Kaladipet Metro,80633,102809,0,1936,24192,0,0,106761,0,0,0,0,0,0,3025,761,3786,2879,677,3556,2920,17,49,1,0,3,44,709,823
1,23/12/2022,01F7-Tollgate Metro,55084,63729,0,1128,16264,0,0,72476,0,0,0,0,0,0,1776,529,2305,1678,512,2190,1714,12,48,0,0,11,40,472,583
1,23/12/2022,01F9-New Washermenpet Metro,85411,93625,0,1016,21182,0,0,107609,0,0,0,0,250,250,2892,715,3607,2776,711,3487,2845,11,78,0,0,6,37,675,807
1,23/12/2022,01FB-Tondiarpet Metro,86296,107680,900,1768,31786,0,0,120750,0,0,0,0,250,250,3034,1050,4084,2985,958,3943,2979,17,0,1,0,3,60,977,1058
1,23/12/2022,01FD-Thiagaraya College Metro,100206,122303,938,1848,32306,0,0,135298,1410,0,1410,0,0,0,3540,1152,4692,3663,977,4640,3685,18,26,0,0,7,68,1070,1189
1,23/12/2022,0101-Washermanpet,81423,133354,800,2216,45682,0,0,130121,0,0,0,0,4250,4250,3787,1558,5345,3474,1406,4880,3561,21,129,2,0,13,80,1459,1704
1,23/12/2022,0103-Mannadi,74569,119109,0,1280,39268,0,0,115117,0,0,0,0,0,0,3206,1351,4557,3370,1279,4649,3370,17,95,0,0,5,53,1290,1460
1,23/12/2022,0105-High Court,120405,281617,900,3096,99272,0,0,223673,0,0,0,0,0,0,7220,3435,10655,7336,2607,9943,7514,31,322,3,0,15,146,3250,3767
1,23/12/2022,0109-Government Estate,87641,159958,150,3072,49138,0,0,140001,0,0,0,0,500,500,4342,1830,6172,4584,1830,6414,4851,31,405,1,0,6,135,1617,2195
1,23/12/2022,0111-LIC,68936,186422,350,2872,42688,0,0,114846,0,0,0,0,2000,2000,5153,1520,6673,5864,1206,7070,5802,22,7,0,0,11,114,1367,1521
1,23/12/2022,0113-Thousand Lights,119616,275060,1950,7280,58254,0,0,187100,0,0,0,0,0,0,7951,2244,10195,8708,1762,10470,8732,26,1,2,0,8,293,1833,2163
1,23/12/2022,0115-AG-DMS,85656,140457,580,2256,30614,0,0,119106,0,0,0,0,0,0,4329,1074,5403,4180,796,4976,4350,20,222,2,0,0,90,931,1265
1,23/12/2022,0117-Teynampet,90795,160721,1330,3400,40180,0,0,135705,0,0,0,0,2000,2000,4878,1535,6413,5075,1148,6223,5045,24,0,1,0,4,138,1336,1503
1,23/12/2022,0119-Nandanam,89665,134509,524,3264,26444,0,0,119897,0,0,0,0,0,0,4258,1042,5300,4354,960,5314,4600,34,239,1,0,3,136,849,1262
1,23/12/2022,0121-Saidapet,49580,86136,550,1952,28496,0,0,80578,0,0,0,0,4250,4250,2067,1015,3082,2363,872,3235,2340,12,0,0,0,0,79,921,1012
1,23/12/2022,0123-Little Mount,75542,111758,520,3352,34196,0,0,113610,0,0,0,0,1000,1000,3784,1317,5101,2941,748,3689,3167,13,214,2,0,1,139,1130,1499
1,23/12/2022,0125-Guindy,171481,310335,250,10632,78224,0,0,260587,0,0,0,0,0,0,9240,2924,12164,7173,2810,9983,8989,42,1751,9,0,1,419,2403,4625
1,23/12/2022,0129-Nanganallur Road,44830,56344,100,880,18120,0,0,63930,0,0,0,0,0,0,1350,566,1916,1489,562,2051,1429,7,0,0,0,0,33,507,547
1,23/12/2022,0131-Meenambakkam,126341,150534,1900,3360,46684,0,0,178285,0,0,0,0,0,0,4099,1440,5539,3225,1100,4325,3514,14,358,3,0,3,114,1303,1795
1,23/12/2022,0133-Chennai International Airport,186333,403440,898,12144,172940,0,0,372315,0,0,0,0,6000,6000,6910,4907,11817,6562,4594,11156,7335,51,1478,17,0,16,377,4310,6249
2,23/12/2022,0201-Puratchi Thalaivar Dr. M.G. Ramachandran Central,223417,582819,1750,16656,251806,0,0,493629,0,0,0,0,9750,9750,12373,9158,21531,13914,9598,23512,13984,123,1724,5,0,26,667,8102,10647
2,23/12/2022,0203-Egmore,75913,160463,300,3456,76216,0,0,155885,0,0,0,0,15500,15500,2614,2719,5333,3564,3744,7308,3556,21,526,2,0,4,140,2551,3244
2,23/12/2022,0205-Nehru Park,41271,52849,650,1600,17314,0,0,60835,0,0,0,0,2000,2000,1531,692,2223,1411,598,2009,1500,23,135,0,0,2,69,605,834
2,23/12/2022,0207-Kilpauk,44800,64922,0,1096,20238,0,0,66134,0,0,0,0,0,0,1766,758,2524,1688,671,2359,1805,22,158,0,0,0,47,701,928
2,23/12/2022,0209-Pachaiyappas College,35948,52834,0,944,14378,0,0,51270,0,0,0,0,0,0,1850,602,2452,1530,488,2018,1626,11,111,1,0,3,45,551,722
2,23/12/2022,0211-Shenoy Nagar,37553,53690,200,936,15534,0,0,54223,0,0,0,0,250,250,1441,570,2011,1494,562,2056,1571,12,102,0,0,1,37,512,664
2,23/12/2022,0213-Anna Nagar East,83942,122337,50,3016,34604,0,0,121612,0,0,0,0,0,0,3471,1300,4771,3397,1128,4525,3517,17,223,6,0,1,112,1155,1514
2,23/12/2022,0215-Anna Nagar Tower,83709,110044,706,3616,27430,0,0,115461,0,0,0,0,1000,1000,3107,1030,4137,2981,1030,4011,3192,18,321,1,0,5,109,902,1356
2,23/12/2022,0217-Thirumangalam,240829,350273,1050,10240,103886,0,0,356005,0,0,0,0,0,0,9236,3700,12936,8788,3170,11958,9273,56,821,5,0,3,385,3216,4486
2,23/12/2022,0219-Koyambedu,180564,275952,700,6216,115512,0,0,302992,0,0,0,0,2250,2250,6264,4079,10343,5603,2881,8484,5990,41,767,3,0,14,269,3671,4765
2,23/12/2022,0221-Puratchi Thalaivi Dr. J. Jayalalithaa CMBT,71669,248503,0,4520,97046,0,0,173235,0,0,0,0,0,0,3062,3267,6329,7357,8301,15658,5917,23,690,3,0,8,195,3010,3929
2,23/12/2022,0223-Arumbakkam,51603,64140,0,1320,26388,0,0,79311,0,0,0,0,0,0,1837,965,2802,1607,764,2371,1534,45,3,0,0,9,57,900,1014
2,23/12/2022,0225-Vadapalani,122917,238194,875,8312,90134,0,0,222238,0,0,0,0,5500,5500,5280,3362,8642,5199,3143,8342,5738,51,843,11,0,4,339,2878,4126
2,23/12/2022,0227-Ashok Nagar,81714,168756,1555,4968,57250,0,0,145487,0,0,0,0,0,0,4201,2116,6317,3922,1876,5798,4371,31,514,4,0,4,217,1775,2545
2,23/12/2022,0229-Ekkattuthangal,83718,147408,1010,5408,41194,0,0,131330,0,0,0,0,0,0,4267,1586,5853,3810,1016,4826,4246,26,445,2,0,4,212,1286,1975
2,23/12/2022,0231-Arignar Anna Alandur,145100,243656,3670,7992,87094,0,0,243856,0,0,0,0,2000,2000,6196,3043,9239,5372,2282,7654,6049,48,765,4,0,9,307,2549,3682
2,23/12/2022,0233-St. Thomas Mount,97647,134052,700,5152,43976,0,0,147475,0,0,0,3000,3475,6475,3442,1601,5043,2879,1244,4123,3394,27,522,10,0,1,194,1342,2096
1,24/12/2022,01ED-Wimco Nagar Depot Metro,58997,71603,0,1872,30880,0,0,91749,0,0,0,0,1000,1000,1656,802,2458,1313,645,1958,1272,13,0,1,0,3,52,740,809
1,24/12/2022,01EF-Wimco Nagar Metro,91846,112855,664,3856,38422,0,0,134788,0,0,0,0,1000,1000,2415,1048,3463,2137,1120,3257,2289,37,123,8,0,17,109,906,1200
1,24/12/2022,01F1-Thiruvotriyur Metro,88636,94442,0,1552,30328,0,0,120516,0,0,0,0,0,0,2322,815,3137,2125,914,3039,2082,36,2,2,0,13,53,764,870
1,24/12/2022,01F3-Thiruvotriyur Theradi Metro,80468,126918,0,3088,47696,0,0,131252,0,0,0,0,0,0,2532,1349,3881,2701,1413,4114,2677,24,33,2,0,13,97,1204,1373
1,24/12/2022,01F5-Kaladipet Metro,80468,89072,0,2832,31180,0,0,114480,0,0,0,0,0,0,2201,955,3156,2112,887,2999,2102,37,0,7,0,4,86,870,1004
1,24/12/2022,01F7-Tollgate Metro,44282,53374,1241,1160,18652,0,0,65335,0,0,0,0,0,0,1307,588,1895,1310,547,1857,1260,18,0,1,0,13,40,534,606
1,24/12/2022,01F9-New Washermenpet Metro,68757,79981,0,704,26476,0,0,95937,0,0,0,0,250,250,2086,816,2902,2047,860,2907,2069,14,76,0,0,2,33,790,915
1,24/12/2022,01FB-Tondiarpet Metro,70104,89072,550,2304,35018,0,0,107976,0,0,0,0,1000,1000,2198,1122,3320,2125,1062,3187,2108,19,2,1,0,11,80,1035,1148
1,24/12/2022,01FD-Thiagaraya College Metro,88360,114926,510,2864,45168,0,0,136902,0,0,0,0,1000,1000,2756,1498,4254,2748,1243,3991,2764,43,68,1,0,6,87,1355,1560
1,24/12/2022,0101-Washermanpet,86558,114498,1770,1984,52486,0,0,142798,0,0,0,0,11000,11000,2521,1691,4212,2402,1555,3957,2464,19,148,0,0,15,79,1585,1846
1,24/12/2022,0103-Mannadi,70558,101949,900,2088,42272,0,0,115818,0,0,0,0,3000,3000,2299,1497,3796,2426,1389,3815,2488,13,132,1,0,5,80,1405,1636
1,24/12/2022,0105-High Court,86686,179249,500,3760,76634,0,0,167580,0,0,0,0,0,0,3871,2645,6516,3831,2133,5964,4087,13,461,7,0,6,154,2412,3053
1,24/12/2022,0109-Government Estate,74999,153306,0,3576,63134,0,0,141709,0,0,0,0,250,250,3399,2319,5718,3521,2139,5660,3791,33,422,2,0,17,153,2074,2701
1,24/12/2022,0111-LIC,38748,99578,167,2832,41686,0,0,83433,0,0,0,0,0,0,1911,1460,3371,2355,1338,3693,2278,38,5,1,0,7,118,1298,1467
1,24/12/2022,0113-Thousand Lights,76276,168210,400,5392,54112,0,0,136180,0,0,0,0,0,0,3939,1966,5905,4630,1762,6392,4535,22,0,0,0,6,221,1680,1929
1,24/12/2022,0115-AG-DMS,46263,74038,700,1648,21352,0,0,69963,0,0,0,0,0,0,1802,725,2527,1809,708,2517,1974,11,240,0,0,1,61,635,948
1,24/12/2022,0117-Teynampet,49567,84606,950,1512,31832,0,0,83861,0,0,0,0,2000,2000,1884,1140,3024,2341,1068,3409,2187,18,0,0,0,6,53,1061,1138
1,24/12/2022,0119-Nandanam,48566,82478,300,2024,26354,0,0,77244,0,0,0,0,0,0,2102,950,3052,2023,885,2908,2208,12,228,3,0,4,76,850,1173
1,24/12/2022,0121-Saidapet,32876,60976,0,1200,28358,0,0,62434,0,0,0,0,7500,7500,1075,940,2015,1302,835,2137,1228,16,0,6,0,6,50,874,952
1,24/12/2022,0123-Little Mount,46878,68542,275,2160,25852,0,0,75165,0,0,0,0,0,0,1848,923,2771,1410,706,2116,1655,14,298,3,0,9,83,795,1202
1,24/12/2022,0125-Guindy,104013,233814,1590,8136,102158,0,0,215897,0,0,0,0,0,0,4694,3481,8175,4176,2978,7154,4875,30,903,4,0,13,320,3108,4378
1,24/12/2022,0129-Nanganallur Road,21654,39600,0,784,17748,0,0,40186,0,0,0,0,0,0,755,548,1303,839,492,1331,787,11,1,5,0,3,31,501,552
1,24/12/2022,0131-Meenambakkam,92028,124078,100,4136,51658,0,0,147922,0,0,0,0,0,0,2588,1488,4076,2042,1285,3327,2356,25,424,6,0,9,111,1341,1916
1,24/12/2022,0133-Chennai International Airport,169288,371687,1100,13936,196008,0,0,380332,0,0,0,0,3000,3000,5025,5492,10517,4941,5418,10359,5507,79,1449,39,0,21,385,4909,6882
2,24/12/2022,0201-Puratchi Thalaivar Dr. M.G. Ramachandran Central,191243,534567,300,17424,281562,0,0,490529,0,0,0,0,4700,4700,8886,9917,18803,8880,9860,18740,9896,118,2167,13,0,36,688,8739,11761
2,24/12/2022,0203-Egmore,71658,140146,500,3320,72684,0,0,148162,0,0,0,0,15500,15500,2143,2590,4733,2332,3262,5594,2696,19,670,12,0,9,132,2413,3255
2,24/12/2022,0205-Nehru Park,27328,53584,450,1728,25202,0,0,54708,0,0,0,0,2500,2500,1173,928,2101,1078,702,1780,1172,20,142,5,0,3,60,831,1061
2,24/12/2022,0207-Kilpauk,28773,45020,0,1424,16934,0,0,47131,0,0,0,0,0,0,1064,630,1694,1057,624,1681,1127,26,107,1,0,0,65,560,759
2,24/12/2022,0209-Pachaiyappas College,25210,41670,0,608,15074,0,0,40892,0,0,0,0,0,0,1144,565,1709,1028,598,1626,1093,14,116,0,0,2,25,528,685
2,24/12/2022,0211-Shenoy Nagar,27726,39367,200,824,14298,0,0,43048,0,0,0,0,4000,4000,1026,525,1551,966,543,1509,1020,7,114,0,0,3,34,477,635
2,24/12/2022,0213-Anna Nagar East,61940,106763,0,3160,40398,0,0,105498,0,0,0,0,3000,3000,2623,1486,4109,2516,1217,3733,2624,12,247,0,0,7,126,1316,1708
2,24/12/2022,0215-Anna Nagar Tower,64694,96397,300,3400,31662,0,0,100056,0,0,0,0,0,0,2349,1180,3529,2210,1215,3425,2458,15,410,0,0,4,114,1017,1560
2,24/12/2022,0217-Thirumangalam,172774,298357,1350,12136,122294,0,0,308554,0,0,0,0,0,0,6264,4303,10567,5987,3856,9843,6551,52,947,13,0,20,461,3728,5221
2,24/12/2022,0219-Koyambedu,129191,228619,750,6408,115676,0,0,252025,0,0,0,0,250,250,4224,3986,8210,3870,3151,7021,4263,61,772,8,0,25,280,3611,4757
2,24/12/2022,0221-Puratchi Thalaivi Dr. J. Jayalalithaa CMBT,64391,221324,600,5032,106612,0,0,176635,0,0,0,0,0,0,2644,3645,6289,4509,7026,11535,4344,21,935,9,0,9,232,3269,4475
2,24/12/2022,0223-Arumbakkam,45776,54658,0,1648,26332,0,0,73756,0,0,0,0,11000,11000,1245,1018,2263,1255,790,2045,1172,34,1,5,0,5,73,927,1045
2,24/12/2022,0225-Vadapalani,107158,285748,440,13272,134642,0,0,255512,0,0,0,0,3500,3500,5137,5017,10154,5065,4732,9797,5790,35,1168,8,0,17,527,4067,5822
2,24/12/2022,0227-Ashok Nagar,81625,143224,1250,5536,64428,0,0,152839,0,0,0,0,3000,3000,2963,2395,5358,2933,2059,4992,3156,21,368,7,0,12,209,2069,2686
2,24/12/2022,0229-Ekkattuthangal,50675,83470,400,3024,31422,0,0,85521,0,0,0,0,0,0,2044,1170,3214,1934,981,2915,2135,20,347,1,0,1,119,1005,1493
2,24/12/2022,0231-Arignar Anna Alandur,126029,211194,1245,7832,95934,0,0,231040,0,0,0,0,0,0,4190,3208,7398,3682,2814,6496,4295,58,922,9,0,16,302,2701,4008
2,24/12/2022,0233-St. Thomas Mount,69799,121924,150,5192,59404,0,0,134545,0,0,0,3000,2600,5600,2269,2007,4276,2216,1718,3934,2328,20,292,0,0,10,204,1764,2290
1,25/12/2022,01ED-Wimco Nagar Depot Metro,48618,75984,0,1664,43702,0,0,93984,0,0,0,0,0,0,1053,1065,2118,1049,586,1635,986,22,0,3,0,17,44,1023,1109
1,25/12/2022,01EF-Wimco Nagar Metro,56411,82175,0,4048,35314,0,0,95773,0,0,0,0,2000,2000,1288,938,2226,1285,1136,2421,1374,30,115,0,0,36,104,809,1094
1,25/12/2022,01F1-Thiruvotriyur Metro,63030,79253,0,3064,38510,0,0,104604,0,0,0,0,0,0,1327,1077,2404,1313,941,2254,1306,30,0,0,0,10,88,976,1104
1,25/12/2022,01F3-Thiruvotriyur Theradi Metro,55907,107138,1100,4416,55294,0,0,116717,0,0,0,0,0,0,1487,1554,3041,1674,1456,3130,1691,26,69,1,0,9,101,1414,1620
1,25/12/2022,01F5-Kaladipet Metro,49595,70590,300,2184,33564,0,0,85643,0,0,0,0,0,0,1245,998,2243,1321,1052,2373,1288,11,0,3,0,14,69,923,1020
1,25/12/2022,01F7-Tollgate Metro,29292,50727,200,1176,26566,0,0,57234,0,0,0,0,0,0,832,779,1611,880,624,1504,840,23,0,0,0,27,37,728,815
1,25/12/2022,01F9-New Washermenpet Metro,52028,67424,0,2432,28874,0,0,83334,0,0,0,0,1000,1000,1296,933,2229,1246,961,2207,1395,16,141,0,0,10,59,856,1082
1,25/12/2022,01FB-Tondiarpet Metro,45725,80605,0,2704,41040,0,0,89469,0,0,0,0,0,0,1315,1246,2561,1437,1206,2643,1400,18,6,2,0,34,75,1169,1304
1,25/12/2022,01FD-Thiagaraya College Metro,54427,88652,510,2096,45186,0,0,102219,0,0,0,0,500,500,1590,1433,3023,1672,1315,2987,1659,19,46,1,0,11,64,1342,1483
1,25/12/2022,0101-Washermanpet,43015,84350,240,1560,47372,0,0,92187,0,0,0,0,12500,12500,1331,1494,2825,1335,1612,2947,1375,8,174,0,0,24,52,1424,1682
1,25/12/2022,0103-Mannadi,28060,72327,0,1392,42580,0,0,72032,0,0,0,0,0,0,1076,1393,2469,1107,1446,2553,1149,9,126,0,0,9,57,1328,1529
1,25/12/2022,0105-High Court,27485,74880,150,1352,41686,0,0,70673,0,0,0,0,0,0,1242,1460,2702,1261,1375,2636,1326,9,178,0,0,4,52,1362,1605
1,25/12/2022,0109-Government Estate,50853,87892,300,2432,43210,0,0,96795,0,0,0,0,5250,5250,1556,1559,3115,1563,1589,3152,1739,21,313,3,0,16,92,1427,1872
1,25/12/2022,0111-LIC,22332,70995,0,1912,38510,0,0,62754,0,0,0,0,0,0,1021,1294,2315,1366,1114,2480,1238,3,0,0,0,25,72,1194,1294
1,25/12/2022,0113-Thousand Lights,27797,78523,1700,2912,39816,0,0,72225,0,0,0,0,0,0,1202,1320,2522,1597,1370,2967,1466,5,0,0,0,23,114,1219,1361
1,25/12/2022,0115-AG-DMS,18456,39964,150,1136,17370,0,0,37112,0,0,0,0,0,0,718,579,1297,673,566,1239,825,8,184,0,0,1,53,520,766
1,25/12/2022,0117-Teynampet,17789,44586,200,848,22718,0,0,41555,0,0,0,0,0,0,759,791,1550,940,870,1810,860,6,14,1,0,10,32,741,804
1,25/12/2022,0119-Nandanam,26206,45534,400,1376,20112,0,0,48094,0,0,0,0,1000,1000,921,742,1663,781,772,1553,953,17,233,4,0,6,53,679,992
1,25/12/2022,0121-Saidapet,19015,45658,100,1728,26758,0,0,47601,0,0,0,0,4000,4000,554,901,1455,733,874,1607,693,15,0,7,0,4,72,816,914
1,25/12/2022,0123-Little Mount,34464,69858,100,2624,36432,0,0,73620,0,0,0,0,0,0,1255,1286,2541,1038,956,1994,1254,16,308,2,0,15,99,1159,1599
1,25/12/2022,0125-Guindy,62308,174141,300,6624,101656,0,0,170888,0,0,0,0,0,0,2391,3290,5681,2167,2845,5012,2547,27,617,5,0,13,239,3020,3921
1,25/12/2022,0129-Nanganallur Road,9964,25854,100,920,15354,0,0,26338,0,0,0,0,0,0,280,478,758,410,475,885,366,6,0,0,0,2,32,447,487
1,25/12/2022,0131-Meenambakkam,47120,88431,200,3168,46888,0,0,97376,0,0,0,0,0,0,1370,1346,2716,1071,1177,2248,1302,13,389,7,0,14,96,1232,1751
1,25/12/2022,0133-Chennai International Airport,115283,326483,500,11400,196984,0,0,324167,0,0,0,0,0,0,3617,5383,9000,3455,5314,8769,3973,56,1164,12,0,39,321,4918,6510
2,25/12/2022,0201-Puratchi Thalaivar Dr. M.G. Ramachandran Central,123042,408943,1024,14096,260284,0,0,398446,0,0,0,0,0,0,4943,9036,13979,5027,8358,13385,5489,79,1437,9,0,51,524,8099,10199
2,25/12/2022,0203-Egmore,46664,121308,250,3608,73688,0,0,124210,0,0,0,0,7000,7000,1582,2579,4161,1661,3047,4708,1889,11,593,20,0,19,141,2407,3191
2,25/12/2022,0205-Nehru Park,21940,38948,500,1280,20564,0,0,44284,0,0,0,0,4000,4000,680,756,1436,616,667,1283,702,21,146,0,0,9,44,690,910
2,25/12/2022,0207-Kilpauk,14763,30876,0,1080,14792,0,0,30635,0,0,0,0,0,0,531,519,1050,525,584,1109,599,6,112,0,0,5,40,473,636
2,25/12/2022,0209-Pachaiyappas College,19872,29937,0,816,14528,0,0,35216,0,0,0,0,2500,2500,626,543,1169,528,444,972,583,10,98,4,0,9,31,495,647
2,25/12/2022,0211-Shenoy Nagar,16014,28825,100,488,13454,0,0,30056,0,0,0,0,0,0,595,455,1050,557,463,1020,600,6,83,0,0,12,17,426,544
2,25/12/2022,0213-Anna Nagar East,34006,62159,0,3056,28852,0,0,65914,0,0,0,0,3000,3000,1163,1083,2246,1074,954,2028,1273,16,228,0,0,7,120,951,1322
2,25/12/2022,0215-Anna Nagar Tower,39755,65361,150,2240,28294,0,0,70439,0,0,0,0,0,0,1372,1052,2424,1212,1044,2256,1416,13,365,4,0,11,87,913,1393
2,25/12/2022,0217-Thirumangalam,106230,225350,300,9352,113076,0,0,228958,0,0,0,0,0,0,3754,3837,7591,3293,3730,7023,3984,30,1025,9,0,19,360,3376,4819
2,25/12/2022,0219-Koyambedu,72587,176687,100,5600,106608,0,0,184895,0,0,0,0,1000,1000,2591,3576,6167,2284,2754,5038,2604,24,666,0,0,31,213,3213,4147
2,25/12/2022,0221-Puratchi Thalaivi Dr. J. Jayalalithaa CMBT,58715,184656,310,4584,110072,0,0,173681,0,0,0,0,0,0,2130,3665,5795,2543,5061,7604,2710,23,839,3,0,11,196,3377,4449
2,25/12/2022,0223-Arumbakkam,26045,46537,0,976,29858,0,0,56879,0,0,0,0,5000,5000,694,1111,1805,824,883,1707,714,29,4,0,0,13,49,1056,1151
2,25/12/2022,0225-Vadapalani,99459,254207,350,13592,125632,0,0,239033,0,0,0,0,1500,1500,4144,4795,8939,3880,4684,8564,4780,29,1375,4,0,51,539,3853,5851
2,25/12/2022,0227-Ashok Nagar,47420,102245,450,3992,60240,0,0,112102,0,0,0,0,3000,3000,1495,2160,3655,1505,2016,3521,1659,22,336,3,0,12,166,1923,2462
2,25/12/2022,0229-Ekkattuthangal,33974,56584,400,2328,25310,0,0,62012,0,0,0,0,0,0,1115,982,2097,1111,1019,2130,1272,11,322,2,0,8,107,812,1262
2,25/12/2022,0231-Arignar Anna Alandur,92375,164094,700,5880,84998,0,0,183953,0,0,0,0,500,500,2622,2770,5392,2270,2640,4910,2813,31,861,10,0,26,194,2450,3572
2,25/12/2022,0233-St. Thomas Mount,48247,93075,50,5008,53154,0,0,106459,0,0,0,0,7600,7600,1281,1813,3094,1485,1645,3130,1452,23,225,2,0,21,175,1597,2043
1,26/12/2022,01ED-Wimco Nagar Depot Metro,87732,93727,0,2232,36846,0,0,126810,0,0,0,0,3250,3250,2075,921,2996,1761,550,2311,1738,12,17,2,0,11,58,876,976
1,26/12/2022,01EF-Wimco Nagar Metro,134877,132888,100,3832,38996,0,0,177805,27870,0,27870,0,4000,4000,3005,1074,4079,2809,1075,3884,2906,45,114,0,0,15,116,926,1216
1,26/12/2022,01F1-Thiruvotriyur Metro,119025,113007,0,1816,33936,0,0,154777,0,0,0,0,0,0,2643,907,3550,2599,779,3378,2582,26,30,2,0,14,59,858,989
1,26/12/2022,01F3-Thiruvotriyur Theradi Metro,103976,126607,100,3856,40798,0,0,148730,0,0,0,0,0,0,2633,1183,3816,2884,1139,4023,2918,13,69,8,0,4,88,1049,1231
1,26/12/2022,01F5-Kaladipet Metro,113941,102437,0,1928,31214,0,0,147083,0,0,0,0,0,0,2709,930,3639,2602,866,3468,2584,15,24,1,0,6,63,870,979
1,26/12/2022,01F7-Tollgate Metro,68433,57131,0,1032,17062,0,0,86527,0,0,0,0,0,0,1512,526,2038,1495,485,1980,1452,19,18,3,0,16,23,496,575
1,26/12/2022,01F9-New Washermenpet Metro,101534,94402,200,1032,26826,0,0,129592,0,0,0,0,250,250,2567,859,3426,2516,819,3335,2565,24,95,1,0,8,39,817,984
1,26/12/2022,01FB-Tondiarpet Metro,95805,100481,1430,1576,30054,0,0,128865,0,0,0,0,1000,1000,2728,952,3680,2727,1005,3732,2704,28,60,0,0,15,49,901,1053
1,26/12/2022,01FD-Thiagaraya College Metro,111506,121304,673,2072,38328,0,0,152579,0,0,0,0,1500,1500,3145,1288,4433,3250,1201,4451,3261,41,112,5,0,8,76,1197,1439
1,26/12/2022,0101-Washermanpet,105110,123972,3274,2056,44736,0,0,155176,0,0,0,0,9750,9750,3327,1516,4843,3064,1397,4461,3164,21,194,11,0,10,76,1423,1735
1,26/12/2022,0103-Mannadi,80240,111981,872,1328,35480,0,0,117920,0,0,0,0,0,0,2833,1199,4032,3116,1301,4417,3165,8,181,0,0,8,50,1141,1388
1,26/12/2022,0105-High Court,134135,215218,2000,3032,68660,0,0,207827,0,0,0,0,0,0,5751,2379,8130,5681,2036,7717,5913,28,348,0,0,11,123,2223,2733
1,26/12/2022,0109-Government Estate,126573,164151,200,3040,54152,0,0,183965,0,0,0,0,12000,12000,4149,1994,6143,4531,2009,6540,4765,27,404,1,0,14,125,1809,2380
1,26/12/2022,0111-LIC,92481,167765,1610,2232,37220,0,0,133543,0,0,0,0,0,0,4546,1318,5864,5233,1265,6498,5234,19,94,0,0,2,92,1177,1384
1,26/12/2022,0113-Thousand Lights,156926,240476,2760,4992,35934,0,0,200612,0,0,0,0,0,0,7178,1307,8485,7794,1782,9576,8125,32,395,0,0,6,204,1110,1747
1,26/12/2022,0115-AG-DMS,92118,126326,1100,1616,26502,0,0,121336,0,0,0,0,1000,1000,3681,916,4597,3736,873,4609,3919,18,245,4,0,2,65,821,1155
1,26/12/2022,0117-Teynampet,105044,147282,1700,1896,34668,0,0,143308,0,0,0,0,500,500,4300,1287,5587,4790,1259,6049,4706,19,23,1,0,4,84,1150,1281
1,26/12/2022,0119-Nandanam,93409,120222,880,1832,25088,0,0,121209,0,0,0,0,3250,3250,3506,931,4437,3894,1037,4931,4015,27,201,5,0,7,78,813,1131
1,26/12/2022,0121-Saidapet,44640,80317,0,1624,25990,0,0,72254,0,0,0,0,750,750,1770,914,2684,2225,866,3091,2202,7,23,13,0,0,55,841,939
1,26/12/2022,0123-Little Mount,89504,96318,280,2440,27712,0,0,119936,0,0,0,0,500,500,3052,1047,4099,2637,848,3485,2725,10,160,1,0,9,98,915,1193
1,26/12/2022,0125-Guindy,177654,266125,1250,8600,78084,0,0,265588,0,0,0,0,0,0,7689,2815,10504,6644,2958,9602,7332,32,884,3,0,9,312,2452,3692
1,26/12/2022,0129-Nanganallur Road,54978,47380,353,568,13816,0,0,69715,0,0,0,0,0,0,1188,440,1628,1322,406,1728,1261,10,16,2,0,1,20,405,454
1,26/12/2022,0131-Meenambakkam,143413,132500,300,3432,41268,0,0,188413,10,0,10,0,0,0,3489,1200,4689,2898,1128,4026,3075,18,319,1,0,12,93,1081,1524
1,26/12/2022,0133-Chennai International Airport,199321,381239,3150,10720,175642,0,0,388833,0,0,0,0,8250,8250,5999,4901,10900,6192,4644,10836,6569,51,1168,19,0,27,315,4402,5982
2,26/12/2022,0201-Puratchi Thalaivar Dr. M.G. Ramachandran Central,237321,519569,500,18392,255910,0,0,512123,0,0,0,0,14200,14200,11778,9269,21047,10555,8390,18945,11204,132,1420,11,0,43,734,8200,10540
2,26/12/2022,0203-Egmore,75510,143732,854,5200,75440,0,0,157004,0,0,0,0,9350,9350,2482,2880,5362,2562,2906,5468,2802,13,582,2,0,1,204,2580,3382
2,26/12/2022,0205-Nehru Park,72436,48477,50,1000,17906,0,0,91392,0,0,0,0,28000,28000,1319,668,1987,1230,617,1847,1295,26,117,3,0,4,39,593,782
2,26/12/2022,0207-Kilpauk,36484,55092,73,1112,17520,0,0,55189,0,0,0,0,0,0,1339,636,1975,1405,673,2078,1483,16,124,0,0,4,41,576,761
2,26/12/2022,0209-Pachaiyappas College,41062,43280,0,536,11728,0,0,53326,0,0,0,0,6500,6500,1317,451,1768,1270,505,1775,1320,9,101,1,0,1,22,420,554
2,26/12/2022,0211-Shenoy Nagar,42377,46906,0,976,13692,0,0,57045,0,0,0,0,0,0,1196,496,1692,1308,585,1893,1348,8,90,2,0,7,42,444,593
2,26/12/2022,0213-Anna Nagar East,83578,117634,500,2472,31350,0,0,117900,0,0,0,0,0,0,3243,1169,4412,3251,1127,4378,3415,24,300,0,0,3,105,1047,1479
2,26/12/2022,0215-Anna Nagar Tower,87358,94689,100,3456,23986,0,0,114900,0,0,0,0,1000,1000,2539,924,3463,2479,975,3454,2723,12,314,0,0,4,106,777,1213
2,26/12/2022,0217-Thirumangalam,274836,322949,1600,8864,100614,0,0,385914,0,0,0,0,0,0,8002,3449,11451,7867,3401,11268,8288,70,777,12,0,14,314,3049,4236
2,26/12/2022,0219-Koyambedu,193447,233048,1150,6688,98838,0,0,300123,0,0,0,0,8000,8000,5376,3374,8750,4660,2472,7132,5026,52,549,9,0,34,248,3047,3939
2,26/12/2022,0221-Puratchi Thalaivi Dr. J. Jayalalithaa CMBT,86719,205849,700,4960,100800,0,0,193179,0,0,0,0,0,0,3124,3366,6490,3732,4625,8357,3992,26,853,0,0,4,211,3105,4199
2,26/12/2022,0223-Arumbakkam,61817,65850,0,1768,24810,0,0,88395,0,0,0,0,7500,7500,1629,937,2566,1749,779,2528,1664,30,30,0,0,12,71,843,986
2,26/12/2022,0225-Vadapalani,134414,241688,510,7192,94772,0,0,236888,0,0,0,0,5500,5500,4932,3401,8333,4955,3602,8557,5505,38,967,6,0,29,280,2992,4312
2,26/12/2022,0227-Ashok Nagar,97832,149775,150,4480,57254,0,0,159716,0,0,0,0,3000,3000,3388,2013,5401,3511,1771,5282,3655,33,264,0,0,6,166,1782,2251
2,26/12/2022,0229-Ekkattuthangal,85403,120108,1250,2768,28934,0,0,118355,0,0,0,0,250,250,3220,1097,4317,3548,1134,4682,3682,20,270,0,0,1,105,916,1312
2,26/12/2022,0231-Arignar Anna Alandur,160164,209320,1302,6296,71656,0,0,239418,0,0,0,0,3250,3250,5478,2487,7965,4895,2216,7111,5249,62,585,6,0,18,222,2166,3059
2,26/12/2022,0233-St. Thomas Mount,98138,118001,200,5112,39746,0,0,143196,0,0,0,6400,5450,11850,2867,1349,4216,2839,1242,4081,2986,27,325,0,0,4,154,1186,1696
1,27/12/2022,01ED-Wimco Nagar Depot Metro,79259,85987,0,1872,30776,0,0,111907,0,0,0,0,4500,4500,2115,801,2916,1747,613,2360,1729,15,0,2,0,5,51,751,824
1,27/12/2022,01EF-Wimco Nagar Metro,108546,126190,300,2928,33648,0,0,145422,0,0,0,0,0,0,3095,927,4022,2810,1014,3824,2869,39,60,7,0,17,89,814,1026
1,27/12/2022,01F1-Thiruvotriyur Metro,108056,103829,100,2176,25286,0,0,135618,0,0,0,0,0,0,2771,721,3492,2590,620,3210,2582,28,0,1,0,9,66,659,763
1,27/12/2022,01F3-Thiruvotriyur Theradi Metro,95423,129326,300,2232,38580,0,0,136535,0,0,0,0,0,0,2849,1098,3947,3092,1064,4156,3074,23,17,4,0,9,63,1011,1127
1,27/12/2022,01F5-Kaladipet Metro,96910,96533,200,1048,25792,0,0,123950,0,0,0,0,0,0,2678,777,3455,2599,713,3312,2571,21,0,3,0,5,35,727,791
1,27/12/2022,01F7-Tollgate Metro,64740,57718,0,672,16846,0,0,82258,0,0,0,0,0,0,1539,527,2066,1481,463,1944,1463,26,0,0,0,8,24,493,551
1,27/12/2022,01F9-New Washermenpet Metro,93380,91964,150,1432,21282,0,0,116244,0,0,0,0,2000,2000,2631,687,3318,2517,763,3280,2700,10,172,3,0,4,51,634,874
1,27/12/2022,01FB-Tondiarpet Metro,79175,101410,0,1808,30454,0,0,111437,0,0,0,0,750,750,2793,986,3779,2750,973,3723,2734,18,0,10,0,15,61,915,1019
1,27/12/2022,01FD-Thiagaraya College Metro,99354,117903,50,1448,34704,0,0,135556,0,0,0,0,2750,2750,3269,1144,4413,3315,1012,4327,3345,31,64,0,0,7,53,1078,1233
1,27/12/2022,0101-Washermanpet,103722,125465,1000,1824,45584,0,0,152130,0,0,0,0,14250,14250,3388,1537,4925,3072,1404,4476,3189,27,181,4,0,9,76,1446,1743
1,27/12/2022,0103-Mannadi,73093,115141,112,1984,36420,0,0,111609,0,0,0,0,0,0,2905,1266,4171,3197,1254,4451,3283,16,145,5,0,9,82,1156,1413
1,27/12/2022,0105-High Court,112775,233935,1020,3312,80134,0,0,197241,0,0,0,0,0,0,6049,2773,8822,6122,2366,8488,6263,17,277,4,0,9,127,2589,3023
1,27/12/2022,0109-Government Estate,98692,163673,0,2336,58496,0,0,159524,0,0,0,0,1000,1000,4065,2126,6191,4488,2045,6533,4646,30,291,2,0,9,107,1940,2379
1,27/12/2022,0111-LIC,90545,177394,300,2928,40832,0,0,134605,0,0,0,0,0,0,4837,1446,6283,5529,1244,6773,5487,25,5,0,0,7,109,1299,1445
1,27/12/2022,0113-Thousand Lights,140348,238968,2760,5344,42596,0,0,191048,0,0,0,0,2000,2000,7174,1637,8811,7899,1623,9522,7903,34,24,7,0,6,205,1328,1604
1,27/12/2022,0115-AG-DMS,98766,129590,900,2208,23756,0,0,125630,0,0,0,0,0,0,3892,840,4732,4014,798,4812,4175,10,193,5,0,1,76,731,1016
1,27/12/2022,0117-Teynampet,101455,149767,1550,1792,30624,0,0,135421,0,0,0,0,250,250,4528,1138,5666,5040,1128,6168,4985,27,1,3,0,3,81,1008,1123
1,27/12/2022,0119-Nandanam,100643,123702,700,2152,24530,0,0,128025,0,0,0,0,0,0,3838,929,4767,4103,999,5102,4242,37,168,6,0,7,92,796,1106
1,27/12/2022,0121-Saidapet,49479,81180,200,1664,25396,0,0,76739,0,0,0,0,4250,4250,1907,891,2798,2303,873,3176,2275,17,0,0,0,5,61,808,891
1,27/12/2022,0123-Little Mount,90567,101654,450,2064,27016,0,0,120097,0,0,0,0,0,0,3329,1007,4336,2838,830,3668,2993,26,228,11,0,7,90,853,1215
1,27/12/2022,0125-Guindy,129314,263198,1051,7184,82546,0,0,220095,0,0,0,0,500,500,7519,2919,10438,6835,2712,9547,7221,43,489,18,0,7,248,2602,3407
1,27/12/2022,0129-Nanganallur Road,43970,45934,500,1208,10994,0,0,56672,0,0,0,0,0,0,1193,369,1562,1339,387,1726,1319,6,3,2,0,4,34,322,371
1,27/12/2022,0131-Meenambakkam,121940,134595,724,2912,42932,0,0,168508,0,0,0,0,0,0,3561,1266,4827,2908,1129,4037,3114,19,266,3,0,7,87,1149,1531
1,27/12/2022,0133-Chennai International Airport,173253,373227,1040,9432,170608,0,0,354333,0,0,0,0,6000,6000,6067,4755,10822,6018,4692,10710,6557,56,1066,15,0,20,278,4315,5750
2,27/12/2022,0201-Puratchi Thalaivar Dr. M.G. Ramachandran Central,215952,498360,750,15280,237614,0,0,469596,0,0,0,0,6400,6400,11421,8548,19969,10492,8259,18751,11181,87,1323,16,0,33,578,7627,9664
2,27/12/2022,0203-Egmore,77858,137244,500,2816,70880,0,0,152054,0,0,0,0,12500,12500,2421,2552,4973,2575,2900,5475,2719,21,425,4,0,10,120,2373,2953
2,27/12/2022,0205-Nehru Park,29994,47672,0,1456,17806,0,0,49256,0,0,0,0,0,0,1287,683,1970,1194,585,1779,1262,21,79,0,0,2,55,614,771
2,27/12/2022,0207-Kilpauk,34637,55607,300,992,16552,0,0,52481,0,0,0,0,0,0,1431,603,2034,1497,648,2145,1566,18,109,0,0,4,37,539,707
2,27/12/2022,0209-Pachaiyappas College,47895,46455,0,776,12806,0,0,61477,0,0,0,0,10000,10000,1387,475,1862,1368,484,1852,1422,16,88,1,0,3,33,432,573
2,27/12/2022,0211-Shenoy Nagar,39064,45191,100,1176,12616,0,0,52956,0,0,0,0,0,0,1268,476,1744,1261,483,1744,1319,10,80,0,0,5,43,425,563
2,27/12/2022,0213-Anna Nagar East,72600,118603,450,2776,32870,0,0,108696,0,0,0,0,1500,1500,3178,1224,4402,3287,1181,4468,3409,13,214,0,0,4,106,1077,1414
2,27/12/2022,0215-Anna Nagar Tower,75724,94386,0,2160,26122,0,0,104006,0,0,0,0,250,250,2535,972,3507,2528,1031,3559,2640,14,208,0,0,2,86,845,1155
2,27/12/2022,0217-Thirumangalam,249422,323537,1600,8592,98232,0,0,357846,0,0,0,0,0,0,8235,3346,11581,8134,3251,11385,8475,70,610,18,0,13,283,2984,3978
2,27/12/2022,0219-Koyambedu,182216,249161,50,5768,99256,0,0,287290,0,0,0,0,5000,5000,5864,3406,9270,5125,2661,7786,5518,48,580,18,0,25,231,3092,3994
2,27/12/2022,0221-Puratchi Thalaivi Dr. J. Jayalalithaa CMBT,74365,195817,10,4712,93182,0,0,172269,0,0,0,0,0,0,2971,3136,6107,3576,4428,8004,3925,15,758,5,0,9,185,2849,3821
2,27/12/2022,0223-Arumbakkam,57389,66855,0,1312,26414,0,0,85115,0,0,0,0,2500,2500,1702,973,2675,1752,851,2603,1666,30,5,4,0,15,53,905,1012
2,27/12/2022,0225-Vadapalani,128265,255928,1380,7552,105262,0,0,242459,0,0,0,0,1000,1000,5204,3683,8887,5178,3765,8943,5716,39,895,4,0,29,238,3248,4453
2,27/12/2022,0227-Ashok Nagar,93544,144181,30,4384,51738,0,0,149696,0,0,0,0,4500,4500,3454,1813,5267,3484,1791,5275,3610,33,260,2,0,13,138,1617,2063
2,27/12/2022,0229-Ekkattuthangal,88297,130065,818,3000,32104,0,0,124219,0,0,0,0,1000,1000,3531,1196,4727,3921,1136,5057,4000,16,148,2,0,4,123,1023,1316
2,27/12/2022,0231-Arignar Anna Alandur,149531,216552,1112,6168,73140,0,0,229951,0,0,0,0,2500,2500,5448,2476,7924,5071,2204,7275,5501,40,558,11,0,14,212,2147,2982
2,27/12/2022,0233-St. Thomas Mount,92907,118651,300,3568,44404,0,0,141179,0,0,0,3125,3700,6825,2888,1489,4377,2843,1202,4045,2907,20,135,2,0,6,112,1299,1574
1,28/12/2022,01ED-Wimco Nagar Depot Metro,86635,91898,0,1832,32372,0,0,120839,0,0,0,0,3250,3250,2268,835,3103,1820,600,2420,1826,15,0,1,0,17,57,773,863
1,28/12/2022,01EF-Wimco Nagar Metro,111055,135754,0,2832,38080,0,0,151967,0,0,0,0,250,250,3099,1026,4125,2936,1034,3970,2990,30,72,3,0,21,85,903,1114
1,28/12/2022,01F1-Thiruvotriyur Metro,113698,106350,0,2016,28302,0,0,144016,0,0,0,0,0,0,2714,781,3495,2552,731,3283,2545,22,0,2,0,8,67,718,817
1,28/12/2022,01F3-Thiruvotriyur Theradi Metro,95287,133219,500,2512,40506,0,0,138805,0,0,0,0,0,0,2947,1133,4080,3095,1247,4342,3144,19,63,2,0,10,73,1034,1201
1,28/12/2022,01F5-Kaladipet Metro,100543,105197,928,2024,32202,0,0,135697,0,0,0,0,0,0,2721,941,3662,2654,811,3465,2619,17,0,1,0,7,53,878,956
1,28/12/2022,01F7-Tollgate Metro,54714,57534,200,1160,15092,0,0,71166,0,0,0,0,0,0,1533,483,2016,1511,477,1988,1508,16,1,0,0,12,29,446,504
1,28/12/2022,01F9-New Washermenpet Metro,76697,94411,300,2720,26058,0,0,105775,0,0,0,0,0,0,2622,816,3438,2584,802,3386,2602,13,50,3,0,7,40,781,894
1,28/12/2022,01FB-Tondiarpet Metro,82200,105161,250,1232,32904,0,0,116586,0,0,0,0,1500,1500,2765,1024,3789,2795,1108,3903,2771,21,4,0,0,13,47,954,1039
1,28/12/2022,01FD-Thiagaraya College Metro,95073,115018,100,1704,34124,0,0,131001,0,0,0,0,250,250,3178,1129,4307,3275,1039,4314,3286,22,39,1,0,6,62,1053,1183
1,28/12/2022,0101-Washermanpet,88439,126248,2240,2552,45168,0,0,138399,0,0,0,0,10500,10500,3393,1514,4907,3148,1430,4578,3241,21,135,0,0,16,76,1427,1675
1,28/12/2022,0103-Mannadi,77759,110451,425,1472,34464,0,0,114120,0,0,0,0,1500,1500,2874,1189,4063,3063,1351,4414,3124,29,122,0,0,7,57,1117,1332
1,28/12/2022,0105-High Court,115956,221663,700,2904,76144,0,0,195704,0,0,0,0,0,0,5736,2629,8365,5812,2186,7998,5941,25,221,8,0,14,117,2477,2862
1,28/12/2022,0109-Government Estate,82643,166840,350,2736,60064,0,0,145793,0,0,0,0,250,250,4106,2122,6228,4449,2000,6449,4654,21,290,11,0,14,107,1964,2407
1,28/12/2022,0111-LIC,72684,174558,710,2496,41566,0,0,117456,0,0,0,0,2000,2000,4609,1463,6072,5366,1271,6637,5348,23,0,1,0,3,99,1326,1452
1,28/12/2022,0113-Thousand Lights,143154,248396,2419,5632,51242,0,0,202447,0,0,0,0,0,0,7136,1912,9048,7919,1668,9587,7917,22,6,1,0,5,226,1609,1869
1,28/12/2022,0115-AG-DMS,87633,133100,700,3048,29352,0,0,120733,0,0,0,0,2250,2250,3929,991,4920,3946,871,4817,4113,10,205,1,0,3,68,891,1178
1,28/12/2022,0117-Teynampet,82796,150658,1110,1992,34140,0,0,120038,0,0,0,0,0,0,4566,1290,5856,4973,1187,6160,4900,30,1,0,0,1,90,1176,1298
1,28/12/2022,0119-Nandanam,104686,133928,860,2032,26790,0,0,134368,0,0,0,0,0,0,4121,1019,5140,4382,997,5379,4492,37,149,0,0,12,90,891,1179
1,28/12/2022,0121-Saidapet,46977,84598,630,1520,26810,0,0,75937,0,0,0,0,2250,2250,1905,937,2842,2357,916,3273,2346,9,0,5,0,1,62,853,930
1,28/12/2022,0123-Little Mount,83586,103331,0,2288,30214,0,0,116088,0,0,0,0,1000,1000,3351,1132,4483,2796,914,3710,2932,16,183,6,0,4,93,969,1271
1,28/12/2022,0125-Guindy,126466,273750,700,7464,89454,0,0,224084,0,0,0,0,0,0,7670,3111,10781,6847,2993,9840,7344,42,490,9,0,17,272,2711,3541
1,28/12/2022,0129-Nanganallur Road,48878,49323,100,616,14304,0,0,63898,0,0,0,0,0,0,1239,438,1677,1342,456,1798,1305,9,0,1,0,6,23,407,446
1,28/12/2022,0131-Meenambakkam,115787,137758,800,2592,47376,0,0,166555,0,0,0,0,0,0,3511,1379,4890,2907,1208,4115,3035,19,241,10,0,6,87,1271,1634
1,28/12/2022,0133-Chennai International Airport,199309,383508,1000,9504,175314,0,0,385127,0,0,0,0,7500,7500,6168,4858,11026,5946,4954,10900,6678,56,1122,16,0,26,307,4456,5983
2,28/12/2022,0201-Puratchi Thalaivar Dr. M.G. Ramachandran Central,210473,506299,1792,14688,241968,0,0,468921,0,0,0,0,5450,5450,11176,8600,19776,10440,8743,19183,11260,110,1239,10,0,34,575,7816,9784
2,28/12/2022,0203-Egmore,77973,146438,30,3776,76324,0,0,158103,0,0,0,1250,10500,11750,2438,2669,5107,2576,3263,5839,2827,17,483,31,0,5,141,2454,3131
2,28/12/2022,0205-Nehru Park,30861,47242,0,1288,16852,0,0,49001,0,0,0,0,2000,2000,1281,642,1923,1178,519,1697,1282,24,109,0,0,2,55,562,752
2,28/12/2022,0207-Kilpauk,33622,59222,100,992,20712,0,0,55426,0,0,0,0,250,250,1396,738,2134,1488,763,2251,1545,22,85,0,0,4,42,675,828
2,28/12/2022,0209-Pachaiyappas College,64696,60660,0,912,22880,0,0,88488,0,0,0,0,22000,22000,1548,804,2352,1474,761,2235,1551,16,92,5,0,5,37,749,904
2,28/12/2022,0211-Shenoy Nagar,33593,46987,200,648,15290,0,0,49731,0,0,0,0,2000,2000,1230,536,1766,1239,522,1761,1283,11,90,0,0,5,28,487,621
2,28/12/2022,0213-Anna Nagar East,83827,116860,200,2032,34462,0,0,120521,0,0,0,0,0,0,3163,1253,4416,3136,1154,4290,3261,29,213,0,0,5,95,1110,1452
2,28/12/2022,0215-Anna Nagar Tower,60553,98974,250,2112,31182,0,0,94097,0,0,0,0,500,500,2514,1108,3622,2575,1049,3624,2647,9,182,1,0,4,84,984,1264
2,28/12/2022,0217-Thirumangalam,229553,322333,1856,8144,98018,0,0,337571,0,0,0,0,0,0,8198,3345,11543,7966,3268,11234,8381,48,607,20,0,13,296,2984,3968
2,28/12/2022,0219-Koyambedu,173800,244762,210,4688,101906,0,0,280604,0,0,0,0,8000,8000,5590,3397,8987,4958,2624,7582,5271,47,510,26,0,15,204,3144,3946
2,28/12/2022,0221-Puratchi Thalaivi Dr. J. Jayalalithaa CMBT,63783,199358,600,4048,106572,0,0,175003,0,0,0,0,0,0,2627,3551,6178,3598,4925,8523,3600,27,469,23,0,9,178,3307,4013
2,28/12/2022,0223-Arumbakkam,61596,68352,0,1480,29624,0,0,92700,0,0,0,0,4250,4250,1647,1061,2708,1667,859,2526,1608,23,0,1,0,6,55,995,1080
2,28/12/2022,0225-Vadapalani,109740,251140,1750,7928,113940,0,0,233358,0,0,0,0,4500,4500,4685,4029,8714,4975,3771,8746,5303,34,599,1,0,29,290,3591,4544
2,28/12/2022,0227-Ashok Nagar,92184,152947,610,3720,60402,0,0,156916,0,0,0,0,0,0,3523,2088,5611,3448,1923,5371,3628,35,285,8,0,9,137,1870,2344
2,28/12/2022,0229-Ekkattuthangal,74907,131797,1265,3304,35788,0,0,115264,0,0,0,0,0,0,3551,1321,4872,3734,1169,4903,3868,10,170,2,0,4,140,1119,1445
2,28/12/2022,0231-Arignar Anna Alandur,149105,220027,1050,5704,78194,0,0,234053,0,0,0,0,3500,3500,5435,2607,8042,5111,2317,7428,5478,38,490,11,0,17,217,2295,3068
2,28/12/2022,0233-St. Thomas Mount,79038,117681,0,4152,41216,0,0,124406,0,0,0,15000,5400,20400,2885,1414,4299,2704,1362,4066,2951,25,246,3,0,6,139,1223,1642
1,29/12/2022,01ED-Wimco Nagar Depot Metro,77327,88072,0,1840,33224,0,0,112391,0,0,0,0,2000,2000,2140,830,2970,1713,548,2261,1702,12,1,6,0,8,50,777,854
1,29/12/2022,01EF-Wimco Nagar Metro,110962,133281,200,2704,36392,0,0,150258,0,0,0,0,500,500,3090,982,4072,2921,1132,4053,2970,26,84,1,0,18,88,886,1103
1,29/12/2022,01F1-Thiruvotriyur Metro,97861,101828,0,2008,27324,0,0,127193,0,0,0,0,0,0,2604,764,3368,2456,734,3190,2471,21,0,1,0,3,69,686,780
1,29/12/2022,01F3-Thiruvotriyur Theradi Metro,92756,133459,1500,2056,42712,0,0,139024,0,0,0,0,0,0,2856,1184,4040,3038,1245,4283,3075,10,56,2,0,9,76,1094,1247
1,29/12/2022,01F5-Kaladipet Metro,91436,97766,1550,1520,27804,0,0,122310,0,0,0,0,0,0,2650,839,3489,2541,829,3370,2542,17,0,2,0,3,54,787,863
1,29/12/2022,01F7-Tollgate Metro,53882,58019,100,1168,16574,0,0,71724,0,0,0,0,0,0,1530,529,2059,1486,554,2040,1501,16,9,0,0,10,36,486,557
1,29/12/2022,01F9-New Washermenpet Metro,85336,95684,500,976,29044,0,0,115856,0,0,0,0,1750,1750,2609,897,3506,2516,866,3382,2554,12,90,0,0,1,35,859,997
1,29/12/2022,01FB-Tondiarpet Metro,80974,99641,150,1464,31388,0,0,113976,0,0,0,0,500,500,2642,1012,3654,2640,1024,3664,2631,14,8,0,0,13,50,946,1031
1,29/12/2022,01FD-Thiagaraya College Metro,94283,117618,883,2344,38174,0,0,135684,0,0,0,0,1500,1500,3096,1247,4343,3184,1076,4260,3211,27,23,0,0,8,80,1147,1285
1,29/12/2022,0101-Washermanpet,94584,127656,250,1848,50146,0,0,146828,0,0,0,0,16500,16500,3425,1685,5110,3074,1510,4584,3148,16,154,3,0,6,70,1579,1828
1,29/12/2022,0103-Mannadi,65307,111151,570,1976,37906,0,0,105759,0,0,0,0,1500,1500,2715,1308,4023,2983,1449,4432,3074,17,117,8,0,5,71,1215,1433
1,29/12/2022,0105-High Court,113841,223285,1400,3016,77728,0,0,195985,0,0,0,0,0,0,5614,2672,8286,5726,2096,7822,5894,19,269,8,0,9,117,2483,2905
1,29/12/2022,0109-Government Estate,91343,161809,900,2744,58628,0,0,153615,0,0,0,0,500,500,4084,2124,6208,4300,2046,6346,4541,19,322,3,0,10,124,1926,2404
1,29/12/2022,0111-LIC,85148,161881,850,2072,39566,0,0,127636,0,0,0,0,0,0,4362,1373,5735,5006,1268,6274,4924,24,5,1,0,6,69,1269,1374
1,29/12/2022,0113-Thousand Lights,126897,243929,3350,5016,47626,0,0,182889,0,0,0,0,250,250,7067,1791,8858,7928,1685,9613,7881,19,1,0,0,2,202,1487,1711
1,29/12/2022,0115-AG-DMS,88488,123707,0,1952,26386,0,0,116826,0,0,0,0,3000,3000,3632,924,4556,3660,818,4478,3863,19,237,0,0,4,78,808,1146
1,29/12/2022,0117-Teynampet,91218,148097,350,2016,32810,0,0,126394,0,0,0,0,0,0,4491,1223,5714,4866,1146,6012,4815,22,0,0,0,10,88,1104,1224
1,29/12/2022,0119-Nandanam,99403,125721,2050,2400,26796,0,0,130649,0,0,0,0,2500,2500,3770,1007,4777,4035,1104,5139,4193,26,184,0,0,11,95,874,1190
1,29/12/2022,0121-Saidapet,50651,85832,100,1584,27696,0,0,80031,0,0,0,0,6000,6000,1979,956,2935,2398,991,3389,2359,16,0,2,1,7,59,883,968
1,29/12/2022,0123-Little Mount,85481,101379,600,2264,29636,0,0,117981,0,0,0,0,0,0,3276,1081,4357,2699,892,3591,2912,13,211,2,0,5,98,933,1262
1,29/12/2022,0125-Guindy,123607,273424,1310,8368,95922,0,0,229207,0,0,0,0,0,0,7313,3286,10599,6624,2773,9397,7032,41,450,20,0,5,280,2901,3697
1,29/12/2022,0129-Nanganallur Road,43124,44751,800,1392,12556,0,0,57872,0,0,0,0,0,0,1143,416,1559,1278,401,1679,1228,10,0,4,0,3,27,381,425
1,29/12/2022,0131-Meenambakkam,114960,134840,500,2632,49340,0,0,167432,0,0,0,0,0,0,3313,1397,4710,2760,1189,3949,2884,10,181,1,0,6,80,1314,1592
1,29/12/2022,0133-Chennai International Airport,179285,384354,3600,9120,181890,0,0,373895,0,0,0,0,3750,3750,6068,5030,11098,5834,4765,10599,6463,63,1034,8,0,25,270,4574,5974
2,29/12/2022,0201-Puratchi Thalaivar Dr. M.G. Ramachandran Central,211925,504456,1100,12416,249060,0,0,474501,0,0,0,0,8950,8950,10786,8735,19521,10401,8425,18826,10888,86,1197,18,0,30,465,7974,9770
2,29/12/2022,0203-Egmore,87011,145352,128,3008,76378,0,0,166525,0,0,0,0,21850,21850,2362,2771,5133,2756,3182,5938,2843,23,426,24,0,11,118,2598,3200
2,29/12/2022,0205-Nehru Park,39237,46515,0,1512,16320,0,0,57069,0,0,0,0,2000,2000,1290,647,1937,1181,567,1748,1285,26,94,2,0,7,54,572,755
2,29/12/2022,0207-Kilpauk,34988,57173,0,864,20192,0,0,56044,0,0,0,0,0,0,1348,722,2070,1415,713,2128,1471,11,94,0,0,5,38,676,824
2,29/12/2022,0209-Pachaiyappas College,38657,46440,0,768,14762,0,0,54187,0,0,0,0,10000,10000,1374,553,1927,1284,520,1804,1332,7,78,1,0,2,30,513,631
2,29/12/2022,0211-Shenoy Nagar,37207,45589,100,768,13000,0,0,51075,0,0,0,0,2000,2000,1242,446,1688,1258,466,1724,1319,5,93,1,0,3,29,409,540
2,29/12/2022,0213-Anna Nagar East,82642,116692,350,2616,34442,0,0,120050,0,0,0,0,6000,6000,3249,1288,4537,3162,1216,4378,3307,15,251,0,0,1,109,1135,1511
2,29/12/2022,0215-Anna Nagar Tower,74357,99605,705,2096,29344,0,0,106502,0,0,0,0,250,250,2591,1053,3644,2564,1044,3608,2738,15,269,2,0,4,90,943,1323
2,29/12/2022,0217-Thirumangalam,241170,323636,250,8536,100254,0,0,350210,0,0,0,0,0,0,8054,3472,11526,7866,3337,11203,8324,41,698,15,0,16,317,3055,4142
2,29/12/2022,0219-Koyambedu,171887,232878,640,4016,96336,0,0,272879,0,0,0,0,5500,5500,5414,3280,8694,4864,2620,7484,5112,54,438,8,0,19,171,3036,3726
2,29/12/2022,0221-Puratchi Thalaivi Dr. J. Jayalalithaa CMBT,66798,186680,250,3960,91350,0,0,162358,0,0,0,0,0,0,2740,3017,5757,3640,4853,8493,3691,35,601,11,0,3,141,2826,3617
2,29/12/2022,0223-Arumbakkam,46398,65634,0,1776,27196,0,0,75370,0,0,0,0,4750,4750,1585,1011,2596,1649,823,2472,1571,18,5,3,0,10,57,928,1021
2,29/12/2022,0225-Vadapalani,104283,231601,1450,7264,102460,0,0,215457,0,0,0,0,3000,3000,4462,3651,8113,4585,3634,8219,5002,26,610,2,0,15,278,3215,4146
2,29/12/2022,0227-Ashok Nagar,84309,143019,900,3728,51880,0,0,140817,0,0,0,0,0,0,3411,1838,5249,3358,1747,5105,3590,20,293,3,0,4,149,1626,2095
2,29/12/2022,0229-Ekkattuthangal,67620,128586,500,4128,33580,0,0,105828,0,0,0,0,0,0,3592,1281,4873,3651,1025,4676,3849,17,206,2,0,6,162,1050,1443
2,29/12/2022,0231-Arignar Anna Alandur,128370,209881,3226,5744,73836,0,0,211176,0,0,0,0,2750,2750,5236,2483,7719,4760,2358,7118,5225,49,582,12,0,4,204,2136,2987
2,29/12/2022,0233-St. Thomas Mount,72780,110961,220,4408,38914,0,0,116322,0,0,0,3000,4600,7600,2781,1349,4130,2649,1245,3894,2791,16,211,4,0,4,135,1171,1541
1,30/12/2022,01ED-Wimco Nagar Depot Metro,76699,83732,2000,2088,31784,0,0,112571,0,0,0,0,5750,5750,2065,831,2896,1614,534,2148,1615,12,0,2,0,2,51,761,828
1,30/12/2022,01EF-Wimco Nagar Metro,105938,131216,0,3832,37680,0,0,147450,0,0,0,0,5000,5000,3073,1023,4096,2837,969,3806,2910,30,70,1,0,21,116,886,1124
1,30/12/2022,01F1-Thiruvotriyur Metro,87476,103846,0,1256,29310,0,0,118042,0,0,0,0,0,0,2708,815,3523,2528,715,3243,2478,19,0,1,0,7,45,768,840
1,30/12/2022,01F3-Thiruvotriyur Theradi Metro,91464,133175,1000,3472,42070,0,0,138006,0,0,0,0,0,0,2856,1233,4089,3035,1288,4323,3113,19,73,3,0,7,108,1082,1292
1,30/12/2022,01F5-Kaladipet Metro,87762,94143,1280,2232,26376,0,0,117650,0,0,0,0,0,0,2582,818,3400,2472,775,3247,2451,12,0,1,0,8,49,767,837
1,30/12/2022,01F7-Tollgate Metro,59638,57933,50,816,17512,0,0,78016,0,0,0,0,0,0,1556,548,2104,1471,446,1917,1449,22,4,3,0,13,26,514,582
1,30/12/2022,01F9-New Washermenpet Metro,85153,91531,200,920,25904,0,0,112177,0,0,0,0,500,500,2512,822,3334,2494,726,3220,2495,9,59,0,0,6,31,779,884
1,30/12/2022,01FB-Tondiarpet Metro,83093,104756,200,2984,33918,0,0,120195,0,0,0,0,250,250,2755,1058,3813,2719,1004,3723,2698,19,2,2,0,21,49,997,1090
1,30/12/2022,01FD-Thiagaraya College Metro,95220,114123,0,1672,36744,0,0,133636,0,0,0,0,1000,1000,3115,1226,4341,3146,1111,4257,3121,23,20,2,0,6,64,1149,1264
1,30/12/2022,0101-Washermanpet,99437,128248,366,2056,47762,0,0,149621,0,0,0,0,14250,14250,3427,1599,5026,3104,1453,4557,3211,21,173,3,0,18,81,1484,1780
1,30/12/2022,0103-Mannadi,71841,112021,100,1464,37350,0,0,110755,0,0,0,0,0,0,2829,1274,4103,3081,1331,4412,3118,16,149,1,0,4,56,1201,1427
1,30/12/2022,0105-High Court,110301,223601,400,3320,73556,0,0,187577,0,0,0,0,0,0,5765,2535,8300,5783,2289,8072,6061,24,367,2,0,17,132,2358,2900
1,30/12/2022,0109-Government Estate,100394,168247,660,3088,60426,0,0,164568,15,0,15,0,500,500,4205,2151,6356,4536,2159,6695,4698,38,326,3,0,18,130,1964,2479
1,30/12/2022,0111-LIC,71470,161213,1700,2784,35526,0,0,111480,0,0,0,0,1000,1000,4315,1279,5594,4911,1245,6156,5033,19,112,1,0,8,119,1113,1372
1,30/12/2022,0113-Thousand Lights,121767,242601,3046,5696,50708,0,0,181217,0,0,0,0,1000,1000,7003,1896,8899,7689,1716,9405,7723,27,0,0,0,8,241,1569,1845
1,30/12/2022,0115-AG-DMS,94200,126870,205,2232,27320,0,0,123957,0,0,0,0,1000,1000,3722,954,4676,3664,833,4497,3899,22,276,7,0,5,91,835,1236
1,30/12/2022,0117-Teynampet,86853,142828,1200,2120,34288,0,0,124461,0,0,0,0,0,0,4307,1278,5585,4608,1101,5709,4543,20,2,0,0,11,95,1158,1286
1,30/12/2022,0119-Nandanam,88584,122641,700,2360,29246,0,0,120890,0,0,0,0,0,0,3718,1085,4803,3812,1088,4900,3973,32,180,0,0,2,104,929,1247
1,30/12/2022,0121-Saidapet,47974,82269,600,1744,28428,0,0,78746,0,0,0,0,6250,6250,1973,1000,2973,2222,904,3126,2177,10,0,5,0,4,69,914,1002
1,30/12/2022,0123-Little Mount,82389,102827,1500,2808,34586,0,0,121283,0,0,0,0,2250,2250,3168,1278,4446,2590,892,3482,2761,26,203,3,0,1,103,1125,1461
1,30/12/2022,0125-Guindy,136380,276570,820,9008,99660,0,0,245868,0,0,0,0,1500,1500,7326,3508,10834,6554,2903,9457,7046,22,483,4,0,11,326,3054,3900
1,30/12/2022,0129-Nanganallur Road,42652,47976,1600,936,14694,0,0,59882,0,0,0,0,0,0,1134,479,1613,1305,450,1755,1261,10,0,2,0,1,31,432,476
1,30/12/2022,0131-Meenambakkam,114143,137123,780,2176,44308,0,0,161407,0,0,0,0,0,0,3540,1270,4810,2824,1247,4071,3105,17,388,0,0,10,70,1192,1677
1,30/12/2022,0133-Chennai International Airport,194453,403017,1200,11576,191662,0,0,398891,0,0,0,0,8250,8250,6220,5403,11623,5897,5302,11199,6717,71,1343,7,1,27,325,4704,6478
2,30/12/2022,0201-Puratchi Thalaivar Dr. M.G. Ramachandran Central,216323,527535,60,14944,257020,0,0,488347,0,0,0,0,8000,8000,10671,9088,19759,11302,9239,20541,11562,98,1214,9,0,20,578,8227,10146
2,30/12/2022,0203-Egmore,85345,148314,300,3744,72454,0,0,161843,0,0,0,0,20000,20000,2407,2613,5020,2984,3358,6342,3115,17,496,7,0,11,152,2400,3083
2,30/12/2022,0205-Nehru Park,34391,48431,0,1040,17456,0,0,52887,0,0,0,0,250,250,1306,664,1970,1210,547,1757,1290,18,134,0,0,5,49,600,806
2,30/12/2022,0207-Kilpauk,32337,51680,10,968,16210,0,0,49525,0,0,0,0,1250,1250,1313,589,1902,1337,634,1971,1416,15,98,4,0,2,37,542,698
2,30/12/2022,0209-Pachaiyappas College,43786,43493,0,856,13296,0,0,57938,0,0,0,0,6500,6500,1370,510,1880,1212,483,1695,1283,9,74,1,0,3,37,468,592
2,30/12/2022,0211-Shenoy Nagar,39121,45485,0,792,14904,0,0,54817,0,0,0,0,3000,3000,1189,539,1728,1203,547,1750,1239,13,90,0,0,3,36,501,643
2,30/12/2022,0213-Anna Nagar East,74089,120803,0,2104,36200,0,0,112393,0,0,0,0,0,0,3310,1326,4636,3207,1198,4405,3370,15,278,8,0,10,96,1191,1598
2,30/12/2022,0215-Anna Nagar Tower,88279,104014,1500,3624,31608,0,0,125011,0,0,0,0,250,250,2663,1150,3813,2607,1158,3765,2798,14,303,2,0,8,110,1007,1444
2,30/12/2022,0217-Thirumangalam,244443,330721,928,10432,108206,0,0,364009,0,0,0,0,0,0,8154,3807,11961,7756,3416,11172,8296,54,796,17,0,21,379,3333,4600
2,30/12/2022,0219-Koyambedu,161411,255260,100,6064,108538,0,0,276113,0,0,0,0,5250,5250,5535,3749,9284,4966,2803,7769,5403,39,649,12,0,18,250,3399,4367
2,30/12/2022,0221-Puratchi Thalaivi Dr. J. Jayalalithaa CMBT,64532,207121,900,4344,98080,0,0,167856,0,0,0,0,0,0,2631,3260,5891,4442,5851,10293,4295,31,581,3,0,7,178,3021,3821
2,30/12/2022,0223-Arumbakkam,53375,63858,0,1360,27132,0,0,81867,0,0,0,0,8500,8500,1556,1020,2576,1590,906,2496,1511,13,2,2,0,7,61,936,1021
2,30/12/2022,0225-Vadapalani,121718,257320,500,8144,115784,0,0,246146,0,0,0,0,4000,4000,4859,4186,9045,4961,3991,8952,5425,40,817,0,0,22,323,3672,4874
2,30/12/2022,0227-Ashok Nagar,83569,148640,975,3864,56118,0,0,144526,0,0,0,0,0,0,3591,2018,5609,3358,1874,5232,3628,20,382,11,0,11,165,1794,2383
2,30/12/2022,0229-Ekkattuthangal,77992,127203,1000,4296,38286,0,0,121574,0,0,0,0,250,250,3355,1456,4811,3305,1040,4345,3557,11,255,7,0,2,178,1215,1668
2,30/12/2022,0231-Arignar Anna Alandur,159960,218591,542,6384,79560,0,0,246446,0,0,0,0,1000,1000,5338,2712,8050,4762,2407,7169,5279,44,647,9,0,11,236,2338,3285
2,30/12/2022,0233-St. Thomas Mount,82772,119576,710,3480,49282,0,0,136244,0,0,0,1000,9400,10400,2824,1652,4476,2581,1358,3939,2706,24,200,4,0,8,128,1484,1848
1,31/12/2022,01ED-Wimco Nagar Depot Metro,83679,81912,0,1816,35416,0,0,120911,0,0,0,0,2250,2250,1853,915,2768,1475,556,2031,1451,14,0,4,0,13,58,848,937
1,31/12/2022,01EF-Wimco Nagar Metro,91052,114771,200,3048,40744,0,0,135044,0,0,0,0,500,500,2509,1073,3582,2259,1027,3286,2309,36,72,4,0,10,92,967,1181
1,31/12/2022,01F1-Thiruvotriyur Metro,102596,102162,0,2248,31866,0,0,136710,42880,0,42880,0,0,0,2394,876,3270,2330,781,3111,2298,31,0,2,0,12,69,800,914
1,31/12/2022,01F3-Thiruvotriyur Theradi Metro,87807,129916,950,2296,49204,0,0,140257,0,0,0,0,0,0,2596,1392,3988,2801,1396,4197,2762,13,61,3,0,7,77,1261,1422
1,31/12/2022,01F5-Kaladipet Metro,86896,88098,700,2136,29270,0,0,119002,0,0,0,0,0,0,2213,906,3119,2141,809,2950,2136,21,0,0,0,6,69,830,926
1,31/12/2022,01F7-Tollgate Metro,52386,54990,0,632,20826,0,0,73844,0,0,0,0,0,0,1354,635,1989,1281,539,1820,1257,29,1,1,0,10,23,600,664
1,31/12/2022,01F9-New Washermenpet Metro,72139,84563,0,1048,27818,0,0,101005,0,0,0,0,250,250,2178,858,3036,2110,919,3029,2157,7,109,2,0,6,39,817,980
1,31/12/2022,01FB-Tondiarpet Metro,75424,94991,200,2192,35484,0,0,113300,0,0,0,0,0,0,2323,1164,3487,2277,1155,3432,2260,14,1,0,0,16,78,1071,1180
1,31/12/2022,01FD-Thiagaraya College Metro,96837,115724,0,2984,44028,0,0,143849,0,0,0,0,2000,2000,2814,1448,4262,2807,1269,4076,2842,27,37,0,0,4,100,1323,1491
1,31/12/2022,0101-Washermanpet,96084,114863,100,2496,50042,0,0,148722,0,0,0,0,24000,24000,2664,1669,4333,2384,1605,3989,2570,21,258,2,0,10,84,1551,1926
1,31/12/2022,0103-Mannadi,65856,106521,0,2128,43270,0,0,111254,0,0,0,0,6000,6000,2292,1478,3770,2553,1473,4026,2613,12,132,0,0,6,68,1358,1576
1,31/12/2022,0105-High Court,85219,179200,1055,3320,73304,0,0,162898,0,0,0,0,0,0,4020,2538,6558,4190,2055,6245,4296,15,259,0,0,10,138,2313,2735
1,31/12/2022,0109-Government Estate,74056,154969,1300,4320,61686,0,0,141362,0,0,0,0,750,750,3485,2286,5771,3634,2099,5733,3919,23,396,4,0,13,180,2002,2618
1,31/12/2022,0111-LIC,62066,121755,1500,3304,40378,0,0,107248,0,0,0,0,0,0,2673,1442,4115,3253,1335,4588,3232,26,2,5,0,13,130,1249,1425
1,31/12/2022,0113-Thousand Lights,124474,195669,1850,4880,57430,0,0,188634,0,0,0,0,0,0,4861,2066,6927,5641,1785,7426,5526,22,0,4,0,14,184,1801,2025
1,31/12/2022,0115-AG-DMS,49614,78666,600,1696,21940,0,0,73850,0,0,0,0,1000,1000,1976,763,2739,2029,783,2812,2176,10,230,1,0,3,69,668,981
1,31/12/2022,0117-Teynampet,71082,94764,1420,2376,25036,0,0,99914,0,0,0,0,2000,2000,2430,949,3379,2660,1146,3806,2833,27,220,1,0,0,90,839,1177
1,31/12/2022,0119-Nandanam,62408,82377,338,1768,25058,0,0,89572,0,0,0,0,250,250,2187,928,3115,2191,1000,3191,2301,23,200,3,0,7,71,832,1136
1,31/12/2022,0121-Saidapet,40141,66958,150,2136,30320,0,0,72747,0,0,0,0,4000,4000,1216,1057,2273,1442,900,2342,1408,8,0,8,0,7,82,964,1069
1,31/12/2022,0123-Little Mount,57683,74843,0,2312,26348,0,0,86343,0,0,0,0,0,0,1974,950,2924,1785,853,2638,1891,7,170,4,0,15,91,809,1096
1,31/12/2022,0125-Guindy,112046,248883,700,8112,105754,0,0,226612,0,0,0,0,0,0,5234,3623,8857,4684,3607,8291,5348,25,905,7,0,8,306,3161,4412
1,31/12/2022,0129-Nanganallur Road,41905,41966,0,888,17522,0,0,60315,0,0,0,0,0,0,833,535,1368,969,558,1527,905,11,2,2,0,0,31,485,531
1,31/12/2022,0131-Meenambakkam,93286,124675,634,3160,55238,0,0,152318,0,0,0,0,0,0,2589,1601,4190,2239,1415,3654,2302,26,221,2,0,8,100,1445,1802
1,31/12/2022,0133-Chennai International Airport,182569,383976,1250,12168,198000,0,0,393987,0,0,0,0,7500,7500,5390,5591,10981,4869,5665,10534,5809,59,1431,12,1,32,395,4868,6798
2,31/12/2022,0201-Puratchi Thalaivar Dr. M.G. Ramachandran Central,188511,531508,440,19400,292326,0,0,500677,0,0,0,0,3750,3750,8960,10387,19347,8985,9600,18585,9626,104,1566,16,0,38,772,9219,11715
2,31/12/2022,0203-Egmore,83613,143243,200,3680,77030,0,0,164523,0,0,0,0,26850,26850,2142,2726,4868,2432,3336,5768,2641,18,543,6,0,11,139,2547,3264
2,31/12/2022,0205-Nehru Park,34050,47776,0,1512,18988,0,0,54550,0,0,0,0,4500,4500,1084,718,1802,1043,668,1711,1179,18,162,3,0,3,67,637,890
2,31/12/2022,0207-Kilpauk,34899,46080,2100,1200,16576,0,0,54775,0,0,0,0,0,0,1055,620,1675,1121,586,1707,1166,10,112,0,0,3,53,562,740
2,31/12/2022,0209-Pachaiyappas College,40075,44440,0,896,15654,0,0,56625,0,0,0,0,8000,8000,1145,576,1721,1178,640,1818,1206,10,94,1,0,2,35,523,665
2,31/12/2022,0211-Shenoy Nagar,28371,43628,100,968,15446,0,0,44885,0,0,0,0,0,0,1093,549,1642,1059,570,1629,1139,8,115,0,0,2,35,499,659
2,31/12/2022,0213-Anna Nagar East,77856,113380,50,3240,39458,0,0,120604,0,0,0,0,0,0,2794,1441,4235,2706,1384,4090,2951,22,367,2,0,3,135,1253,1782
2,31/12/2022,0215-Anna Nagar Tower,76074,103620,1000,2816,37604,0,0,117494,0,0,0,0,0,0,2463,1360,3823,2302,1385,3687,2556,14,402,10,0,7,111,1205,1749
2,31/12/2022,0217-Thirumangalam,207610,325804,220,11672,137934,0,0,357436,0,0,0,0,0,0,6596,4742,11338,6388,4319,10707,6968,62,945,12,0,14,435,4199,5667
2,31/12/2022,0219-Koyambedu,142764,235376,200,8672,114546,0,0,266182,0,0,0,0,750,750,4614,4021,8635,3960,3166,7126,4556,33,837,6,0,21,340,3477,4714
2,31/12/2022,0221-Puratchi Thalaivi Dr. J. Jayalalithaa CMBT,71123,204794,0,4800,110602,0,0,186525,0,0,0,0,0,0,2479,3737,6216,3530,5463,8993,3680,30,735,9,0,5,209,3413,4401
2,31/12/2022,0223-Arumbakkam,46132,61126,200,1704,31038,0,0,79074,0,0,0,0,4250,4250,1279,1146,2425,1361,889,2250,1261,17,4,1,0,7,82,1047,1158
2,31/12/2022,0225-Vadapalani,122104,286251,300,13848,140794,0,0,277046,0,0,0,0,5000,5000,4917,5315,10232,5022,5149,10171,5605,41,921,9,0,31,520,4463,5985
2,31/12/2022,0227-Ashok Nagar,91451,141358,460,4624,62388,0,0,158923,0,0,0,0,500,500,3026,2359,5385,2845,2314,5159,3106,45,399,4,0,7,214,2063,2732
2,31/12/2022,0229-Ekkattuthangal,113435,88658,1000,2896,34884,0,0,152215,0,0,0,0,0,0,2091,1283,3374,2022,1127,3149,2182,71,237,7,0,5,121,1102,1543
2,31/12/2022,0231-Arignar Anna Alandur,126775,202940,0,7392,88180,0,0,222347,0,0,0,0,1750,1750,4210,3002,7212,3805,3083,6888,4289,44,744,14,0,11,264,2580,3657
2,31/12/2022,0233-St. Thomas Mount,69346,126379,200,6152,65394,0,0,141092,0,0,0,3400,1200,4600,2233,2182,4415,2138,1794,3932,2308,21,249,5,0,7,219,1909,2410